Entries (AM Peak (Open-9:30am)),Entries (Evening (7pm-12am)),Entries (Late Night (12am-Close)),Entries (Midday (9:30am-3pm)),Entries (PM Peak (3pm-7pm)),Total Entries,Exits (AM Peak (Open-9:30am)),Exits (Evening (7pm-12am)),Exits (Late Night (12am-Close)),Exits (Midday (9:30am-3pm)),Exits (PM Peak (3pm-7pm)),Total Exits,Station_ID,Date_ID
100,66,2,135,95,398,45,134,12,113,169,473,1,1
642,96,15,322,148,1223,114,239,37,225,709,1324,1,2
864,84,10,348,162,1468,167,267,20,282,831,1567,1,3
858,76,31,313,172,1450,173,286,49,228,821,1557,1,4
722,82,1,357,235,1397,140,271,18,272,741,1442,1,5
132,49,1,197,101,480,63,137,25,137,190,552,1,6
96,64,72,258,126,616,29,210,69,139,182,629,1,7
822,81,3,354,175,1435,162,271,12,257,796,1498,1,8
898,62,0,283,99,1342,148,195,11,276,793,1423,1,9
899,87,1,338,154,1479,135,276,9,254,889,1563,1,10
899,116,1,357,203,1576,157,336,22,274,884,1673,1,11
763,77,4,377,208,1429,142,248,19,316,679,1404,1,12
139,75,2,268,131,615,65,161,21,170,257,674,1,13
100,47,1,177,78,403,49,126,10,130,129,444,1,14
193,71,8,222,136,630,67,146,18,145,281,657,1,15
287,45,1,193,129,655,89,174,13,132,300,708,1,16
700,87,7,329,137,1260,111,279,16,187,751,1344,1,17
857,95,8,316,169,1445,143,295,21,225,853,1537,1,18
339,80,7,206,121,753,94,182,16,159,331,782,1,19
126,50,3,198,111,488,57,137,21,121,200,536,1,20
92,54,13,160,91,410,35,135,19,110,151,450,1,21
824,89,4,315,165,1397,120,257,41,235,818,1471,1,22
942,73,7,352,148,1522,123,283,22,248,902,1578,1,23
958,97,7,333,162,1557,161,314,22,248,875,1620,1,24
903,91,9,345,171,1519,155,329,23,254,878,1639,1,25
711,110,4,373,213,1411,138,258,30,282,720,1428,1,26
163,83,3,269,134,652,61,187,21,182,237,688,1,27
104,85,1,188,96,474,46,174,12,147,166,545,1,28
846,89,6,323,177,1441,137,280,16,228,815,1476,1,29
1004,68,11,321,185,1589,147,294,10,265,941,1657,1,30
990,83,3,380,193,1649,153,314,15,273,931,1686,1,31
968,120,3,419,192,1702,137,344,14,306,886,1687,1,32
736,102,10,403,230,1481,130,286,26,301,801,1544,1,33
143,67,3,261,143,617,60,180,29,203,248,720,1,34
121,67,1,216,106,511,53,166,8,118,221,566,1,35
888,108,1,334,218,1549,140,290,11,235,837,1513,1,36
945,94,17,349,180,1585,122,313,22,241,961,1659,1,37
922,101,21,363,188,1595,151,291,31,282,935,1690,1,38
938,83,18,349,183,1571,156,284,33,229,932,1634,1,39
772,84,4,362,218,1440,135,256,28,297,760,1476,1,40
168,76,1,270,119,634,54,203,31,170,241,699,1,41
117,58,2,203,87,467,35,158,15,125,178,511,1,42
835,76,1,333,171,1416,159,287,19,251,811,1527,1,43
922,86,18,336,176,1538,139,298,49,249,826,1561,1,44
968,93,4,343,184,1592,167,341,24,296,858,1686,1,45
926,82,3,361,203,1575,140,305,24,248,839,1556,1,46
683,92,10,354,196,1335,126,255,42,288,671,1382,1,47
139,71,4,233,109,556,42,153,20,154,217,586,1,48
106,55,2,198,104,465,36,145,21,118,184,504,1,49
292,68,2,316,138,816,93,214,8,216,342,873,1,50
976,89,5,408,187,1665,158,310,22,298,881,1669,1,51
967,90,10,351,161,1579,157,318,20,282,928,1705,1,52
951,86,3,372,200,1612,156,343,16,251,902,1668,1,53
815,102,15,370,217,1519,153,276,41,294,775,1539,1,54
174,75,3,266,136,654,60,193,25,169,256,703,1,55
121,69,9,206,118,523,49,178,18,142,188,575,1,56
877,111,6,321,212,1527,158,320,19,245,900,1642,1,57
1022,84,2,328,182,1618,163,303,12,279,920,1677,1,58
1000,76,4,344,181,1605,184,304,8,269,937,1702,1,59
942,83,2,379,208,1614,167,332,11,303,934,1747,1,60
802,82,7,382,227,1500,171,230,31,320,851,1603,1,61
72,155,22,190,202,641,153,172,10,259,263,857,1,62
65,177,37,193,226,698,114,159,31,315,215,834,1,63
856,100,8,353,188,1505,146,282,21,264,834,1547,1,64
950,90,2,329,183,1554,156,314,21,221,939,1651,1,65
992,111,1,328,171,1603,195,335,12,279,925,1746,1,66
939,100,7,401,213,1660,193,317,26,288,957,1781,1,67
822,96,15,377,248,1558,168,311,45,317,751,1592,1,68
162,60,2,217,118,559,56,175,13,161,237,642,1,69
107,76,11,213,100,507,46,165,21,162,187,581,1,70
830,110,4,307,197,1448,158,285,24,235,800,1502,1,71
979,127,9,399,179,1693,194,320,22,288,958,1782,1,72
981,117,11,404,202,1715,185,310,25,304,956,1780,1,73
856,114,16,480,255,1721,175,363,31,336,940,1845,1,74
712,127,4,353,224,1420,160,315,32,247,723,1477,1,75
187,103,2,318,154,764,82,251,32,222,290,877,1,76
142,98,1,246,148,635,66,216,15,143,227,667,1,77
850,97,1,375,213,1536,149,284,13,238,919,1603,1,78
975,98,8,373,216,1670,147,340,16,294,977,1774,1,79
998,97,13,371,221,1700,171,344,27,271,980,1793,1,80
961,110,13,367,219,1670,151,337,45,256,990,1779,1,81
816,115,5,398,218,1552,157,296,31,317,830,1631,1,82
148,89,1,226,132,596,60,180,32,152,277,701,1,83
129,83,6,221,109,548,48,193,17,155,216,629,1,84
886,98,6,350,219,1559,129,348,17,255,876,1625,1,85
951,102,6,373,209,1641,138,334,21,258,1000,1751,1,86
985,96,36,320,170,1607,146,293,54,277,921,1691,1,87
934,120,11,389,177,1631,149,320,30,297,947,1743,1,88
760,104,9,404,195,1472,131,340,32,262,781,1546,1,89
180,96,9,339,196,820,75,244,33,216,341,909,1,90
114,71,2,271,131,589,49,197,16,160,236,658,1,91
808,118,5,362,189,1482,145,316,19,227,852,1559,1,92
983,100,4,422,198,1707,165,332,19,281,999,1796,1,93
954,114,2,396,191,1657,151,337,9,291,893,1681,1,94
967,126,2,402,237,1734,188,381,15,276,967,1827,1,95
780,125,2,389,235,1531,159,369,29,321,778,1656,1,96
217,104,7,318,151,797,71,250,33,225,328,907,1,97
137,76,2,276,135,626,49,198,15,181,247,690,1,98
926,105,10,379,182,1602,153,263,23,245,945,1629,1,99
1030,99,8,428,222,1787,199,309,29,311,1024,1872,1,100
1031,111,13,446,173,1774,160,328,17,294,983,1782,1,101
976,108,5,394,215,1698,157,361,27,309,943,1797,1,102
803,138,24,399,193,1557,180,327,49,297,810,1663,1,103
202,118,16,335,183,854,94,224,45,234,323,920,1,104
156,74,8,299,158,695,74,205,16,182,286,763,1,105
797,122,5,390,217,1531,159,340,16,264,752,1531,1,106
819,129,23,390,223,1584,163,368,37,277,855,1700,1,107
923,137,32,385,214,1691,195,377,45,307,911,1835,1,108
875,136,56,423,241,1731,171,369,67,325,861,1793,1,109
744,103,12,383,228,1470,165,356,40,282,746,1589,1,110
193,128,20,279,174,794,174,215,37,158,213,797,1,111
78,46,4,172,86,386,40,72,15,115,132,374,1,112
897,144,51,344,208,1644,197,299,60,286,949,1791,1,113
993,99,3,385,217,1697,183,350,13,274,1007,1827,1,114
1045,102,58,393,223,1821,160,374,69,282,959,1844,1,115
1043,129,54,380,213,1819,185,342,77,259,982,1845,1,116
892,123,4,394,251,1664,192,331,27,289,857,1696,1,117
123,228,72,284,300,1007,161,153,21,319,331,985,1,118
125,91,1,250,165,632,64,186,18,178,259,705,1,119
929,100,17,377,215,1638,158,314,29,252,907,1660,1,120
1053,122,9,390,186,1760,175,347,24,318,1025,1889,1,121
1085,105,4,410,187,1791,187,336,18,317,1014,1872,1,122
1030,114,3,454,250,1851,193,344,21,338,1013,1909,1,123
888,120,9,414,253,1684,204,313,35,323,921,1796,1,124
322,188,11,611,368,1500,170,448,94,425,591,1728,1,125
246,163,24,499,287,1219,138,415,55,378,505,1491,1,126
962,117,19,404,216,1718,169,338,28,286,918,1739,1,127
1072,120,5,403,241,1841,189,362,22,286,1047,1906,1,128
1077,117,8,443,190,1835,193,369,21,369,1000,1952,1,129
990,136,4,437,225,1792,167,394,28,348,946,1883,1,130
848,126,25,377,221,1597,173,338,51,325,835,1722,1,131
408,234,11,789,391,1833,206,502,80,548,775,2111,1,132
254,189,2,513,284,1242,151,369,32,400,494,1446,1,133
921,110,4,393,213,1641,179,320,20,300,910,1729,1,134
1063,105,19,359,179,1725,167,321,33,264,1005,1790,1,135
1043,114,5,393,215,1770,208,341,27,321,995,1892,1,136
1003,146,7,425,218,1799,164,373,30,320,980,1867,1,137
852,99,8,418,236,1613,178,353,32,319,867,1749,1,138
163,101,18,272,144,698,63,225,40,171,276,775,1,139
156,82,5,272,130,645,80,198,26,166,261,731,1,140
1004,103,2,380,209,1698,189,332,18,278,993,1810,1,141
1084,115,1,417,252,1869,199,350,31,298,1051,1929,1,142
1045,100,10,417,241,1813,191,316,28,298,1066,1899,1,143
969,144,2,415,219,1749,171,355,19,318,983,1846,1,144
857,158,9,437,202,1663,195,344,28,383,750,1700,1,145
183,126,13,340,169,831,78,253,35,196,319,881,1,146
248,212,2,610,308,1380,154,486,59,436,548,1683,1,147
278,175,0,463,301,1217,159,391,38,386,499,1473,1,148
1005,106,5,394,194,1704,188,289,19,303,983,1782,1,149
1044,113,1,431,193,1782,186,323,19,315,1007,1850,1,150
1023,128,8,411,226,1796,206,391,23,297,967,1884,1,151
871,124,6,441,246,1688,193,351,36,319,851,1750,1,152
188,124,5,334,196,847,67,264,39,201,310,881,1,153
144,78,1,261,141,625,79,211,14,170,248,722,1,154
993,119,8,386,211,1717,192,339,22,271,959,1783,1,155
1041,107,8,409,266,1831,204,362,17,305,1047,1935,1,156
1055,117,11,422,233,1838,198,341,32,310,1015,1896,1,157
1029,141,12,407,243,1832,202,400,28,301,1025,1956,1,158
869,130,7,454,292,1752,210,380,39,292,900,1821,1,159
247,208,9,411,292,1167,76,408,75,246,395,1200,1,160
171,139,6,287,167,770,72,257,21,172,297,819,1,161
943,112,7,377,217,1656,165,282,27,280,937,1691,1,162
1033,114,4,386,253,1790,180,336,36,286,1079,1917,1,163
991,131,19,438,260,1839,191,366,37,307,1074,1975,1,164
967,107,11,432,230,1747,186,380,36,316,938,1856,1,165
842,165,11,441,296,1755,187,401,46,308,845,1787,1,166
218,114,10,318,170,830,97,264,38,216,333,948,1,167
164,112,5,240,142,663,72,217,18,147,274,728,1,168
850,107,14,387,201,1559,164,315,38,292,856,1665,1,169
954,127,11,378,239,1709,170,368,33,317,890,1778,1,170
354,113,16,362,203,1048,144,286,38,219,444,1131,1,171
884,134,9,430,245,1702,161,360,24,301,891,1737,1,172
746,115,4,375,233,1473,152,310,29,299,747,1537,1,173
189,103,6,328,145,771,76,256,48,205,295,880,1,174
133,101,13,275,124,646,74,222,36,157,225,714,1,175
818,118,23,393,251,1603,137,343,39,276,790,1585,1,176
932,115,9,428,228,1712,162,329,27,299,986,1803,1,177
993,111,16,411,185,1716,155,345,29,275,900,1704,1,178
928,144,9,409,248,1738,160,390,24,319,904,1797,1,179
823,118,18,402,241,1602,181,338,44,326,795,1684,1,180
212,100,4,306,166,788,94,242,37,234,334,941,1,181
128,80,8,258,136,610,65,196,17,171,224,673,1,182
861,133,13,417,232,1656,174,336,24,295,878,1707,1,183
640,102,2,407,266,1417,224,352,16,317,921,1830,1,184
895,113,2,417,240,1667,174,325,23,366,809,1697,1,185
191,367,11,274,291,1134,69,439,30,191,358,1087,1,186
538,139,11,343,194,1225,136,307,47,309,565,1364,1,187
168,95,5,280,160,708,75,228,37,179,257,776,1,188
158,72,1,224,140,595,68,201,10,159,251,689,1,189
885,105,7,368,220,1585,182,293,24,304,793,1596,1,190
922,118,10,429,202,1681,174,305,39,310,888,1716,1,191
957,123,4,421,168,1673,158,351,21,332,837,1699,1,192
858,130,4,424,242,1658,164,364,35,308,846,1717,1,193
794,110,10,407,221,1542,184,302,50,315,724,1575,1,194
175,110,11,320,162,778,84,242,45,232,282,885,1,195
132,74,3,233,83,525,68,183,12,157,232,652,1,196
827,81,3,348,173,1432,158,269,26,318,822,1593,1,197
966,100,34,427,192,1719,160,295,61,339,897,1752,1,198
974,80,13,414,201,1682,177,271,27,330,899,1704,1,199
951,123,13,398,218,1703,177,320,36,338,899,1770,1,200
656,148,9,434,249,1496,126,343,45,343,729,1586,1,201
190,80,22,312,162,766,76,207,49,229,286,847,1,202
113,64,9,234,119,539,82,185,11,160,230,668,1,203
844,90,5,383,182,1504,161,277,31,355,801,1625,1,204
978,99,19,451,235,1782,190,355,40,300,930,1815,1,205
955,100,1,407,207,1670,174,284,35,292,873,1658,1,206
922,123,6,441,219,1711,159,321,27,309,891,1707,1,207
832,144,14,452,222,1664,172,354,30,308,767,1631,1,208
183,113,18,355,189,858,65,290,56,213,296,920,1,209
124,94,2,239,135,594,72,217,29,143,207,668,1,210
844,97,5,393,215,1554,154,305,24,299,827,1609,1,211
1003,109,1,384,210,1707,169,346,21,299,912,1747,1,212
986,157,5,605,192,1945,173,406,21,294,947,1841,1,213
922,136,2,398,227,1685,141,352,17,334,857,1701,1,214
751,119,5,408,213,1496,155,359,36,292,718,1560,1,215
201,85,5,358,143,792,69,215,34,225,299,842,1,216
145,93,8,263,138,647,53,216,17,173,253,712,1,217
825,96,2,370,227,1520,148,296,17,258,826,1545,1,218
934,112,9,388,220,1663,155,318,17,285,863,1638,1,219
952,95,1,442,222,1712,179,339,13,300,924,1755,1,220
876,102,3,379,219,1579,156,326,22,276,852,1632,1,221
693,114,23,350,176,1356,113,307,62,261,667,1410,1,222
153,103,4,314,148,722,73,222,33,224,271,823,1,223
115,88,2,234,128,567,57,192,15,161,231,656,1,224
845,112,2,348,216,1523,144,287,21,264,816,1532,1,225
893,101,5,416,226,1641,153,309,10,285,909,1666,1,226
884,108,8,396,208,1604,150,311,18,309,860,1648,1,227
861,108,1,410,236,1616,168,317,20,268,820,1593,1,228
724,142,8,413,214,1501,143,307,39,291,748,1528,1,229
187,81,6,305,156,735,84,199,39,216,323,861,1,230
125,101,0,222,133,581,59,206,15,144,240,664,1,231
800,132,2,381,220,1535,159,300,10,284,898,1651,1,232
896,129,1,400,205,1631,145,364,18,299,894,1720,1,233
920,121,3,440,198,1682,167,381,29,281,895,1753,1,234
835,110,10,419,202,1576,148,330,25,248,881,1632,1,235
724,130,18,413,228,1513,155,328,38,274,758,1553,1,236
200,89,16,295,187,787,76,228,43,225,306,878,1,237
137,110,3,275,148,673,75,205,32,194,250,756,1,238
914,90,5,376,197,1582,169,314,22,301,877,1683,1,239
1015,114,10,400,200,1739,182,335,20,246,1009,1792,1,240
1033,111,17,424,199,1784,183,342,36,316,973,1850,1,241
880,82,2,414,222,1600,156,296,23,284,943,1702,1,242
787,127,19,450,231,1614,145,321,46,357,761,1630,1,243
169,99,12,322,183,785,73,228,34,196,304,835,1,244
136,78,5,234,123,576,84,170,24,145,221,644,1,245
162,98,3,287,146,696,70,198,19,202,272,761,1,246
1029,124,1,399,235,1788,196,359,11,311,975,1852,1,247
1072,113,11,398,210,1804,170,353,27,308,1001,1859,1,248
999,130,1,393,225,1748,171,360,15,292,978,1816,1,249
819,128,11,444,218,1620,161,305,45,326,818,1655,1,250
192,106,10,297,150,755,88,232,30,222,272,844,1,251
147,74,2,249,127,599,61,194,11,157,239,662,1,252
947,90,2,369,225,1633,162,289,18,281,968,1718,1,253
1080,117,1,379,256,1833,195,364,15,274,1076,1924,1,254
1061,125,1,421,223,1831,179,384,19,299,1046,1927,1,255
1040,117,2,443,228,1830,202,351,20,288,1041,1902,1,256
905,127,8,441,238,1719,177,358,44,335,850,1764,1,257
205,132,5,340,192,874,79,259,41,221,345,945,1,258
173,88,3,360,135,759,71,195,9,201,342,818,1,259
959,105,3,379,199,1645,141,305,21,271,957,1695,1,260
1105,114,9,418,214,1860,190,351,24,334,1039,1938,1,261
1071,107,6,396,207,1787,165,395,16,294,1023,1893,1,262
1057,129,7,462,229,1884,185,349,27,335,1058,1954,1,263
906,150,12,432,249,1749,181,315,50,375,928,1849,1,264
122,325,42,331,313,1133,222,194,27,542,290,1275,1,265
75,213,23,200,241,752,120,137,11,306,213,787,1,266
1013,117,7,361,200,1698,191,295,17,267,981,1751,1,267
1067,109,6,411,226,1819,168,392,22,266,1038,1886,1,268
1090,116,8,417,209,1840,162,397,23,293,1055,1930,1,269
1072,134,7,395,220,1828,186,353,23,310,1080,1952,1,270
952,112,20,392,217,1693,171,351,37,299,805,1663,1,271
209,118,3,361,193,884,113,262,44,244,332,995,1,272
134,73,18,244,146,615,87,186,15,143,255,686,1,273
1015,105,7,396,261,1784,176,332,25,264,981,1778,1,274
1095,104,9,376,204,1788,197,346,29,293,983,1848,1,275
1082,121,3,400,199,1805,176,350,23,297,1079,1925,1,276
1050,116,2,417,232,1817,185,354,19,284,1024,1866,1,277
895,167,17,412,271,1762,187,357,72,340,883,1839,1,278
197,120,7,310,193,827,87,235,42,220,325,909,1,279
139,86,2,353,122,702,66,198,21,192,360,837,1,280
1013,100,3,395,215,1726,151,346,16,315,968,1796,1,281
1139,101,8,421,234,1903,167,346,30,306,1115,1964,1,282
1109,105,5,385,230,1834,161,365,24,294,1042,1886,1,283
1026,130,6,425,233,1820,181,373,28,289,961,1832,1,284
823,148,13,431,280,1695,156,379,41,339,837,1752,1,285
235,97,4,356,175,867,99,227,23,225,342,916,1,286
135,81,7,287,137,647,63,195,18,177,232,685,1,287
473,109,13,323,175,1093,127,286,25,257,556,1251,1,288
1076,125,12,417,225,1855,197,351,29,305,1032,1914,1,289
1135,99,9,419,246,1908,211,372,21,301,1141,2046,1,290
1086,136,8,418,248,1896,205,389,21,306,1049,1970,1,291
885,152,18,465,253,1773,160,377,51,354,889,1831,1,292
217,127,34,397,199,974,94,271,75,244,347,1031,1,293
149,103,2,350,194,798,75,311,19,183,313,901,1,294
1009,139,23,434,217,1822,185,348,39,305,978,1855,1,295
1147,104,4,424,254,1933,201,358,17,285,1113,1974,1,296
1163,121,3,397,277,1961,164,413,31,330,1031,1969,1,297
1056,119,5,392,224,1796,169,370,26,315,1003,1883,1,298
855,145,5,423,262,1690,144,380,43,333,876,1776,1,299
212,91,8,369,180,860,83,278,41,232,355,989,1,300
146,81,3,325,162,717,64,293,20,208,262,847,1,301
977,109,13,362,236,1697,180,336,24,280,1000,1820,1,302
1027,95,14,427,285,1848,190,412,27,349,1024,2002,1,303
1121,127,8,412,236,1904,194,450,24,294,1063,2025,1,304
1057,136,7,441,302,1943,180,388,25,329,997,1919,1,305
818,136,11,455,230,1650,189,351,40,313,896,1789,1,306
187,118,4,353,191,853,73,240,41,216,363,933,1,307
138,61,3,261,154,617,77,203,13,189,264,746,1,308
921,86,7,375,204,1593,190,314,18,326,884,1732,1,309
862,94,20,384,222,1582,156,270,29,373,838,1666,1,310
1039,104,6,397,232,1778,173,334,31,318,959,1815,1,311
1028,118,4,423,280,1853,182,317,24,275,1082,1880,1,312
882,109,5,404,283,1683,192,334,45,334,862,1767,1,313
212,75,4,333,175,799,103,216,30,215,324,888,1,314
154,51,5,332,139,681,68,156,14,177,335,750,1,315
450,97,1,345,186,1079,122,256,13,235,523,1149,1,316
1069,103,2,420,245,1839,169,316,25,322,1060,1892,1,317
1067,107,13,393,198,1778,156,356,25,322,1060,1919,1,318
989,110,2,391,226,1718,156,321,22,296,1047,1842,1,319
923,113,8,419,247,1710,171,331,29,314,930,1775,1,320
196,79,6,341,184,806,62,223,38,232,315,870,1,321
149,54,2,221,138,564,63,165,13,162,246,649,1,322
990,109,5,374,231,1709,155,327,17,322,965,1786,1,323
1111,106,0,424,226,1867,175,350,19,324,1090,1958,1,324
1137,89,1,382,244,1853,210,327,18,312,1137,2004,1,325
1048,86,13,394,258,1799,181,334,35,317,1054,1921,1,326
859,101,5,391,214,1570,190,292,33,307,856,1678,1,327
207,84,7,305,183,786,69,221,28,229,317,864,1,328
146,74,4,359,166,749,59,182,15,202,351,809,1,329
937,99,8,367,247,1658,158,350,45,338,959,1850,1,330
944,112,1,452,219,1728,189,338,20,303,929,1779,1,331
687,84,1,370,204,1346,147,242,20,359,650,1418,1,332
84,89,1,147,92,413,50,79,5,148,193,475,1,333
344,86,1,353,168,952,96,224,23,265,394,1002,1,334
167,58,2,279,146,652,83,169,34,201,262,749,1,335
141,68,1,334,158,702,76,169,9,182,346,782,1,336
914,97,7,345,190,1553,172,282,14,271,928,1667,1,337
958,96,4,415,236,1709,169,357,17,293,1091,1927,1,338
1008,92,1,412,212,1725,188,350,18,333,1016,1905,1,339
985,104,1,370,251,1711,162,353,20,305,1014,1854,1,340
829,108,4,387,243,1571,159,305,35,315,832,1646,1,341
98,216,42,235,277,868,191,114,19,351,293,968,1,342
82,175,10,178,222,667,111,111,6,308,206,742,1,343
964,92,5,346,221,1628,186,269,16,255,979,1705,1,344
1082,86,2,393,208,1771,199,311,13,283,956,1762,1,345
1040,89,4,400,199,1732,191,346,26,295,963,1821,1,346
1016,120,1,422,221,1780,182,385,19,296,1038,1920,1,347
870,130,9,450,226,1685,192,302,39,319,876,1728,1,348
172,95,9,349,195,820,88,211,39,231,342,911,1,349
123,63,6,213,93,498,56,182,25,135,182,580,1,350
946,89,10,358,211,1614,163,282,24,241,982,1692,1,351
1033,99,8,390,264,1794,187,353,19,274,1116,1949,1,352
1050,98,3,374,235,1760,185,335,21,290,1054,1885,1,353
971,114,6,389,249,1729,170,329,34,281,950,1764,1,354
698,85,9,394,221,1407,165,273,38,286,674,1436,1,355
154,74,7,265,156,656,61,166,26,207,228,688,1,356
100,54,6,259,169,588,42,137,19,128,293,619,1,357
523,75,9,325,165,1097,108,227,22,227,510,1094,1,358
324,50,4,232,125,735,110,139,13,237,286,785,1,359
39,58,2,93,68,260,38,57,8,71,105,279,1,360
366,72,8,274,172,892,75,225,19,189,415,923,1,361
392,71,5,298,207,973,104,189,21,200,411,925,1,362
118,65,6,210,141,540,58,155,25,127,181,546,1,363
97,100,10,202,145,554,38,160,98,108,197,601,1,364
486,87,4,295,172,1044,115,240,13,230,532,1130,1,365
533,114,25,332,187,1191,134,192,48,305,532,1211,1,366
251,243,7,687,445,1633,123,417,13,497,515,1565,2,1
1067,372,12,1133,990,3574,686,693,24,840,1233,3476,2,2
1554,364,8,1295,1247,4468,920,784,20,1031,1569,4324,2,3
1543,408,7,1279,1324,4561,996,752,16,1001,1587,4352,2,4
1369,506,58,1282,1186,4401,866,803,77,956,1423,4125,2,5
335,306,30,785,436,1892,172,525,42,532,555,1826,2,6
300,345,8,838,497,1988,161,540,20,512,677,1910,2,7
1581,426,4,1269,1302,4582,955,784,13,935,1629,4316,2,8
1624,254,6,1173,906,3963,908,548,18,934,1330,3738,2,9
1723,431,8,1332,1330,4824,1019,745,25,1090,1655,4534,2,10
1646,402,11,1329,1372,4760,851,576,16,830,1591,3864,2,11
1449,411,77,1384,1269,4590,743,709,92,933,1445,3922,2,12
375,373,30,1060,595,2433,195,655,61,627,809,2347,2,13
307,316,11,790,474,1898,141,538,23,510,660,1872,2,14
464,315,14,1207,489,2489,270,547,19,692,717,2245,2,15
604,282,33,772,565,2256,401,548,40,588,752,2329,2,16
797,225,28,856,808,2714,752,441,53,969,1119,3334,2,17
1590,443,17,1358,1264,4672,962,795,36,970,1651,4414,2,18
611,311,18,764,512,2216,380,579,40,629,704,2332,2,19
325,336,22,785,511,1979,181,659,56,516,589,2001,2,20
255,347,22,739,386,1749,124,590,27,463,551,1755,2,21
1586,360,34,1184,1334,4498,982,665,62,899,1740,4348,2,22
1706,395,35,1269,1364,4769,1082,746,55,940,1784,4607,2,23
1642,319,15,1218,1211,4405,1044,740,21,939,1592,4336,2,24
1521,279,7,1113,1164,4084,1011,710,18,847,1523,4109,2,25
1172,309,16,1259,960,3716,762,665,44,929,1281,3681,2,26
349,241,9,819,451,1869,186,538,37,474,608,1843,2,27
279,171,6,663,283,1402,122,347,8,448,546,1471,2,28
1414,273,7,1030,1065,3789,968,563,13,767,1574,3885,2,29
1586,264,4,1143,1216,4213,989,672,11,863,1715,4250,2,30
1661,256,6,1103,1162,4188,1103,697,17,928,1516,4261,2,31
1684,332,19,1267,1144,4446,1160,729,36,960,1645,4530,2,32
1525,269,15,1217,1192,4218,987,650,45,977,1554,4213,2,33
315,262,17,859,470,1923,169,502,62,529,643,1905,2,34
269,199,18,622,345,1453,131,486,27,420,542,1606,2,35
1456,265,7,1165,1130,4023,978,594,24,858,1570,4024,2,36
1759,249,10,1157,1189,4364,1162,676,29,889,1753,4509,2,37
1734,290,8,1151,1338,4521,1153,738,14,899,1770,4574,2,38
1650,293,3,1114,1260,4320,1067,720,11,889,1696,4383,2,39
1490,336,14,1235,1067,4142,990,700,65,978,1422,4155,2,40
327,253,17,876,562,2035,168,604,54,537,764,2127,2,41
282,171,6,622,376,1457,111,367,11,414,634,1537,2,42
1429,270,6,1052,1212,3969,893,619,19,986,1611,4128,2,43
1612,270,7,993,1299,4181,1012,722,16,772,1733,4255,2,44
1777,372,7,1035,1658,4849,1152,857,11,903,1960,4883,2,45
1582,329,5,1057,1252,4225,1060,738,12,827,1757,4394,2,46
1030,299,16,1131,826,3302,665,636,42,878,1148,3369,2,47
299,255,25,741,377,1697,149,502,58,480,621,1810,2,48
239,205,4,667,397,1512,110,407,18,467,587,1589,2,49
517,252,6,774,520,2069,263,502,11,503,791,2070,2,50
1533,298,7,1054,1284,4176,966,674,19,834,1793,4286,2,51
1569,282,3,1122,1209,4185,1027,653,16,892,1780,4368,2,52
1512,300,16,1079,1260,4167,1016,655,21,910,1746,4348,2,53
1303,349,15,1191,1026,3884,900,663,41,923,1416,3943,2,54
309,243,37,822,547,1958,186,589,46,512,668,2001,2,55
217,211,4,626,369,1427,111,455,16,354,529,1465,2,56
1555,278,9,1009,1352,4203,1126,700,17,894,1649,4386,2,57
1739,333,7,1168,1366,4613,1199,675,17,911,1811,4613,2,58
1605,231,6,1159,1293,4294,1118,620,14,952,1613,4317,2,59
1582,319,7,1169,1178,4255,1074,685,13,857,1637,4266,2,60
1380,300,14,1278,1067,4039,956,675,44,940,1439,4054,2,61
315,209,13,680,465,1682,171,504,41,404,570,1690,2,62
266,211,4,693,341,1515,123,441,20,427,561,1572,2,63
1442,289,6,989,1183,3909,1011,568,19,785,1686,4069,2,64
1678,288,10,1095,1314,4385,1125,672,29,947,1726,4499,2,65
1574,249,9,1157,1253,4242,1074,645,19,976,1647,4361,2,66
1624,304,17,1130,1387,4462,1096,728,30,888,1881,4623,2,67
1408,340,24,1173,1216,4161,938,776,88,883,1602,4287,2,68
370,204,11,758,409,1752,194,444,36,538,521,1733,2,69
258,204,7,631,320,1420,123,405,18,361,559,1466,2,70
1450,300,5,960,1236,3951,982,599,17,732,1669,3999,2,71
1558,331,6,1112,1370,4377,1008,740,16,892,1736,4392,2,72
1555,319,7,1261,1261,4403,1110,726,22,987,1695,4540,2,73
1292,337,7,1209,1231,4076,952,789,27,915,1404,4087,2,74
1032,348,15,1253,982,3630,778,689,56,818,1264,3605,2,75
370,325,23,1048,593,2359,180,704,64,642,850,2440,2,76
265,265,10,649,405,1594,119,634,19,388,582,1742,2,77
1559,334,5,1059,1228,4185,1103,728,13,817,1708,4369,2,78
1597,323,3,1085,1283,4291,1124,723,14,793,1658,4312,2,79
1652,314,7,1203,1244,4420,1125,784,19,970,1670,4568,2,80
1623,303,18,1157,1340,4441,1080,797,43,932,1715,4567,2,81
1443,315,19,1098,1132,4007,904,732,48,869,1543,4096,2,82
299,271,12,719,457,1758,145,690,36,465,639,1975,2,83
272,217,2,687,383,1561,124,538,9,436,716,1823,2,84
1506,309,8,1043,1223,4089,992,671,14,821,1659,4157,2,85
1604,345,12,1164,1461,4586,1052,797,14,908,1989,4760,2,86
1630,316,31,1124,1265,4366,1061,674,49,907,1675,4366,2,87
1568,372,15,1196,1113,4264,1124,690,29,900,1696,4439,2,88
1404,330,23,1264,1191,4212,939,777,60,940,1466,4182,2,89
333,250,15,969,673,2240,185,717,51,568,795,2316,2,90
251,220,11,674,328,1484,121,481,9,406,572,1589,2,91
1425,338,2,1203,1329,4297,963,858,12,806,1780,4419,2,92
1569,287,14,1250,1252,4372,1106,746,19,910,1717,4498,2,93
1581,271,3,1109,1140,4104,1075,764,9,892,1581,4321,2,94
1700,372,7,1314,1257,4650,1173,862,34,1021,1693,4783,2,95
1190,380,36,1220,1178,4004,865,930,62,919,1333,4109,2,96
365,289,27,998,527,2206,184,722,53,610,746,2315,2,97
353,241,10,830,400,1834,143,638,22,449,704,1956,2,98
1555,329,6,1167,1149,4206,1081,676,17,867,1647,4288,2,99
1702,346,19,1104,1217,4388,1062,793,28,907,1585,4375,2,100
1621,323,9,1191,1226,4370,1090,744,19,960,1651,4464,2,101
1589,302,5,1192,1182,4270,1153,705,8,962,1551,4379,2,102
1424,371,15,1265,1102,4177,948,720,61,1003,1402,4134,2,103
413,348,17,924,595,2297,206,750,67,598,729,2350,2,104
261,235,5,756,474,1731,123,626,11,423,619,1802,2,105
1181,321,14,1132,1046,3694,763,743,16,880,1373,3775,2,106
1071,315,16,1137,812,3351,589,747,23,791,1245,3395,2,107
1232,318,12,1148,980,3690,795,673,23,843,1197,3531,2,108
1233,332,15,1223,999,3802,837,736,25,924,1344,3866,2,109
1045,364,17,1185,976,3587,687,553,57,833,1205,3335,2,110
367,328,15,1078,688,2476,174,823,38,525,862,2422,2,111
283,197,4,669,328,1481,128,456,17,375,620,1596,2,112
1535,339,4,988,1138,4004,1013,632,9,830,1596,4080,2,113
1773,357,5,1167,1375,4677,1214,880,15,931,1647,4687,2,114
1676,412,14,1199,1411,4712,1155,941,19,947,1702,4764,2,115
1680,336,24,1307,1273,4620,1130,832,29,949,1734,4674,2,116
1479,401,21,1171,1202,4274,926,860,57,911,1475,4229,2,117
408,318,16,820,571,2133,183,686,62,588,620,2139,2,118
310,277,11,793,483,1874,137,589,19,440,694,1879,2,119
1633,399,5,984,1269,4290,1092,606,7,789,1609,4103,2,120
1744,372,8,1241,1367,4732,1208,740,14,1028,1798,4788,2,121
1689,417,5,1300,1234,4645,1132,815,16,1131,1772,4866,2,122
1623,353,6,1247,1301,4530,1120,742,23,983,1704,4572,2,123
1445,379,24,1271,1272,4391,984,871,49,957,1551,4412,2,124
349,292,20,908,539,2108,164,680,42,504,664,2054,2,125
260,246,6,794,379,1685,122,586,15,416,631,1770,2,126
1601,323,4,1003,1208,4139,1102,619,8,858,1572,4159,2,127
1672,417,6,1176,1449,4720,1103,964,10,994,1762,4833,2,128
1591,358,8,1081,1422,4460,1092,899,15,965,1669,4640,2,129
1608,354,9,1237,1174,4382,1090,762,15,910,1668,4445,2,130
1511,314,22,1164,1084,4095,979,700,48,890,1495,4112,2,131
418,332,23,894,506,2173,211,666,78,604,768,2327,2,132
304,230,5,654,382,1575,133,479,19,413,608,1652,2,133
1535,355,11,1017,1388,4306,1097,685,29,834,1653,4298,2,134
1547,343,2,1196,1307,4395,1094,725,14,969,1660,4462,2,135
1629,344,7,1181,1187,4348,1114,737,25,922,1605,4403,2,136
1729,389,3,1298,1209,4628,1178,759,24,1037,1635,4633,2,137
1533,374,19,1279,1134,4339,1007,763,51,894,1474,4189,2,138
340,308,17,809,455,1929,169,654,66,550,599,2038,2,139
278,246,12,735,359,1630,175,561,25,344,590,1695,2,140
1528,367,6,1076,1339,4316,1044,839,8,812,1779,4482,2,141
1796,372,14,1141,1560,4883,1199,911,17,866,1831,4824,2,142
1773,403,13,1270,1359,4818,1150,784,28,1048,1892,4902,2,143
1517,328,18,1101,1252,4216,1057,708,18,832,1574,4189,2,144
1251,391,25,1177,1162,4006,795,908,44,998,1377,4122,2,145
323,356,37,956,580,2252,181,834,78,524,719,2336,2,146
307,339,3,843,451,1943,131,640,19,442,802,2034,2,147
322,213,4,644,363,1546,160,419,13,435,639,1666,2,148
1683,375,10,1031,1320,4419,1143,814,15,846,1710,4528,2,149
1677,334,6,1107,1221,4345,1148,657,18,1065,1613,4501,2,150
1583,409,5,1250,1447,4694,1178,790,21,1112,1749,4850,2,151
1479,423,21,1218,1282,4423,1017,788,66,956,1592,4419,2,152
396,352,29,934,571,2282,213,729,56,620,752,2370,2,153
329,258,15,736,410,1748,141,515,22,484,671,1833,2,154
1447,377,5,1160,1422,4411,1025,840,16,947,1739,4567,2,155
1411,371,4,1201,1397,4384,1040,878,7,946,1570,4441,2,156
1596,342,3,1227,1299,4467,1133,796,7,954,1667,4557,2,157
1364,392,9,1206,1443,4414,928,1022,28,1001,1566,4545,2,158
1395,495,14,1280,1307,4491,836,1089,64,958,1477,4424,2,159
394,542,36,1204,860,3036,228,1242,148,658,869,3145,2,160
312,375,33,952,502,2174,157,722,52,493,813,2237,2,161
1485,344,10,1168,1192,4199,1005,659,17,1034,1591,4306,2,162
1636,385,8,1352,1229,4610,1129,775,20,1090,1641,4655,2,163
1546,420,10,1279,1276,4531,1023,847,15,1126,1577,4588,2,164
1497,423,11,1217,1207,4355,1003,856,22,1024,1591,4496,2,165
1216,490,38,1290,1137,4171,781,1100,97,1009,1379,4366,2,166
361,429,21,1043,627,2481,188,964,75,527,810,2564,2,167
310,272,3,794,429,1808,142,604,14,436,708,1904,2,168
1239,360,11,1047,1041,3698,796,706,27,908,1320,3757,2,169
1262,416,16,1227,1078,3999,870,891,29,956,1284,4030,2,170
628,367,6,1108,909,3018,366,829,18,947,896,3056,2,171
1201,450,8,1269,1156,4084,851,931,16,924,1563,4285,2,172
1035,477,30,1170,990,3702,677,1023,71,847,1288,3906,2,173
318,342,17,782,521,1980,156,727,72,497,662,2114,2,174
287,258,20,729,353,1647,134,494,40,418,530,1616,2,175
1312,367,19,1209,1043,3950,856,710,35,1052,1353,4006,2,176
1401,357,8,1187,1089,4042,928,701,18,959,1397,4003,2,177
1449,331,5,1249,1111,4145,924,730,14,1051,1481,4200,2,178
1388,386,11,1291,1176,4252,922,887,21,1039,1454,4323,2,179
1234,386,24,1265,980,3889,734,792,55,899,1369,3849,2,180
372,354,17,864,562,2169,160,689,62,583,732,2226,2,181
290,240,14,621,350,1515,132,488,22,400,517,1559,2,182
1343,379,3,1322,1237,4284,951,925,23,1033,1530,4462,2,183
1370,366,3,1402,1267,4408,1018,968,14,1104,1499,4603,2,184
1405,442,9,1379,1305,4540,968,1042,9,1155,1425,4599,2,185
399,1091,33,918,746,3187,223,1422,52,738,825,3260,2,186
893,411,17,1139,895,3355,527,919,60,810,1039,3355,2,187
325,351,53,868,485,2082,181,765,95,499,605,2145,2,188
318,261,19,757,345,1700,147,506,22,450,674,1799,2,189
1343,338,20,1229,1095,4025,935,733,27,1031,1472,4198,2,190
1470,341,7,1284,1165,4267,1022,746,11,1099,1550,4428,2,191
1401,289,15,1302,1066,4073,980,662,22,1105,1475,4244,2,192
1369,334,22,1214,1160,4099,999,758,29,1031,1517,4334,2,193
1146,385,17,1220,950,3718,761,854,51,894,1295,3855,2,194
342,349,18,909,627,2245,159,924,49,547,646,2325,2,195
272,205,15,630,327,1449,128,473,28,394,590,1613,2,196
1329,312,7,1053,940,3641,876,601,14,881,1335,3707,2,197
1456,289,9,1202,1135,4091,1020,674,14,1002,1362,4072,2,198
1404,238,4,1209,1061,3916,981,563,9,984,1443,3980,2,199
1280,335,7,1227,1044,3893,930,731,13,967,1448,4089,2,200
1141,442,13,1217,1130,3943,778,957,109,970,1327,4141,2,201
330,345,15,847,617,2154,173,770,52,501,628,2124,2,202
299,238,12,804,335,1688,139,487,33,415,638,1712,2,203
1191,275,3,1063,942,3474,878,607,17,814,1222,3538,2,204
1366,351,4,1218,1175,4114,902,794,13,1007,1468,4184,2,205
1353,346,11,1324,1233,4267,892,855,19,1063,1531,4360,2,206
1365,351,4,1140,1058,3918,874,689,13,953,1426,3955,2,207
1201,372,18,1282,939,3812,749,753,87,967,1357,3913,2,208
331,301,42,896,532,2102,164,737,101,561,660,2223,2,209
265,252,7,693,359,1576,131,605,20,403,486,1645,2,210
1152,277,6,1189,1054,3678,826,770,18,843,1322,3779,2,211
1338,281,4,1037,1101,3761,940,591,13,855,1418,3817,2,212
1265,293,7,1220,999,3784,885,641,13,1006,1431,3976,2,213
1258,383,3,1205,1175,4024,872,760,20,958,1448,4058,2,214
1203,422,21,1206,1034,3886,739,935,60,951,1207,3892,2,215
356,248,10,917,473,2004,166,532,61,485,792,2036,2,216
330,214,6,718,320,1588,122,428,20,389,662,1621,2,217
1112,273,1,1052,1030,3468,756,699,12,875,1245,3587,2,218
1270,299,19,1125,1141,3854,885,778,17,840,1369,3889,2,219
1203,270,8,1156,1148,3785,887,721,15,865,1315,3803,2,220
1257,242,13,1107,923,3542,826,605,18,958,1243,3650,2,221
1047,284,15,963,866,3175,620,659,72,785,1006,3142,2,222
324,282,11,799,561,1977,146,680,53,522,613,2014,2,223
313,250,4,697,362,1626,126,485,11,441,554,1617,2,224
1042,301,8,1045,1003,3399,752,606,20,887,1218,3483,2,225
1217,297,5,1142,1172,3833,880,679,11,873,1314,3757,2,226
1255,320,37,1171,1053,3836,928,682,49,894,1345,3898,2,227
1162,347,16,1163,1203,3891,894,748,24,851,1311,3828,2,228
1070,356,34,1159,1033,3652,734,762,71,877,1193,3637,2,229
324,292,22,732,530,1900,170,519,79,519,670,1957,2,230
273,234,8,660,307,1482,136,444,18,385,547,1530,2,231
1125,264,6,1016,1055,3466,837,553,8,841,1240,3479,2,232
1275,309,3,1166,1383,4136,962,801,9,884,1535,4191,2,233
1261,308,8,1214,1208,3999,913,839,23,957,1304,4036,2,234
1372,339,11,1239,1155,4116,1042,748,19,897,1444,4150,2,235
1149,363,24,1146,1066,3748,825,750,48,907,1200,3730,2,236
312,302,17,878,481,1990,178,649,59,553,605,2044,2,237
259,214,16,759,371,1619,118,448,29,459,644,1698,2,238
1442,292,25,1043,1327,4129,952,831,25,885,1649,4342,2,239
1742,343,13,1088,1441,4627,1134,944,14,853,1694,4639,2,240
1699,264,5,1142,1277,4387,1062,833,18,923,1643,4479,2,241
1628,273,24,1097,1269,4291,1037,713,26,887,1633,4296,2,242
1383,340,15,1191,1181,4110,852,853,56,952,1390,4103,2,243
321,248,17,870,604,2060,175,642,58,513,738,2126,2,244
289,212,8,803,373,1685,156,489,21,408,675,1749,2,245
313,239,7,667,398,1624,174,465,6,447,537,1629,2,246
1691,282,11,1104,1327,4415,1055,678,11,926,1698,4368,2,247
1761,304,8,1208,1241,4522,1199,694,15,1000,1763,4671,2,248
1713,325,6,1150,1397,4591,1152,740,18,907,1711,4528,2,249
1632,340,16,1202,1199,4389,1054,736,46,927,1557,4320,2,250
340,316,14,945,585,2200,190,683,72,560,746,2251,2,251
269,224,19,707,390,1609,139,499,24,430,550,1642,2,252
1685,295,9,982,1243,4214,1075,697,12,805,1547,4136,2,253
1730,277,8,1068,1412,4495,1161,855,10,925,1700,4651,2,254
1800,334,8,1167,1282,4591,1262,894,15,1008,1656,4835,2,255
1799,388,12,1179,1503,4881,1156,940,13,963,1776,4848,2,256
1526,366,28,1259,1320,4499,958,922,55,1008,1636,4579,2,257
394,333,39,1045,628,2439,204,784,57,605,770,2420,2,258
329,229,20,875,380,1833,128,469,25,493,744,1859,2,259
1644,312,46,1098,1321,4421,1099,652,57,921,1674,4403,2,260
1811,323,5,1074,1344,4557,1211,676,12,919,1714,4532,2,261
1780,317,9,1188,1315,4609,1184,742,14,995,1613,4548,2,262
1745,400,4,1214,1433,4796,1172,849,21,1017,1853,4912,2,263
1571,404,27,1347,1141,4490,973,784,62,1027,1563,4409,2,264
412,321,15,1039,535,2322,173,823,66,607,701,2370,2,265
279,216,6,715,374,1590,130,479,15,404,558,1586,2,266
1648,300,14,995,1287,4244,1048,636,19,894,1610,4207,2,267
1873,281,32,1170,1452,4808,1239,782,45,933,1776,4775,2,268
1888,353,24,1304,1395,4964,1323,848,36,1108,1768,5083,2,269
1802,336,26,1272,1357,4793,1189,803,31,967,1844,4834,2,270
1478,388,28,1269,1280,4443,949,954,55,953,1597,4508,2,271
389,447,28,1014,700,2578,186,1043,106,574,732,2641,2,272
271,190,32,868,399,1760,138,536,22,451,692,1839,2,273
1655,347,28,1153,1435,4618,1132,750,31,859,1854,4626,2,274
1841,289,26,1170,1394,4720,1235,731,15,902,1782,4665,2,275
1931,349,18,1383,1384,5065,1344,736,31,1096,1776,4983,2,276
1860,390,9,1247,1451,4957,1291,756,14,973,1867,4901,2,277
1757,379,15,1230,1309,4690,1129,818,56,959,1640,4602,2,278
333,296,23,943,513,2108,174,646,65,502,711,2098,2,279
276,179,7,712,379,1553,151,494,13,407,581,1646,2,280
1676,317,8,1059,1307,4367,1085,617,18,905,1780,4405,2,281
1857,322,8,1200,1514,4901,1263,669,10,1011,1930,4883,2,282
2000,345,13,1332,1491,5181,1319,716,18,1116,1899,5068,2,283
1358,374,11,1167,1374,4284,992,791,31,827,1714,4355,2,284
1275,285,37,1452,1082,4131,804,745,52,1140,1320,4061,2,285
350,280,21,911,592,2154,183,675,68,493,731,2150,2,286
312,217,6,754,435,1724,129,603,14,442,538,1726,2,287
641,228,20,909,596,2394,311,498,28,620,905,2362,2,288
1778,287,14,1146,1446,4671,1187,723,24,944,1839,4717,2,289
1711,294,8,1170,1358,4541,1181,693,16,986,1750,4626,2,290
1734,344,11,1256,1462,4807,1215,752,14,945,1884,4810,2,291
1578,359,19,1313,1284,4553,1038,825,50,1038,1585,4536,2,292
374,359,16,951,644,2344,165,743,99,660,677,2344,2,293
283,193,11,734,409,1630,136,568,15,416,581,1716,2,294
1684,314,7,1117,1337,4459,1135,757,15,963,1704,4574,2,295
1773,324,23,1162,1471,4753,1274,753,24,892,1875,4818,2,296
1847,314,8,1253,1406,4828,1256,724,13,1094,1852,4939,2,297
1937,329,12,1279,1488,5045,1329,775,21,1085,1827,5037,2,298
1533,353,24,1221,1189,4320,1087,691,51,967,1511,4307,2,299
378,331,13,1013,555,2290,202,622,66,663,686,2239,2,300
388,177,7,742,368,1682,178,425,10,445,627,1685,2,301
1690,318,8,1085,1323,4424,1143,674,12,884,1711,4424,2,302
1896,391,17,1190,1574,5068,1310,961,21,908,1874,5074,2,303
1843,325,11,1313,1398,4890,1260,797,20,1058,1734,4869,2,304
1855,446,16,1233,1535,5085,1367,860,20,1018,1760,5025,2,305
1447,323,22,1271,1174,4237,987,732,50,974,1464,4207,2,306
354,291,12,1005,521,2183,179,611,58,574,736,2158,2,307
296,189,2,730,372,1589,163,389,9,439,569,1569,2,308
1393,325,22,1106,1201,4047,1071,649,32,921,1416,4089,2,309
1257,281,10,1327,1027,3902,959,600,30,991,1343,3923,2,310
1816,355,15,1244,1476,4906,1277,674,25,1084,1881,4941,2,311
1765,328,21,1146,1395,4655,1291,656,29,989,1744,4709,2,312
1644,359,14,1327,1222,4566,1117,674,59,1044,1674,4568,2,313
377,236,17,930,508,2068,164,535,48,588,651,1986,2,314
358,174,7,747,333,1619,152,391,22,479,654,1698,2,315
690,230,9,893,634,2456,315,516,16,689,918,2454,2,316
1977,320,60,1316,1612,5285,1470,684,49,1015,2125,5343,2,317
1918,294,38,1281,1468,4999,1352,758,54,1060,1824,5048,2,318
1816,314,21,1241,1359,4751,1252,711,35,971,1822,4791,2,319
1520,296,16,1186,1181,4199,982,642,35,1005,1570,4234,2,320
400,236,19,1035,486,2176,192,536,45,561,811,2145,2,321
312,170,12,716,352,1562,136,464,12,439,557,1608,2,322
1688,282,17,1145,1384,4516,1185,614,31,847,1870,4547,2,323
1843,303,14,1108,1468,4736,1263,660,23,955,1859,4760,2,324
1876,288,22,1297,1490,4973,1291,694,23,1158,1843,5009,2,325
1698,296,6,1264,1727,4991,1231,646,22,1065,2159,5123,2,326
1595,309,10,1263,1140,4317,1092,653,38,1078,1390,4251,2,327
428,288,17,998,514,2245,196,560,42,667,692,2157,2,328
278,171,10,706,349,1514,136,395,15,455,634,1635,2,329
1521,285,16,1136,1389,4347,974,658,33,902,1629,4196,2,330
1535,280,9,1225,1466,4515,950,662,11,862,1666,4151,2,331
1084,312,5,1233,937,3571,629,625,14,916,1251,3435,2,332
203,195,3,506,334,1241,147,232,10,387,435,1211,2,333
612,208,27,988,584,2419,322,491,48,604,795,2260,2,334
316,250,22,780,524,1892,152,531,49,505,624,1861,2,335
266,161,11,718,435,1591,115,468,20,474,567,1644,2,336
1648,283,21,1128,1397,4477,1115,607,26,942,1730,4420,2,337
1806,305,11,1180,1519,4821,1254,737,21,920,1934,4866,2,338
1788,319,33,1223,1414,4777,1273,654,42,1027,1793,4789,2,339
1760,301,13,1121,1585,4780,1192,814,32,935,1893,4866,2,340
1493,320,14,1304,1300,4431,1040,634,58,951,1710,4393,2,341
370,281,18,976,583,2228,252,666,74,577,642,2211,2,342
321,209,13,705,406,1654,119,488,21,426,565,1619,2,343
1694,306,21,1136,1416,4573,1088,672,28,886,1876,4550,2,344
1810,286,6,1235,1566,4903,1191,717,15,889,2056,4868,2,345
1823,286,20,1130,1354,4613,1255,629,33,994,1701,4612,2,346
1807,377,8,1224,1569,4985,1245,842,21,993,1881,4982,2,347
1552,319,10,1380,1246,4507,1116,687,53,1039,1643,4538,2,348
385,251,11,1024,582,2253,214,580,45,596,760,2195,2,349
238,164,13,800,382,1597,116,455,18,472,532,1593,2,350
1623,267,15,1105,1323,4333,1159,576,19,894,1686,4334,2,351
1789,302,14,1184,1516,4805,1233,701,28,978,1940,4880,2,352
1777,306,12,1251,1385,4731,1251,740,22,1048,1726,4787,2,353
1625,287,10,1281,1412,4615,1106,751,15,1000,1738,4610,2,354
1431,334,22,1287,1168,4242,974,675,50,1082,1347,4128,2,355
350,236,20,873,503,1982,191,528,44,540,612,1915,2,356
277,191,11,709,430,1618,127,468,20,431,520,1566,2,357
875,213,11,1033,824,2956,517,520,19,764,1115,2935,2,358
675,218,4,947,462,2306,405,371,10,689,758,2233,2,359
162,160,39,386,210,957,122,185,31,325,296,959,2,360
729,236,17,919,761,2662,466,563,17,726,935,2707,2,361
762,269,20,1033,781,2865,498,576,34,743,995,2846,2,362
257,216,22,731,473,1699,140,512,67,442,549,1710,2,363
261,189,14,619,342,1425,126,369,19,399,516,1429,2,364
814,260,5,1083,910,3072,519,563,15,773,1066,2936,2,365
884,492,59,1104,652,3191,550,634,106,802,1047,3139,2,366
30,118,14,377,456,995,77,91,9,654,181,1012,3,1
151,315,10,575,2492,3543,1820,138,14,1101,388,3461,3,2
194,380,4,660,2929,4167,2362,114,6,1067,430,3979,3,3
203,375,9,730,2781,4098,2248,115,9,1060,383,3815,3,4
180,455,14,731,2217,3597,1758,145,12,1092,545,3552,3,5
55,234,12,458,878,1637,146,103,8,1032,296,1585,3,6
42,261,14,520,929,1766,117,92,18,1115,368,1710,3,7
198,378,16,667,2636,3895,2251,110,16,924,442,3743,3,8
207,291,10,904,2582,3994,2548,85,12,865,306,3816,3,9
190,452,13,845,3153,4653,2602,100,14,1269,507,4492,3,10
197,538,9,750,2802,4296,2374,154,9,1102,513,4152,3,11
146,341,26,953,2088,3554,1724,135,5,1196,468,3528,3,12
68,345,25,748,2383,3569,145,157,9,2966,771,4048,3,13
45,300,6,633,1250,2234,131,113,6,1422,470,2142,3,14
71,258,7,567,857,1760,184,112,7,1120,333,1756,3,15
134,267,5,354,678,1438,438,102,3,566,309,1418,3,16
187,478,2,734,2785,4186,2341,152,4,1136,408,4041,3,17
195,636,1,770,3048,4650,2644,150,2,1154,587,4537,3,18
134,382,15,804,1441,2776,798,182,7,1873,402,3262,3,19
56,409,23,585,1198,2271,160,130,10,1323,546,2169,3,20
47,220,4,515,768,1554,109,71,4,1081,339,1604,3,21
202,541,5,877,2894,4519,2447,109,7,1235,486,4284,3,22
219,738,23,912,3407,5299,3040,122,22,1306,634,5124,3,23
241,745,12,871,3407,5276,3026,154,17,1288,636,5121,3,24
200,742,3,920,2990,4855,2730,156,3,1320,621,4830,3,25
177,555,25,1066,2355,4178,1913,181,10,1229,624,3957,3,26
60,392,32,675,1451,2610,168,154,13,1396,633,2364,3,27
56,228,4,515,763,1566,116,76,4,969,309,1474,3,28
198,580,4,944,2771,4497,2584,108,4,1157,523,4376,3,29
198,620,24,856,3409,5107,3077,134,22,1275,512,5020,3,30
207,739,3,956,3368,5273,3104,156,3,1395,633,5291,3,31
208,779,15,872,3028,4902,2679,164,17,1382,565,4807,3,32
192,463,58,907,2318,3938,1922,157,28,1209,497,3813,3,33
76,376,35,593,1314,2394,152,166,11,1354,506,2189,3,34
52,226,12,443,907,1640,119,94,18,936,343,1510,3,35
178,588,1,775,2789,4331,2426,134,2,1187,475,4224,3,36
224,709,3,897,3462,5295,3035,142,3,1390,595,5165,3,37
203,747,9,904,3342,5205,2980,130,3,1355,657,5125,3,38
188,728,8,826,3008,4758,2755,166,7,1278,569,4775,3,39
190,495,19,887,2321,3912,1934,182,12,1092,518,3738,3,40
36,491,24,731,1365,2647,187,210,8,1627,565,2597,3,41
56,223,1,425,871,1576,110,96,1,913,292,1412,3,42
212,657,1,848,2762,4480,2395,141,2,1206,589,4333,3,43
232,691,6,894,3219,5042,2722,146,6,1312,585,4771,3,44
241,885,18,913,3378,5435,2958,204,4,1353,779,5298,3,45
200,783,5,980,3065,5033,2705,162,7,1295,624,4793,3,46
155,508,27,1058,2235,3983,1930,192,11,1272,530,3935,3,47
48,338,23,852,2005,3266,144,144,12,2116,577,2993,3,48
73,327,0,746,1691,2837,125,113,1,2022,512,2773,3,49
79,461,9,795,1292,2636,374,98,10,1582,477,2541,3,50
202,646,5,935,3173,4961,2798,125,5,1383,525,4836,3,51
201,743,20,839,3348,5151,2938,144,24,1435,615,5156,3,52
186,769,5,845,3037,4842,2680,146,5,1351,649,4831,3,53
162,501,21,848,2428,3960,1908,150,8,1253,519,3838,3,54
48,388,26,616,1507,2585,167,185,13,1599,566,2530,3,55
54,271,25,516,1035,1901,138,102,21,1133,381,1775,3,56
193,671,13,764,2788,4429,2424,109,11,1132,602,4278,3,57
225,743,7,879,3196,5050,3014,104,3,1322,556,4999,3,58
209,660,1,817,3312,4999,2932,126,3,1225,818,5104,3,59
233,754,3,924,3088,5002,2642,146,4,1282,648,4722,3,60
205,623,23,909,2337,4097,1983,199,12,1248,636,4078,3,61
62,405,26,681,1275,2449,140,150,13,1655,455,2413,3,62
47,302,6,579,1315,2249,146,162,2,1398,454,2162,3,63
194,623,4,938,2924,4683,2492,144,2,1402,551,4591,3,64
209,715,2,959,3569,5454,2882,134,5,1709,618,5348,3,65
200,735,3,920,3604,5462,3084,127,2,1413,657,5283,3,66
210,929,13,1000,3316,5468,2683,213,10,1587,710,5203,3,67
182,548,23,997,2450,4200,1829,170,18,1404,715,4136,3,68
70,355,32,832,1660,2949,215,114,7,1850,506,2692,3,69
48,346,2,560,1493,2449,122,137,3,1552,476,2290,3,70
186,737,6,1013,3239,5181,2513,158,6,1831,613,5121,3,71
198,1070,3,1071,3866,6208,2961,220,7,2084,804,6076,3,72
200,973,4,1039,3905,6121,2910,181,4,2026,834,5955,3,73
189,1374,17,1126,3574,6280,2710,232,17,2057,1277,6293,3,74
193,517,30,1176,2968,4884,2005,210,8,1949,675,4847,3,75
297,664,25,3249,1875,6110,1770,305,9,3107,870,6061,3,76
46,465,5,648,1218,2382,216,151,5,1483,586,2441,3,77
194,598,6,843,2958,4599,2370,128,9,1450,631,4588,3,78
205,683,4,940,3642,5474,2814,158,6,1609,637,5224,3,79
239,835,5,959,3651,5689,2909,158,4,1626,827,5524,3,80
239,885,4,1074,3301,5503,2660,208,4,1633,745,5250,3,81
174,765,24,1026,2842,4831,1887,259,8,1863,890,4907,3,82
49,602,33,819,1930,3433,198,261,8,2633,771,3871,3,83
68,538,12,1041,2410,4069,318,160,15,2805,833,4131,3,84
203,930,13,1137,3664,5947,2529,204,12,2380,851,5976,3,85
210,1042,11,1342,4331,6936,3067,188,13,2798,959,7025,3,86
207,753,19,1431,4402,6812,2885,169,12,2821,830,6717,3,87
199,936,7,1347,3957,6446,2578,205,8,2749,872,6412,3,88
201,853,21,1493,3444,6012,1909,336,9,2928,931,6113,3,89
65,771,28,1524,3096,5484,300,308,8,4142,986,5744,3,90
42,468,14,796,1491,2811,182,173,12,1911,683,2961,3,91
183,770,13,1244,3605,5815,2369,267,11,2361,750,5758,3,92
219,900,5,1238,4200,6562,2963,149,6,2642,758,6518,3,93
223,873,2,1190,4407,6695,3147,236,2,2384,781,6550,3,94
207,1097,11,1314,4099,6728,2903,288,15,2439,933,6578,3,95
191,825,24,1265,3402,5707,2037,231,18,2459,874,5619,3,96
73,608,23,1372,2022,4098,586,339,5,2386,712,4028,3,97
95,468,7,1449,1057,3076,627,120,7,1408,516,2678,3,98
167,730,11,920,3551,5379,2358,124,7,1959,630,5078,3,99
199,893,3,987,3562,5644,2921,186,5,1660,757,5529,3,100
206,945,8,1133,3729,6021,3076,193,8,1857,774,5908,3,101
223,1203,5,1081,3421,5933,2776,229,5,1725,1024,5759,3,102
187,690,37,1192,2746,4852,2140,217,12,1737,708,4814,3,103
95,679,43,2930,5224,8971,1019,264,7,6901,1269,9460,3,104
68,630,3,1896,3183,5780,328,201,1,4685,760,5975,3,105
178,808,3,981,3121,5091,2377,158,3,1775,738,5051,3,106
181,1065,20,924,3458,5648,2686,227,25,1706,786,5430,3,107
177,926,12,1118,3434,5667,2936,161,11,1769,1722,6599,3,108
173,921,5,1010,3383,5492,2664,192,4,1710,704,5274,3,109
172,612,28,1096,2746,4654,1972,251,12,1661,655,4551,3,110
74,995,36,923,8521,10549,280,376,12,5405,6045,12118,3,111
50,349,1,631,1250,2281,167,96,2,1357,455,2077,3,112
193,656,1,921,3154,4925,2446,148,4,1496,639,4733,3,113
212,740,1,1060,3768,5781,3044,233,3,1660,626,5566,3,114
237,885,2,965,3797,5886,2918,280,3,1729,808,5738,3,115
196,863,8,1217,3556,5840,2664,296,8,1998,779,5745,3,116
160,747,27,1138,2667,4739,1992,238,7,1702,678,4617,3,117
68,472,22,786,1292,2640,301,191,7,1648,559,2706,3,118
53,415,1,536,1186,2191,163,157,2,1301,500,2123,3,119
156,680,9,881,3151,4877,2359,161,9,1473,630,4632,3,120
220,819,2,1064,3443,5548,2941,180,2,1543,649,5315,3,121
217,852,1,1074,3620,5764,3022,182,4,1579,802,5589,3,122
191,893,11,1003,3288,5386,2734,188,11,1570,822,5325,3,123
195,636,18,1191,2633,4673,1977,262,3,1572,596,4410,3,124
63,393,27,769,1184,2436,208,198,15,1423,471,2315,3,125
63,326,3,727,1038,2157,171,114,3,1311,381,1980,3,126
187,561,4,874,2991,4617,2316,148,5,1486,580,4535,3,127
183,731,10,1023,3537,5484,2989,229,12,1524,587,5341,3,128
211,877,2,1157,3740,5987,2989,285,3,1653,722,5652,3,129
207,1152,14,1029,3102,5504,2652,231,12,1553,959,5407,3,130
194,643,31,1031,2450,4349,1822,213,9,1417,539,4000,3,131
63,407,33,877,1313,2693,238,162,16,1718,465,2599,3,132
42,304,8,550,1020,1924,206,147,10,1395,387,2145,3,133
179,981,4,927,3106,5197,2426,318,5,1429,648,4826,3,134
213,561,2,1098,3692,5566,2904,143,3,1723,614,5387,3,135
221,806,8,995,3566,5596,2858,188,8,1598,691,5343,3,136
225,906,4,1039,3276,5450,2781,223,3,1610,751,5368,3,137
177,612,27,1035,2622,4473,1921,192,10,1645,737,4505,3,138
65,492,50,820,1968,3395,192,184,13,2073,566,3028,3,139
47,507,10,742,1329,2635,234,191,9,1579,512,2525,3,140
223,580,9,945,3282,5039,2499,232,11,1535,514,4791,3,141
251,816,7,1028,3788,5890,3054,313,4,1683,669,5723,3,142
189,699,7,1158,3496,5549,2951,172,6,1590,716,5435,3,143
210,695,8,1035,3156,5104,2594,198,10,1531,612,4945,3,144
160,614,26,1309,2248,4357,1765,306,9,1457,606,4143,3,145
66,547,17,890,1732,3252,270,289,10,1973,681,3223,3,146
65,638,3,915,1490,3111,201,254,1,1933,697,3086,3,147
51,280,3,777,1928,3039,225,148,4,2437,376,3190,3,148
209,579,9,986,3373,5156,2860,165,11,1522,554,5112,3,149
206,606,10,1035,3542,5399,2984,160,12,1451,583,5190,3,150
232,877,1,944,3227,5281,2732,218,2,1494,799,5245,3,151
189,1421,43,915,2667,5235,1942,276,21,1423,1478,5140,3,152
61,685,27,1113,2201,4087,304,232,7,2556,1072,4171,3,153
65,326,10,502,1091,1994,196,138,12,1204,457,2007,3,154
224,644,4,998,3403,5273,2694,238,2,1608,628,5170,3,155
216,870,2,1090,3818,5996,3146,215,1,1662,672,5696,3,156
223,770,4,1069,3720,5786,3076,243,2,1658,661,5640,3,157
200,862,8,1125,3576,5771,2813,311,9,1611,797,5541,3,158
165,1412,37,1000,2869,5483,1347,421,13,1603,1426,4810,3,159
99,2323,36,1016,4326,7800,338,513,11,1857,1299,4018,3,160
58,4578,5,1638,6103,12382,259,1080,5,5648,4527,11519,3,161
189,697,53,973,3169,5081,2706,140,42,1833,698,5419,3,162
254,1158,17,1151,3916,6496,3252,295,16,1961,951,6475,3,163
251,901,14,1170,4310,6646,3337,375,21,2114,787,6634,3,164
269,996,17,1121,3416,5819,2965,240,20,1890,746,5861,3,165
177,1260,41,1184,2734,5396,2008,338,11,1706,1293,5356,3,166
77,667,21,1006,2130,3901,282,311,11,2221,780,3605,3,167
60,402,6,686,1246,2400,190,133,1,1411,483,2218,3,168
190,636,28,928,3251,5033,2540,230,24,1487,627,4908,3,169
207,875,3,1197,3692,5974,2960,298,3,1846,768,5875,3,170
81,558,8,918,1742,3307,384,244,3,1766,647,3044,3,171
225,791,14,1176,3350,5556,2659,199,9,1726,977,5570,3,172
193,1398,35,974,2735,5335,1876,310,10,1581,1296,5073,3,173
83,2299,73,1633,2802,6890,298,1217,11,3085,1540,6151,3,174
51,500,42,977,2168,3738,230,159,22,2103,707,3221,3,175
185,704,27,914,3289,5119,2486,203,24,1491,658,4862,3,176
223,854,13,1054,3704,5848,3031,234,8,1700,690,5663,3,177
227,868,10,1129,3736,5970,2994,182,5,1839,704,5724,3,178
200,767,3,1151,3701,5822,2771,202,4,1913,677,5567,3,179
177,1327,35,1429,2764,5732,2002,328,11,2134,1365,5840,3,180
87,563,28,2843,2497,6018,325,272,13,2231,662,3503,3,181
62,394,4,677,1335,2472,158,158,4,1432,427,2179,3,182
199,540,2,1039,3202,4982,2472,211,3,1679,605,4970,3,183
239,883,5,1135,3738,6000,2920,307,11,1904,726,5868,3,184
191,787,6,1692,3023,5699,2378,419,3,1857,742,5399,3,185
92,5848,26,2917,2403,11286,787,5703,19,5008,2639,14156,3,186
113,647,25,1309,2787,4881,1146,316,13,2361,722,4558,3,187
79,453,22,942,1699,3195,233,274,7,1977,503,2994,3,188
48,321,1,646,1144,2160,176,138,2,1238,442,1996,3,189
201,577,2,1069,3372,5221,2396,196,3,1546,563,4704,3,190
263,838,8,1328,3823,6260,2936,224,6,1861,752,5779,3,191
235,895,9,1180,3569,5888,2931,231,9,1631,719,5521,3,192
202,870,15,1228,3444,5759,2829,229,9,1717,730,5514,3,193
170,576,30,1049,2600,4425,1912,262,10,1610,610,4404,3,194
91,494,32,824,1761,3202,240,335,16,1967,562,3120,3,195
42,349,17,612,1195,2215,163,153,15,1364,455,2150,3,196
180,527,1,921,3177,4806,2454,178,1,1471,561,4665,3,197
226,608,4,978,3612,5428,2805,213,3,1623,586,5230,3,198
195,648,2,1024,3673,5542,2883,164,2,1672,590,5311,3,199
194,776,3,924,3260,5157,2655,199,3,1693,650,5200,3,200
173,1224,31,1048,2469,4945,1779,378,33,1528,1270,4988,3,201
66,610,28,870,1754,3328,241,291,11,1878,585,3006,3,202
52,350,1,727,1103,2233,172,121,2,1373,492,2160,3,203
193,508,4,946,3097,4748,2333,150,4,1546,504,4537,3,204
224,756,4,951,3721,5656,2934,245,3,1694,665,5541,3,205
201,831,3,1585,3809,6429,2721,279,3,2293,777,6073,3,206
219,738,5,1075,3305,5342,2594,140,8,1672,789,5203,3,207
195,1265,40,1043,2585,5128,1868,296,12,1628,1214,5018,3,208
60,580,41,677,1401,2759,250,233,51,1561,677,2772,3,209
59,394,6,668,1243,2370,197,166,8,1376,538,2285,3,210
171,497,1,1011,3085,4765,2349,212,2,1618,551,4732,3,211
199,690,1,984,3487,5361,2916,159,1,1698,626,5400,3,212
193,639,2,1117,3526,5477,2888,170,6,1625,556,5245,3,213
213,695,1,990,3197,5096,2524,197,0,1565,601,4887,3,214
213,640,34,963,2550,4400,1851,239,3,1487,664,4244,3,215
68,441,24,812,1655,3000,250,169,12,1653,527,2611,3,216
46,314,4,632,1118,2114,188,129,3,1310,430,2060,3,217
181,503,2,902,3031,4619,2337,172,2,1431,473,4415,3,218
246,666,2,1013,3491,5418,2750,233,1,1619,625,5228,3,219
189,596,5,1001,3355,5146,2757,175,3,1550,568,5053,3,220
175,592,12,914,3045,4738,2373,153,10,1383,553,4472,3,221
156,466,24,744,2157,3547,1498,246,10,1280,460,3494,3,222
60,407,26,697,1359,2549,183,243,4,1567,542,2539,3,223
58,293,3,504,1129,1987,155,124,3,1114,450,1846,3,224
172,537,4,891,2784,4388,2240,160,2,1259,506,4167,3,225
181,761,1,990,3249,5182,2741,199,1,1552,639,5132,3,226
199,633,1,918,3233,4984,2630,197,1,1404,613,4845,3,227
192,681,3,868,2962,4706,2291,180,2,1459,657,4589,3,228
143,1107,34,867,2268,4419,1656,265,8,1449,1187,4565,3,229
67,443,28,639,1339,2516,177,182,10,1485,506,2360,3,230
55,255,2,546,957,1815,146,102,2,1103,405,1758,3,231
174,492,2,872,2778,4318,2259,168,2,1272,478,4179,3,232
191,638,2,956,3459,5246,2823,218,1,1453,562,5057,3,233
204,596,4,823,3384,5011,2675,186,4,1387,549,4801,3,234
186,663,8,883,2960,4700,2447,152,9,1297,591,4496,3,235
163,1124,30,852,2529,4698,1740,267,14,1355,1229,4605,3,236
64,520,40,708,1252,2584,212,236,8,1330,639,2425,3,237
47,370,5,1071,1712,3205,192,179,6,1927,566,2870,3,238
179,694,4,955,3141,4973,2509,184,3,1421,567,4684,3,239
213,709,4,1150,3588,5664,3040,228,4,1502,673,5447,3,240
202,838,7,1150,3582,5779,2908,211,7,1743,612,5481,3,241
213,619,3,1144,3166,5145,2671,95,4,1637,613,5020,3,242
153,470,28,1416,2074,4141,1798,217,15,1456,548,4034,3,243
67,451,17,1069,1783,3387,244,210,11,2151,629,3245,3,244
62,633,14,773,1343,2825,156,287,14,1643,731,2831,3,245
45,280,1,575,920,1821,170,134,1,1140,392,1837,3,246
218,728,1,1048,3454,5449,3062,112,5,1430,693,5302,3,247
324,870,1,1083,3571,5849,3171,132,1,1733,685,5722,3,248
201,956,2,1113,3306,5578,2924,153,1,1599,739,5416,3,249
194,555,35,1078,2536,4398,2198,193,10,1383,626,4410,3,250
106,514,22,1139,1306,3087,322,320,26,1595,487,2750,3,251
61,332,1,630,990,2014,191,132,1,1255,350,1929,3,252
215,828,1,907,3037,4988,2676,159,3,1562,682,5082,3,253
205,959,5,1149,3867,6185,3431,183,4,1654,729,6001,3,254
217,1005,5,1181,3991,6399,3332,201,5,1789,786,6113,3,255
206,1504,2,1117,3423,6252,3049,266,2,1633,1164,6114,3,256
210,735,50,1172,2866,5033,2268,317,11,1602,663,4861,3,257
77,656,28,873,1527,3161,207,302,10,1873,696,3088,3,258
57,363,6,804,1047,2277,153,129,5,1260,528,2075,3,259
189,768,1,1011,3194,5163,2748,115,1,1570,677,5111,3,260
216,860,21,1147,3913,6157,3403,208,22,1686,677,5996,3,261
217,1034,1,1114,3905,6271,3299,234,1,1876,834,6244,3,262
196,1037,3,1202,3514,5952,3008,211,2,1873,747,5841,3,263
182,959,28,1256,2673,5098,2132,410,9,1717,757,5025,3,264
74,552,22,848,1498,2994,256,288,19,1741,654,2958,3,265
54,371,1,548,1063,2037,151,137,2,1270,398,1958,3,266
169,727,3,1056,3295,5250,2656,115,4,1669,591,5035,3,267
190,888,1,1126,4054,6259,3414,171,2,1784,828,6199,3,268
197,864,3,1111,4034,6209,3254,173,3,1903,713,6046,3,269
168,980,3,1265,3711,6127,2987,208,3,1952,884,6034,3,270
174,662,24,1329,2850,5039,2216,256,9,1963,614,5058,3,271
68,1126,36,1500,3185,5915,271,444,11,3175,1413,5314,3,272
46,643,2,816,2208,3715,177,91,3,2478,704,3453,3,273
163,761,1,1123,3208,5256,2745,144,3,1730,599,5221,3,274
233,803,4,1160,3796,5996,3377,134,2,1719,646,5878,3,275
215,884,3,1140,3947,6189,3247,136,3,1846,658,5890,3,276
190,853,2,1195,3509,5749,2929,184,3,1803,729,5648,3,277
184,711,37,1254,2880,5066,2187,275,6,1787,614,4869,3,278
93,629,24,946,1663,3355,244,239,8,2019,739,3249,3,279
54,376,5,559,1174,2168,147,149,6,1369,511,2182,3,280
166,757,1,1108,3380,5412,2802,150,0,1727,689,5368,3,281
211,944,11,1354,3930,6450,3469,157,10,1959,734,6329,3,282
223,899,1,1230,4084,6437,3279,160,6,2107,733,6285,3,283
174,1330,1,1235,3694,6434,2996,231,0,1998,1094,6319,3,284
156,690,32,1377,2915,5170,1956,216,10,2161,694,5037,3,285
64,1264,33,1306,3775,6442,665,250,24,4485,1091,6515,3,286
95,479,1,802,1446,2823,268,147,2,1907,587,2911,3,287
79,703,1,958,1817,3558,742,147,1,1977,617,3484,3,288
204,1002,2,1176,3852,6236,3214,177,0,2030,746,6167,3,289
194,869,4,1205,4092,6364,3230,188,3,2094,657,6172,3,290
181,1014,3,1193,3581,5972,2936,169,4,2084,739,5932,3,291
164,841,37,1235,2946,5223,1988,302,39,2001,772,5102,3,292
57,635,56,1039,1706,3493,381,296,21,1819,798,3315,3,293
70,405,5,955,1882,3317,159,174,7,2132,671,3143,3,294
179,730,11,1095,3383,5398,2830,151,14,1669,702,5366,3,295
216,866,2,1098,3806,5988,3289,156,3,1826,817,6091,3,296
199,927,1,1278,3948,6353,3413,145,2,1910,755,6225,3,297
180,885,3,1167,3716,5951,3004,225,2,2025,794,6050,3,298
166,722,24,1380,3087,5379,2190,235,10,2011,740,5186,3,299
81,649,30,929,1701,3390,277,215,15,2067,789,3363,3,300
247,363,3,1006,1181,2800,2388,134,4,1591,485,4602,3,301
201,705,11,1115,3258,5290,2745,152,9,1805,606,5317,3,302
214,2371,1,1450,3981,8017,3332,246,2,1897,1930,7407,3,303
204,876,1,1180,4136,6397,3390,170,0,1934,806,6300,3,304
192,740,47,1228,3405,5612,2843,147,39,1603,574,5206,3,305
161,648,36,1154,2742,4741,2134,234,7,1692,711,4778,3,306
64,604,25,855,1474,3022,289,215,13,1935,734,3186,3,307
49,212,1,613,981,1856,154,93,2,1166,319,1734,3,308
172,697,9,1144,3257,5279,2810,104,8,1527,573,5022,3,309
151,576,7,1343,2914,4991,2727,108,7,1488,508,4838,3,310
179,730,3,1061,3288,5261,2788,151,2,1481,599,5021,3,311
193,783,4,1120,3411,5511,2884,128,2,1634,610,5258,3,312
164,628,24,1326,2650,4792,2128,178,10,1692,630,4638,3,313
59,564,24,831,1595,3073,197,187,6,1794,667,2851,3,314
48,268,2,726,1153,2197,151,71,3,1392,453,2070,3,315
67,481,4,933,1391,2876,655,129,4,1574,503,2865,3,316
205,855,1,1137,3754,5952,3326,169,0,1674,736,5905,3,317
213,928,2,1224,3905,6272,3338,125,0,1839,680,5982,3,318
202,1075,1,1229,3543,6050,3080,187,1,1707,914,5889,3,319
177,593,32,1172,2671,4645,2040,211,6,1749,550,4556,3,320
74,434,19,983,1641,3151,326,179,14,2048,584,3151,3,321
59,276,2,626,1122,2085,161,92,3,1371,318,1945,3,322
151,629,5,1067,3310,5162,2802,96,3,1480,615,4996,3,323
212,812,5,1139,3859,6027,3465,126,5,1711,625,5932,3,324
236,819,5,1173,4010,6243,3511,145,4,1767,633,6060,3,325
205,917,10,1107,3547,5786,3082,179,8,1630,697,5596,3,326
192,459,19,1290,2669,4629,2165,143,12,1518,517,4355,3,327
63,483,45,781,1375,2747,192,162,30,1686,606,2676,3,328
57,321,1,480,1084,1943,136,93,2,1250,419,1900,3,329
167,474,3,963,3094,4701,2460,126,3,1442,521,4552,3,330
166,496,37,1004,3058,4761,2343,112,30,1500,546,4531,3,331
142,364,37,1505,1589,3637,1533,108,36,1616,445,3738,3,332
100,155,2,328,584,1169,183,58,2,656,168,1067,3,333
70,358,12,1033,1699,3172,631,135,4,2043,442,3255,3,334
48,405,18,620,1285,2376,133,149,7,1572,462,2323,3,335
42,293,7,386,857,1585,104,128,8,954,360,1554,3,336
168,544,9,917,2862,4500,2461,142,7,1298,489,4397,3,337
205,726,11,984,3746,5672,3161,136,9,1580,721,5607,3,338
190,711,15,1098,3589,5603,3241,113,13,1546,651,5564,3,339
166,836,11,995,3532,5540,2896,169,9,1602,807,5483,3,340
192,740,26,964,2726,4648,2080,210,6,1562,713,4571,3,341
65,688,58,806,1514,3131,216,235,28,1710,792,2981,3,342
52,446,4,615,1210,2327,166,117,7,1428,580,2298,3,343
190,719,11,861,3119,4900,2603,141,9,1364,631,4748,3,344
199,914,6,1048,4036,6203,3231,161,7,1818,694,5911,3,345
208,757,16,1289,3907,6177,3194,141,15,1961,657,5968,3,346
210,1070,6,1221,3749,6256,2960,224,3,2066,976,6229,3,347
189,872,49,1283,3010,5403,2103,245,11,2029,971,5359,3,348
85,839,34,888,1567,3413,224,220,12,1815,744,3015,3,349
54,333,2,584,1035,2008,153,78,2,1260,337,1830,3,350
167,547,4,930,3080,4728,2570,90,4,1352,546,4562,3,351
200,748,48,981,3662,5639,2952,143,52,1572,685,5404,3,352
190,607,1,1168,3359,5325,2939,125,1,1494,591,5150,3,353
191,641,5,1017,2995,4849,2632,128,7,1398,628,4793,3,354
189,650,29,1201,2536,4605,1968,211,8,1666,603,4456,3,355
48,481,19,679,1330,2557,172,149,10,1508,557,2396,3,356
38,370,3,492,1022,1925,120,109,2,1209,513,1953,3,357
112,411,1,950,2152,3626,1359,98,2,1742,531,3732,3,358
98,240,3,574,759,1674,314,60,1,1011,276,1662,3,359
26,128,10,139,239,542,27,49,10,230,188,504,3,360
76,439,5,791,2027,3338,885,105,3,1836,630,3459,3,361
99,535,14,1107,2860,4615,1046,170,3,2950,739,4908,3,362
35,399,8,995,2029,3466,227,161,12,2877,539,3816,3,363
67,307,7,791,1961,3133,190,85,8,2540,538,3361,3,364
106,509,7,1193,2992,4807,1404,161,7,2648,673,4893,3,365
99,280,76,1350,1583,3388,1241,192,46,1498,422,3399,3,366
18,4,0,245,160,427,43,5,0,334,52,434,4,1
14,1,0,190,225,430,48,2,0,273,88,411,4,2
30,4,5,228,245,512,82,3,5,340,81,511,4,3
36,4,4,223,168,435,126,5,3,272,98,504,4,4
29,1,3,289,232,554,99,5,4,317,118,543,4,5
18,0,0,110,45,173,47,0,0,107,17,171,4,6
12,1,0,210,146,369,34,2,0,267,60,363,4,7
28,0,3,122,136,289,56,1,1,171,61,290,4,8
20,1,1,70,29,121,49,2,1,51,22,125,4,9
20,9,3,196,144,372,76,14,1,224,61,376,4,10
62,5,1,149,167,384,111,5,2,202,87,407,4,11
422,359,24,757,1020,2582,1214,244,14,862,649,2983,4,12
159,324,45,665,894,2087,206,246,29,970,597,2048,4,13
105,203,13,466,573,1360,96,236,8,686,484,1510,4,14
180,221,17,419,450,1287,258,266,13,577,388,1502,4,15
29,10,8,101,43,191,31,9,10,95,35,180,4,16
32,1,0,142,104,279,44,5,0,186,38,273,4,17
36,4,5,341,261,647,244,6,3,251,109,613,4,18
46,2,1,95,185,329,66,3,2,109,133,313,4,19
61,4,3,607,155,830,306,3,3,447,74,833,4,20
11,0,0,179,108,298,46,0,0,183,60,289,4,21
37,3,0,81,117,238,75,4,0,113,55,247,4,22
7,1,0,90,96,194,62,5,0,92,32,191,4,23
25,9,0,103,120,257,96,10,0,98,76,280,4,24
24,4,0,122,131,281,70,4,0,145,41,260,4,25
60,2,1,269,228,560,139,4,1,284,74,502,4,26
22,0,0,268,272,562,81,0,0,379,133,593,4,27
8,2,0,172,99,281,13,4,0,195,38,250,4,28
33,12,19,123,68,255,102,14,25,95,23,259,4,29
18,0,3,100,131,252,66,1,3,162,27,259,4,30
20,4,1,127,126,278,88,5,1,153,44,291,4,31
44,1,0,109,153,307,79,9,0,154,53,295,4,32
47,0,1,155,171,374,102,1,1,182,55,341,4,33
14,0,0,246,229,489,48,0,0,380,93,521,4,34
13,1,1,252,209,476,73,2,1,356,73,505,4,35
30,1,0,103,140,274,82,2,0,129,60,273,4,36
33,1,0,117,112,263,82,2,0,125,30,239,4,37
15,4,2,168,195,384,67,8,1,205,114,395,4,38
17,1,1,137,167,323,95,1,1,157,53,307,4,39
53,1,0,181,165,400,101,2,0,269,60,432,4,40
21,0,17,277,306,621,47,1,12,391,96,547,4,41
12,0,2,149,128,291,39,1,2,162,49,253,4,42
42,1,0,144,134,321,99,2,0,157,52,310,4,43
20,12,5,119,137,293,58,8,7,155,53,281,4,44
27,1,3,191,220,442,152,1,4,214,180,551,4,45
50,3,1,227,188,469,150,3,2,257,69,481,4,46
29,4,2,309,309,653,97,4,2,464,83,650,4,47
26,0,5,393,217,641,34,1,5,465,121,626,4,48
14,3,0,408,392,817,78,6,0,546,143,773,4,49
39,1,0,387,337,764,95,2,0,521,103,721,4,50
17,0,0,197,151,365,86,1,0,230,72,389,4,51
25,2,0,242,199,468,159,3,0,235,79,476,4,52
28,1,9,246,246,530,116,3,9,279,82,489,4,53
9,1,1,218,173,402,91,0,0,267,72,430,4,54
24,0,4,335,271,634,82,1,4,427,134,648,4,55
21,1,16,317,320,675,59,4,14,444,157,678,4,56
29,7,11,214,232,493,128,18,10,257,109,522,4,57
31,1,8,186,150,376,130,1,8,168,71,378,4,58
22,1,2,194,109,328,162,1,4,150,38,355,4,59
58,0,6,187,262,513,158,0,4,280,64,506,4,60
47,2,0,366,327,742,167,1,0,536,65,769,4,61
26,4,1,148,259,438,64,5,1,260,143,473,4,62
15,0,0,753,380,1148,237,0,0,712,157,1106,4,63
34,8,1,299,303,645,117,10,1,338,124,590,4,64
21,1,0,281,239,542,143,2,0,247,135,527,4,65
29,3,2,386,173,593,128,2,2,306,74,512,4,66
46,5,60,324,385,820,183,6,37,490,134,850,4,67
64,0,1,510,353,928,242,1,1,488,153,885,4,68
24,4,2,284,159,473,34,4,2,330,59,429,4,69
8,6,1,693,374,1082,182,8,1,713,177,1081,4,70
32,1,0,497,439,969,247,1,0,516,198,962,4,71
18,5,0,724,571,1318,212,4,1,904,292,1413,4,72
44,0,1,911,634,1590,446,1,1,825,290,1563,4,73
44,3,0,961,685,1693,286,2,0,1104,356,1748,4,74
66,0,3,762,508,1339,314,0,4,912,176,1406,4,75
64,1,0,907,652,1624,337,12,0,1149,284,1782,4,76
8,11,0,826,644,1489,161,12,0,1031,275,1479,4,77
59,4,1,625,470,1159,179,5,1,688,171,1044,4,78
37,5,10,527,557,1136,270,5,13,629,237,1154,4,79
29,0,0,500,557,1086,159,1,0,792,273,1225,4,80
34,4,0,570,521,1129,256,2,1,642,206,1107,4,81
58,3,5,751,645,1462,234,4,4,976,314,1532,4,82
34,0,13,270,549,866,64,1,11,520,217,813,4,83
30,3,0,1327,1353,2713,413,2,0,1741,587,2743,4,84
45,5,0,1283,1120,2453,336,1,0,1650,410,2397,4,85
29,1,5,1428,1215,2678,441,1,8,1833,473,2756,4,86
29,6,2,639,301,977,190,6,2,581,161,940,4,87
57,1,2,965,805,1830,300,3,2,1124,377,1806,4,88
40,2,10,1403,1336,2791,333,5,1,1917,491,2747,4,89
21,2,0,1638,1275,2936,321,2,0,2125,391,2839,4,90
87,4,0,1175,1075,2341,166,5,0,1849,478,2498,4,91
33,36,17,663,608,1357,156,11,11,890,246,1314,4,92
28,40,0,742,436,1246,260,16,1,782,223,1282,4,93
30,26,4,428,267,755,137,8,6,461,120,732,4,94
69,32,18,1697,1121,2937,514,21,19,2136,344,3034,4,95
56,19,0,1585,905,2565,479,29,0,1854,325,2687,4,96
20,35,0,1286,653,1994,182,15,0,1526,231,1954,4,97
41,38,0,936,878,1893,276,22,0,1129,344,1771,4,98
28,34,9,486,397,954,175,18,6,575,133,907,4,99
27,18,0,482,394,921,167,17,0,611,132,927,4,100
31,22,8,596,430,1087,179,19,7,625,176,1006,4,101
32,16,2,569,241,860,258,23,3,509,152,945,4,102
82,20,3,1139,441,1685,293,17,3,1016,215,1544,4,103
34,43,0,834,699,1610,272,32,0,1107,234,1645,4,104
17,34,1,1088,739,1879,284,21,1,1241,302,1849,4,105
34,43,3,556,402,1038,183,23,4,737,156,1103,4,106
20,30,1,578,491,1120,234,15,1,691,163,1104,4,107
34,24,0,491,415,964,222,25,0,688,209,1144,4,108
29,41,4,666,554,1294,267,20,5,866,172,1330,4,109
38,23,4,658,438,1161,235,6,3,857,124,1225,4,110
43,43,0,777,604,1467,288,15,0,911,250,1464,4,111
34,31,0,766,385,1216,176,18,0,818,133,1145,4,112
37,32,13,568,449,1099,232,10,13,630,187,1072,4,113
35,36,6,424,434,935,165,15,6,564,151,901,4,114
32,28,0,569,354,983,201,12,0,564,140,917,4,115
39,29,4,786,365,1223,453,30,5,789,162,1439,4,116
87,28,0,733,561,1409,315,20,0,807,239,1381,4,117
31,28,0,783,381,1223,225,20,0,790,154,1189,4,118
12,68,8,708,506,1302,102,56,9,906,194,1267,4,119
35,29,5,604,329,1002,231,21,7,535,189,983,4,120
20,32,3,385,366,806,233,24,3,343,183,786,4,121
29,59,0,379,466,933,194,23,0,624,136,977,4,122
59,33,12,444,571,1119,192,14,12,720,210,1148,4,123
69,15,1,738,537,1360,243,14,1,932,211,1401,4,124
22,14,1,535,310,882,117,13,1,618,130,879,4,125
32,59,6,364,396,857,99,19,5,523,177,823,4,126
29,33,0,448,410,920,149,22,0,601,151,923,4,127
32,35,1,484,310,862,177,15,1,556,131,880,4,128
51,37,15,530,531,1164,182,17,13,665,226,1103,4,129
56,29,0,524,497,1106,215,26,0,697,173,1111,4,130
69,21,1,513,286,890,248,18,0,527,129,922,4,131
27,8,0,787,583,1405,172,11,0,961,206,1350,4,132
13,21,0,679,462,1175,131,14,0,748,193,1086,4,133
25,35,0,881,474,1415,266,20,1,1027,222,1536,4,134
31,18,0,631,264,944,212,14,0,576,126,928,4,135
43,25,0,470,439,977,262,12,0,577,114,965,4,136
50,52,1,823,538,1464,310,34,1,951,223,1519,4,137
87,35,1,926,601,1650,333,11,1,1003,195,1543,4,138
32,12,0,464,338,846,131,14,0,594,120,859,4,139
21,54,0,799,443,1317,173,39,0,929,153,1294,4,140
14,30,3,747,460,1254,320,28,3,762,168,1281,4,141
47,36,2,684,382,1151,312,17,4,647,195,1175,4,142
28,47,1,848,377,1301,448,11,1,845,144,1449,4,143
50,37,1,686,373,1147,242,20,2,586,139,989,4,144
46,50,1,806,513,1416,237,28,1,1031,190,1487,4,145
31,44,0,1449,836,2360,480,34,0,1575,310,2399,4,146
26,40,0,2615,1232,3913,614,28,0,2653,362,3657,4,147
34,33,0,2482,913,3462,699,16,1,2306,418,3440,4,148
72,22,15,642,487,1238,227,20,11,770,162,1190,4,149
51,27,8,670,246,1002,295,12,10,640,95,1052,4,150
54,49,22,1003,631,1759,421,23,15,872,198,1529,4,151
91,35,1,837,491,1455,383,18,1,866,226,1494,4,152
37,113,6,874,569,1599,322,25,3,1078,351,1779,4,153
26,77,38,1008,611,1760,206,26,27,950,260,1469,4,154
39,44,34,717,456,1290,231,21,22,788,193,1255,4,155
53,63,26,654,430,1226,310,30,22,648,198,1208,4,156
74,25,10,789,297,1195,343,15,9,772,123,1262,4,157
71,51,21,706,399,1248,299,23,26,685,215,1248,4,158
81,40,0,1147,635,1903,307,27,0,1305,262,1901,4,159
40,42,0,1164,735,1981,357,40,0,1236,326,1959,4,160
8,34,6,993,630,1671,295,23,8,1121,251,1698,4,161
57,45,0,772,689,1563,294,41,0,964,255,1554,4,162
50,156,2,817,582,1607,258,38,0,974,323,1593,4,163
45,60,2,861,507,1475,319,44,2,939,244,1548,4,164
64,74,3,727,561,1429,322,43,1,796,221,1383,4,165
68,28,0,1126,508,1730,436,17,0,937,218,1608,4,166
38,42,3,868,621,1572,276,26,5,1033,264,1604,4,167
14,39,1,833,531,1418,188,18,1,1009,179,1395,4,168
41,36,0,681,380,1138,216,19,0,704,153,1092,4,169
57,59,2,853,442,1413,316,15,3,879,221,1434,4,170
38,43,19,817,436,1353,227,29,25,893,150,1324,4,171
61,41,0,697,452,1251,306,33,0,684,233,1256,4,172
63,23,0,1264,391,1741,650,28,0,935,192,1805,4,173
50,22,0,998,348,1418,481,25,0,853,129,1488,4,174
48,14,2,726,417,1207,224,47,2,765,171,1209,4,175
73,32,8,679,435,1227,254,33,5,744,235,1271,4,176
51,108,9,612,423,1203,207,35,8,685,248,1183,4,177
52,40,10,562,330,994,227,28,11,585,169,1020,4,178
65,42,1,685,539,1332,234,25,0,816,242,1317,4,179
75,35,15,1261,513,1899,377,32,8,1280,225,1922,4,180
29,35,0,898,565,1527,285,36,0,915,244,1480,4,181
35,25,1,841,410,1312,216,17,1,937,166,1337,4,182
56,41,1,735,533,1366,269,11,0,820,196,1296,4,183
50,65,4,749,485,1353,267,29,1,770,178,1245,4,184
53,48,5,912,568,1586,280,35,6,1069,254,1644,4,185
52,3715,25,1193,910,5895,316,4026,23,1262,1018,6645,4,186
71,44,0,1282,639,2036,319,27,0,1392,329,2067,4,187
31,43,2,905,543,1524,231,27,3,1063,221,1545,4,188
20,21,5,765,487,1298,248,27,5,888,181,1349,4,189
82,44,2,639,412,1179,250,37,1,678,154,1120,4,190
56,67,2,603,346,1074,243,32,2,577,254,1108,4,191
49,29,8,565,418,1069,231,23,8,574,195,1031,4,192
77,50,5,774,379,1285,351,32,3,691,245,1322,4,193
72,18,0,510,702,1302,197,14,0,899,173,1283,4,194
36,41,0,924,594,1595,184,28,0,1073,238,1523,4,195
21,55,0,902,373,1351,214,27,0,910,131,1282,4,196
30,38,5,567,261,901,164,29,4,548,129,874,4,197
30,64,1,374,301,770,164,25,3,449,148,789,4,198
66,14,2,566,331,979,273,21,2,528,134,958,4,199
47,52,3,700,550,1352,206,30,4,837,270,1347,4,200
62,48,0,1046,511,1667,284,25,0,1007,231,1547,4,201
28,56,0,884,510,1478,249,39,0,985,146,1419,4,202
12,47,30,951,486,1526,191,34,27,1058,181,1491,4,203
61,33,0,514,289,897,190,27,0,514,151,882,4,204
33,60,2,801,453,1349,489,31,0,622,203,1345,4,205
56,38,0,758,533,1385,211,29,0,911,212,1363,4,206
43,34,19,581,487,1164,196,33,11,638,257,1135,4,207
49,50,4,748,569,1420,235,28,4,852,293,1412,4,208
21,52,1,848,626,1548,206,26,1,1114,225,1572,4,209
17,24,21,869,656,1587,160,29,18,1050,185,1442,4,210
35,40,3,695,392,1165,195,20,3,680,207,1105,4,211
56,81,4,487,476,1104,160,22,5,576,252,1015,4,212
35,47,0,694,425,1201,162,17,0,812,131,1122,4,213
38,55,2,623,376,1094,245,48,2,635,157,1087,4,214
71,38,0,632,386,1127,196,28,0,726,162,1112,4,215
58,14,0,813,371,1256,277,7,0,847,134,1265,4,216
25,27,6,835,558,1451,191,26,5,988,196,1406,4,217
60,58,7,513,309,947,213,42,6,576,144,981,4,218
47,66,4,566,331,1014,221,25,3,575,225,1049,4,219
56,36,9,556,336,993,236,32,10,635,139,1052,4,220
69,17,0,438,271,795,145,11,0,508,139,803,4,221
74,48,0,195,304,621,122,30,0,338,173,663,4,222
26,52,0,864,511,1453,162,37,0,947,215,1361,4,223
11,64,10,579,569,1233,120,20,10,885,251,1286,4,224
48,67,7,507,389,1018,197,47,5,564,203,1016,4,225
39,70,26,442,357,934,138,28,23,477,249,915,4,226
40,34,14,505,375,968,181,26,10,544,189,950,4,227
49,40,0,565,414,1068,191,26,0,647,191,1055,4,228
75,57,3,621,485,1241,215,36,2,770,241,1264,4,229
23,34,0,663,475,1195,183,15,0,791,158,1147,4,230
8,23,1,420,406,858,90,18,1,575,206,890,4,231
59,36,1,386,286,768,152,14,1,463,136,766,4,232
31,42,8,396,328,805,113,13,6,444,174,750,4,233
43,36,1,427,474,981,153,33,1,479,231,897,4,234
55,23,0,371,345,794,156,14,0,444,159,773,4,235
39,36,0,441,370,886,96,30,0,582,151,859,4,236
23,34,0,573,404,1034,141,18,0,657,149,965,4,237
15,26,24,502,303,870,66,13,24,620,119,842,4,238
65,27,20,325,207,644,175,16,10,370,100,671,4,239
81,38,11,360,308,798,203,19,12,429,166,829,4,240
37,30,19,439,210,735,116,19,13,473,108,729,4,241
53,44,0,406,261,764,138,40,0,459,124,761,4,242
25,33,0,397,300,755,126,23,0,454,108,711,4,243
15,51,0,658,520,1244,143,14,0,829,211,1197,4,244
15,40,7,792,530,1384,134,16,8,1028,211,1397,4,245
22,54,2,583,438,1099,131,22,4,693,190,1040,4,246
52,46,2,271,256,627,112,28,2,340,109,591,4,247
47,23,5,295,285,655,105,15,5,408,104,637,4,248
66,34,3,542,344,989,173,10,3,567,152,905,4,249
49,36,19,397,315,816,162,27,19,457,120,785,4,250
22,38,0,618,349,1027,132,17,0,623,141,913,4,251
16,30,10,564,371,991,130,18,11,676,156,991,4,252
36,34,0,364,287,721,131,12,2,445,100,690,4,253
52,41,1,414,325,833,153,24,1,527,136,841,4,254
48,48,29,409,321,855,144,29,23,497,135,828,4,255
59,53,13,412,359,896,119,39,17,519,185,879,4,256
90,26,0,474,394,984,176,25,0,671,116,988,4,257
40,33,0,629,457,1159,127,12,0,729,184,1052,4,258
17,27,24,682,414,1164,120,24,24,749,173,1090,4,259
46,23,9,436,353,867,151,15,9,550,132,857,4,260
36,25,0,350,269,680,124,13,0,331,93,561,4,261
39,32,0,284,300,655,102,27,0,424,105,658,4,262
75,36,0,584,340,1035,234,84,0,578,142,1038,4,263
56,21,0,522,399,998,245,13,0,612,113,983,4,264
30,18,0,678,444,1170,180,13,0,781,194,1168,4,265
14,32,3,492,440,981,91,16,3,694,113,917,4,266
53,20,0,428,390,891,161,17,0,559,119,856,4,267
55,16,2,393,305,771,138,10,2,507,109,766,4,268
35,18,7,251,255,566,113,15,9,340,110,587,4,269
38,22,0,486,512,1058,170,16,0,682,163,1031,4,270
50,23,4,331,298,706,123,15,5,464,123,730,4,271
14,35,2,672,605,1328,154,11,0,898,280,1343,4,272
13,20,3,465,397,898,111,15,3,558,93,780,4,273
35,22,0,234,263,554,118,18,0,274,102,512,4,274
29,1,4,144,218,396,88,1,4,165,130,388,4,275
33,3,0,409,254,699,140,7,0,492,121,760,4,276
42,0,0,442,385,869,165,1,0,610,160,936,4,277
53,5,0,571,489,1118,196,9,0,760,142,1107,4,278
35,1,6,665,599,1306,167,2,7,801,160,1137,4,279
10,0,0,680,449,1139,82,1,0,724,176,983,4,280
31,2,1,518,416,968,213,2,1,666,172,1054,4,281
27,4,0,395,474,900,160,2,2,568,178,910,4,282
22,0,2,620,409,1053,191,1,5,544,175,916,4,283
18,2,3,522,439,984,120,3,3,682,144,952,4,284
53,0,0,654,673,1380,184,2,0,811,351,1348,4,285
27,1,0,973,859,1860,194,1,0,1372,312,1879,4,286
73,1,0,1298,814,2186,352,2,2,1369,295,2020,4,287
33,2,0,739,587,1361,243,3,0,886,207,1339,4,288
16,4,0,453,380,853,155,5,0,540,145,845,4,289
44,2,0,503,432,981,188,2,0,611,162,963,4,290
18,8,2,503,515,1046,184,7,0,643,171,1005,4,291
68,0,4,624,536,1232,238,1,4,770,238,1251,4,292
28,1,0,746,535,1310,139,2,0,969,181,1291,4,293
7,0,0,630,536,1173,102,1,0,875,175,1153,4,294
17,2,2,558,342,921,211,2,2,502,157,874,4,295
29,4,0,329,330,692,126,4,0,515,140,785,4,296
30,0,0,422,409,861,198,1,0,462,123,784,4,297
57,2,0,438,285,782,154,2,0,615,95,866,4,298
66,0,0,605,566,1237,227,1,0,797,272,1297,4,299
36,0,0,948,747,1731,146,1,0,1304,255,1706,4,300
464,15,0,2782,1060,4321,865,10,1,5702,213,6791,4,301
47,0,1,628,398,1074,207,5,1,739,124,1076,4,302
37,3,2,326,444,812,113,4,2,508,217,844,4,303
30,7,1,388,324,750,174,10,1,446,169,800,4,304
51,1,0,415,251,718,189,2,0,428,94,713,4,305
26,0,1,317,335,679,77,1,2,380,164,624,4,306
18,1,0,461,402,882,125,2,0,548,159,834,4,307
20,4,0,394,427,845,105,4,1,549,188,847,4,308
41,5,1,289,241,577,113,5,0,313,124,555,4,309
54,2,2,204,181,443,131,1,5,219,77,433,4,310
41,3,1,279,209,533,113,2,2,323,90,530,4,311
34,3,0,290,248,575,111,4,0,329,81,525,4,312
47,1,0,311,304,663,151,2,0,444,101,698,4,313
22,2,0,675,448,1147,130,7,0,834,128,1099,4,314
14,0,2,449,329,794,96,1,2,545,127,771,4,315
34,3,0,1114,554,1705,442,3,0,1036,194,1675,4,316
33,0,0,339,159,531,138,1,0,285,69,493,4,317
18,2,0,253,171,444,63,2,0,279,57,401,4,318
33,0,1,211,155,400,100,4,1,224,72,401,4,319
40,0,6,261,199,506,106,1,6,280,77,470,4,320
19,0,0,449,370,838,136,1,0,562,160,859,4,321
8,0,2,350,301,661,58,1,2,500,89,650,4,322
43,7,0,255,184,489,119,8,0,232,77,436,4,323
23,1,0,173,168,365,117,2,0,195,67,381,4,324
48,1,0,172,178,399,90,2,0,282,54,428,4,325
30,2,0,257,147,436,154,2,0,241,63,460,4,326
52,1,1,252,111,417,135,1,1,248,42,427,4,327
16,0,0,334,340,690,79,1,0,426,129,635,4,328
10,0,0,427,246,683,80,1,0,494,98,673,4,329
30,6,0,428,285,749,162,4,0,630,93,889,4,330
19,1,0,318,297,635,89,2,0,429,106,626,4,331
19,4,3,401,294,721,105,3,4,474,101,687,4,332
14,0,1,107,152,274,30,1,1,195,53,280,4,333
42,1,0,396,288,727,102,2,0,499,89,692,4,334
13,0,0,346,192,551,63,1,0,439,69,572,4,335
8,0,0,228,192,428,46,1,0,242,73,362,4,336
25,0,2,121,139,287,71,1,2,144,55,273,4,337
7,3,0,139,116,265,60,1,0,168,32,261,4,338
26,6,1,144,132,309,99,7,2,130,53,291,4,339
32,1,0,308,124,465,278,1,1,153,47,480,4,340
36,3,0,212,203,454,140,4,0,254,94,492,4,341
10,1,0,301,180,492,51,1,0,407,68,527,4,342
20,0,0,544,269,833,123,1,0,631,112,867,4,343
50,1,0,119,165,335,120,1,0,158,81,360,4,344
35,3,0,153,155,346,101,4,0,183,135,423,4,345
23,0,0,97,80,200,54,1,0,94,41,190,4,346
14,1,5,281,184,485,116,2,5,250,68,441,4,347
36,2,0,405,322,765,116,1,0,532,128,777,4,348
674,1,0,6636,256,7567,5649,2,0,1307,89,7047,4,349
16,0,0,455,177,648,69,2,0,484,55,610,4,350
30,1,0,166,152,349,89,1,0,190,58,338,4,351
26,1,2,223,173,425,105,3,2,264,61,435,4,352
18,1,2,191,163,375,82,2,2,209,68,363,4,353
21,7,2,184,145,359,71,10,2,234,36,353,4,354
26,0,0,165,162,353,93,1,0,186,82,362,4,355
6,0,0,204,156,366,34,1,0,277,44,356,4,356
3,0,0,147,172,322,18,1,0,233,72,324,4,357
41,5,0,158,160,364,73,6,0,241,74,394,4,358
29,2,0,93,109,233,38,3,0,141,37,219,4,359
5,1,0,121,153,280,23,3,0,224,55,305,4,360
8,4,1,159,180,352,34,9,1,287,81,412,4,361
41,2,0,450,489,982,102,2,0,688,181,973,4,362
5,1,0,324,202,532,39,2,0,370,89,500,4,363
15,0,0,555,411,981,80,1,0,742,107,930,4,364
45,4,0,525,491,1065,147,4,0,777,193,1121,4,365
19,0,0,352,236,607,91,1,0,424,87,603,4,366
46,44,0,198,108,396,14,121,10,143,202,490,5,1
681,36,1,292,116,1126,61,199,5,125,737,1127,5,2
777,30,4,277,215,1303,49,353,11,160,750,1323,5,3
734,45,1,278,142,1200,56,247,15,128,740,1186,5,4
403,58,0,263,252,976,56,300,25,138,487,1006,5,5
50,28,2,215,131,426,13,180,31,118,148,490,5,6
45,34,0,387,121,587,12,296,11,123,197,639,5,7
668,31,0,226,156,1081,48,277,11,114,611,1061,5,8
845,17,2,156,90,1110,58,186,5,161,723,1133,5,9
916,40,5,233,131,1325,56,278,16,106,849,1305,5,10
818,35,0,194,213,1260,56,303,13,130,763,1265,5,11
324,46,3,180,148,701,67,173,17,109,362,728,5,12
71,41,2,495,121,730,17,298,21,129,312,777,5,13
39,36,0,193,65,333,18,98,5,116,168,405,5,14
92,31,0,193,95,411,33,104,1,111,166,415,5,15
184,26,0,114,134,458,51,155,7,77,164,454,5,16
649,45,2,147,106,949,50,255,16,108,551,980,5,17
843,35,2,179,169,1228,54,297,13,127,724,1215,5,18
179,28,2,145,142,496,31,153,25,90,212,511,5,19
92,31,4,281,156,564,15,203,33,149,188,588,5,20
78,31,1,239,144,493,10,161,10,129,223,533,5,21
621,34,0,229,92,976,54,202,8,121,596,981,5,22
939,38,8,212,121,1318,52,284,15,124,836,1311,5,23
981,45,4,209,132,1371,58,347,10,128,795,1338,5,24
826,26,0,182,140,1174,54,287,8,131,740,1220,5,25
478,50,4,240,200,972,60,249,53,155,486,1003,5,26
122,65,1,616,199,1003,19,326,52,161,495,1053,5,27
57,72,2,308,107,546,14,130,15,159,259,577,5,28
705,33,0,161,98,997,60,169,17,122,590,958,5,29
1011,44,3,189,137,1384,58,304,16,149,843,1370,5,30
938,55,1,183,138,1315,55,312,12,109,820,1308,5,31
836,48,0,201,127,1212,68,251,13,116,750,1198,5,32
432,74,0,205,238,949,54,237,42,172,469,974,5,33
125,53,0,355,173,706,20,212,34,156,337,759,5,34
51,48,0,365,94,558,21,211,12,123,251,618,5,35
712,41,0,177,118,1048,62,180,16,109,630,997,5,36
1001,36,3,189,142,1371,57,271,10,124,869,1331,5,37
963,52,2,178,139,1334,71,320,18,110,820,1339,5,38
879,41,0,153,125,1198,53,220,14,123,773,1183,5,39
453,68,1,310,179,1011,48,238,62,177,549,1074,5,40
108,84,4,464,205,865,15,266,55,143,333,812,5,41
57,66,0,402,123,648,18,146,35,218,332,749,5,42
664,30,0,178,121,993,69,219,10,119,591,1008,5,43
739,48,2,196,189,1174,59,340,6,118,623,1146,5,44
950,45,1,183,135,1314,53,284,11,142,814,1304,5,45
878,34,0,199,148,1259,58,288,18,149,756,1269,5,46
429,92,0,222,231,974,61,261,70,179,470,1041,5,47
86,45,0,285,152,568,27,175,34,156,246,638,5,48
64,37,0,346,141,588,9,209,11,151,276,656,5,49
196,53,1,280,134,664,37,153,14,156,342,702,5,50
962,42,0,237,148,1389,61,306,18,126,891,1402,5,51
1031,28,3,205,104,1371,56,256,18,131,918,1379,5,52
876,28,0,199,134,1237,55,286,13,124,733,1211,5,53
474,70,0,204,156,904,36,186,26,170,517,935,5,54
101,57,2,389,252,801,16,259,56,169,337,837,5,55
50,37,0,308,124,519,19,176,11,145,239,590,5,56
676,45,0,161,167,1049,67,212,10,134,637,1060,5,57
981,39,5,191,139,1355,57,300,16,138,852,1363,5,58
981,31,3,193,123,1331,56,266,17,117,871,1327,5,59
820,40,0,180,128,1168,49,263,17,110,769,1208,5,60
448,53,0,223,348,1072,52,359,48,176,510,1145,5,61
126,72,1,369,179,747,23,276,25,187,289,800,5,62
80,43,1,453,141,718,16,207,15,153,366,757,5,63
759,57,0,277,106,1199,49,218,11,146,752,1176,5,64
1016,42,5,292,123,1478,56,272,17,166,954,1465,5,65
990,42,3,262,177,1474,53,397,27,149,850,1476,5,66
847,37,0,246,191,1321,69,322,28,162,829,1410,5,67
465,86,1,294,223,1069,58,308,75,171,539,1151,5,68
162,67,0,450,209,888,25,346,40,176,344,931,5,69
68,55,1,378,137,639,21,213,10,167,320,731,5,70
675,45,0,230,116,1066,53,223,12,130,659,1077,5,71
998,35,4,282,149,1468,66,310,14,134,922,1446,5,72
1048,34,2,317,138,1539,50,350,28,131,1009,1568,5,73
895,46,0,382,192,1515,55,363,38,172,945,1573,5,74
472,82,0,269,235,1058,62,246,90,181,561,1140,5,75
151,92,2,906,278,1429,20,501,136,223,611,1491,5,76
98,55,1,487,222,863,15,361,21,165,386,948,5,77
734,45,0,296,128,1203,56,245,10,142,729,1182,5,78
1042,38,4,297,131,1512,51,343,25,163,938,1520,5,79
1084,51,1,371,264,1771,73,505,37,162,968,1745,5,80
902,69,0,364,159,1494,60,362,20,205,906,1553,5,81
507,85,0,487,394,1473,56,424,71,208,670,1429,5,82
118,58,1,436,276,889,19,330,76,152,302,879,5,83
242,66,1,1178,158,1645,19,475,7,244,947,1692,5,84
721,57,0,756,277,1811,55,409,86,178,1035,1763,5,85
976,46,1,669,263,1955,63,518,18,178,1082,1859,5,86
799,38,0,320,155,1312,57,287,16,167,849,1376,5,87
683,43,0,430,139,1295,48,308,13,153,885,1407,5,88
464,66,0,882,238,1650,62,472,48,224,888,1694,5,89
200,90,5,1490,339,2124,29,862,62,292,1082,2327,5,90
105,79,1,565,228,978,17,349,17,231,457,1071,5,91
685,39,0,506,171,1401,62,404,26,148,660,1300,5,92
986,47,0,288,113,1434,61,294,16,134,952,1457,5,93
944,33,0,224,177,1378,54,345,24,157,853,1433,5,94
922,56,0,379,226,1583,64,475,36,154,936,1665,5,95
513,59,0,461,263,1296,53,380,36,180,678,1327,5,96
137,72,0,595,168,972,28,355,54,210,382,1029,5,97
177,58,0,498,190,923,14,318,13,223,370,938,5,98
658,34,0,234,115,1041,54,194,22,173,610,1053,5,99
986,47,2,265,150,1450,66,332,46,147,910,1501,5,100
1009,52,0,332,127,1520,54,345,39,198,936,1572,5,101
899,38,1,234,158,1330,56,300,31,128,823,1338,5,102
486,69,5,248,216,1024,45,292,47,170,524,1078,5,103
196,65,1,583,295,1140,26,479,37,206,479,1227,5,104
130,69,0,483,166,848,25,254,15,173,403,870,5,105
669,57,3,276,176,1181,67,258,21,148,672,1166,5,106
993,57,0,322,144,1516,63,376,20,150,897,1506,5,107
1018,37,0,232,170,1457,67,333,28,137,912,1477,5,108
955,53,1,310,158,1477,64,333,22,198,1021,1638,5,109
490,99,0,255,265,1109,72,289,68,206,548,1183,5,110
159,88,7,914,263,1431,28,702,89,200,442,1461,5,111
55,63,1,413,129,661,23,204,25,202,324,778,5,112
742,61,1,266,143,1213,69,245,20,170,647,1151,5,113
1035,45,1,262,188,1531,65,353,22,146,903,1489,5,114
1037,49,0,278,236,1600,49,409,30,174,935,1597,5,115
1043,40,0,321,194,1598,59,403,42,229,947,1680,5,116
510,69,0,277,321,1177,67,365,76,182,509,1199,5,117
139,76,2,376,221,814,31,276,83,184,298,872,5,118
93,81,0,448,184,806,21,273,63,188,339,884,5,119
709,39,0,220,110,1078,63,218,23,154,678,1136,5,120
1038,54,0,217,140,1449,62,260,23,158,929,1432,5,121
1025,64,0,244,154,1487,68,366,40,158,839,1471,5,122
872,68,2,265,145,1352,58,306,22,129,838,1353,5,123
491,95,0,264,267,1117,66,319,30,219,522,1156,5,124
130,68,6,446,187,837,54,316,60,170,302,902,5,125
50,67,0,388,128,633,22,277,18,141,232,690,5,126
727,59,1,242,142,1171,77,214,15,178,675,1159,5,127
1086,58,2,329,248,1723,119,421,34,192,953,1719,5,128
1029,52,0,310,227,1618,79,407,70,188,906,1650,5,129
878,68,1,250,159,1356,66,349,26,182,881,1504,5,130
435,95,3,275,206,1014,48,250,58,224,515,1095,5,131
138,102,4,456,171,871,26,325,37,232,363,983,5,132
64,103,1,365,146,679,29,196,14,189,279,707,5,133
785,52,1,293,170,1301,82,256,13,185,733,1269,5,134
1045,58,1,255,155,1514,64,316,25,161,954,1520,5,135
1063,54,1,240,159,1517,67,359,20,165,899,1510,5,136
956,68,0,331,182,1537,71,395,22,189,893,1570,5,137
532,105,0,315,211,1163,65,282,46,207,626,1226,5,138
91,113,0,423,192,819,17,284,61,134,357,853,5,139
155,63,0,439,151,808,42,248,20,216,308,834,5,140
810,54,0,315,223,1402,61,318,41,160,814,1394,5,141
1120,62,0,294,178,1654,71,369,21,195,1031,1687,5,142
1070,56,0,317,156,1599,77,387,24,159,1066,1713,5,143
931,87,0,268,174,1460,93,358,31,198,853,1533,5,144
435,114,5,364,336,1254,74,400,62,210,557,1303,5,145
143,98,5,861,308,1415,44,657,85,216,420,1422,5,146
149,70,0,645,224,1088,30,395,39,260,495,1219,5,147
106,42,0,422,120,690,21,169,12,159,386,747,5,148
1047,71,0,311,248,1677,102,304,93,199,991,1689,5,149
1078,53,1,279,149,1560,82,342,23,191,943,1581,5,150
942,65,1,325,182,1515,75,346,46,159,898,1524,5,151
547,96,0,351,266,1260,71,323,40,207,570,1211,5,152
121,141,1,538,259,1060,28,396,61,239,379,1103,5,153
100,78,0,381,141,700,31,255,16,212,327,841,5,154
828,46,1,278,213,1366,70,364,19,176,803,1432,5,155
1206,61,0,297,196,1760,90,387,13,175,1120,1785,5,156
1199,68,2,305,164,1738,74,403,26,182,1055,1740,5,157
1048,58,1,289,302,1698,59,478,76,186,946,1745,5,158
600,135,0,349,496,1580,77,475,138,234,653,1577,5,159
156,129,1,1155,381,1822,37,852,195,226,478,1788,5,160
111,83,0,595,202,991,30,427,18,212,434,1121,5,161
839,46,0,301,167,1353,85,314,14,140,821,1374,5,162
1226,58,3,382,223,1892,97,438,29,182,1155,1901,5,163
1175,83,5,349,236,1848,82,409,78,211,1076,1856,5,164
1019,51,0,365,148,1583,67,410,13,199,982,1671,5,165
563,153,1,350,429,1496,83,447,169,227,618,1544,5,166
160,112,0,729,280,1281,46,553,121,246,375,1341,5,167
107,100,0,486,147,840,41,285,21,194,365,906,5,168
879,61,0,359,175,1474,83,301,14,167,870,1435,5,169
1166,60,3,330,334,1893,90,471,21,225,1080,1887,5,170
431,81,1,442,197,1152,79,361,27,185,502,1154,5,171
1014,85,5,485,222,1811,74,401,25,205,1068,1773,5,172
560,150,2,345,237,1294,61,330,73,169,627,1260,5,173
143,133,1,481,306,1064,25,411,115,202,310,1063,5,174
88,77,2,341,201,709,23,233,45,192,295,788,5,175
885,53,4,337,164,1443,90,353,24,174,803,1444,5,176
1215,56,4,375,187,1837,112,443,24,192,1080,1851,5,177
1305,76,2,356,206,1945,97,451,33,213,1155,1949,5,178
1095,74,2,448,241,1860,80,482,67,176,1073,1878,5,179
587,135,1,445,279,1447,85,378,74,231,688,1456,5,180
148,129,0,528,276,1081,29,377,64,242,404,1116,5,181
111,68,0,397,152,728,32,249,16,205,298,800,5,182
805,61,0,399,269,1534,92,433,29,187,833,1574,5,183
1065,65,1,482,279,1892,84,497,69,202,1075,1927,5,184
785,93,0,495,434,1807,90,558,95,230,899,1872,5,185
279,504,36,830,1139,2788,33,1272,516,195,556,2572,5,186
377,111,1,446,303,1238,65,343,83,244,599,1334,5,187
135,127,3,618,211,1094,31,442,71,205,386,1135,5,188
87,98,1,408,150,744,39,297,16,199,302,853,5,189
790,59,1,449,152,1451,83,389,25,159,821,1477,5,190
1010,43,2,292,189,1536,114,322,16,172,952,1576,5,191
1038,52,0,332,202,1624,99,395,24,175,1005,1698,5,192
902,100,0,341,238,1581,102,418,27,188,916,1651,5,193
558,104,2,344,294,1302,77,324,79,182,598,1260,5,194
168,97,0,708,483,1456,25,760,67,241,455,1548,5,195
97,87,0,422,153,759,30,287,42,208,331,898,5,196
816,47,1,288,152,1304,95,278,17,170,789,1349,5,197
1123,45,1,286,219,1674,78,454,16,143,993,1684,5,198
1082,54,0,323,186,1645,68,389,24,196,1030,1707,5,199
1024,68,1,317,210,1620,79,412,37,191,933,1652,5,200
494,147,0,388,411,1440,64,433,163,189,645,1494,5,201
142,112,9,619,588,1470,33,691,127,204,423,1478,5,202
120,70,0,638,179,1007,31,295,26,197,503,1052,5,203
759,57,4,326,241,1387,69,356,53,166,742,1386,5,204
1121,59,0,368,250,1798,83,496,28,149,1115,1871,5,205
1065,49,0,371,333,1818,81,466,93,191,1031,1862,5,206
1059,125,1,437,203,1825,96,427,30,198,1101,1852,5,207
572,158,2,435,306,1473,88,366,94,189,687,1424,5,208
194,122,1,684,356,1357,28,441,220,249,479,1417,5,209
112,74,0,440,207,833,32,333,31,149,375,920,5,210
796,50,0,399,321,1566,93,349,182,161,789,1574,5,211
1133,55,1,338,212,1739,106,383,10,222,1050,1771,5,212
1085,63,0,387,198,1733,81,391,28,169,1087,1756,5,213
981,141,3,352,201,1678,89,426,26,170,909,1620,5,214
580,124,0,436,453,1593,65,536,217,192,589,1599,5,215
244,98,1,697,205,1245,27,610,97,214,392,1340,5,216
154,59,0,604,150,967,22,294,16,193,519,1044,5,217
758,45,1,317,223,1344,98,344,32,200,739,1413,5,218
1127,66,0,369,259,1821,90,443,53,203,1036,1825,5,219
1038,70,6,361,251,1726,98,439,32,189,970,1728,5,220
854,113,5,320,205,1497,71,314,45,183,850,1463,5,221
455,117,2,305,280,1159,73,318,116,147,529,1183,5,222
199,148,0,592,326,1265,36,514,101,259,447,1357,5,223
190,49,5,573,263,1080,21,391,22,255,520,1209,5,224
733,58,0,387,147,1325,83,328,11,187,779,1388,5,225
1052,50,0,370,196,1668,70,397,37,197,1019,1720,5,226
1025,46,0,307,168,1546,94,346,22,193,964,1619,5,227
914,45,0,364,212,1535,87,348,30,211,944,1620,5,228
535,111,0,348,238,1232,84,312,44,187,593,1220,5,229
136,93,1,538,308,1076,47,371,126,204,353,1101,5,230
102,75,2,419,242,840,22,241,90,202,365,920,5,231
732,49,1,316,155,1253,79,319,10,206,687,1301,5,232
975,74,10,330,241,1630,68,451,34,186,917,1656,5,233
999,53,4,312,256,1624,108,416,33,177,963,1697,5,234
861,53,0,349,156,1419,70,417,28,177,780,1472,5,235
504,96,2,286,251,1139,74,258,71,187,568,1158,5,236
170,120,1,529,281,1101,30,409,86,237,395,1157,5,237
86,78,0,362,202,728,25,295,32,170,291,813,5,238
828,40,2,240,273,1383,74,428,9,171,703,1385,5,239
1159,57,11,261,260,1748,72,447,39,176,970,1704,5,240
1038,44,2,259,256,1599,79,433,23,151,934,1620,5,241
945,76,1,249,248,1519,71,308,96,192,869,1536,5,242
449,97,1,395,314,1256,73,365,72,247,530,1287,5,243
129,82,3,662,244,1120,34,525,59,239,408,1265,5,244
97,84,0,690,172,1043,18,330,13,237,601,1199,5,245
106,87,0,418,179,790,32,219,13,251,330,845,5,246
1082,74,0,295,170,1621,84,387,11,159,948,1589,5,247
1164,67,11,268,158,1668,72,360,23,186,1040,1681,5,248
1008,38,9,242,166,1463,85,332,32,161,883,1493,5,249
536,70,1,236,227,1070,67,269,45,206,587,1174,5,250
95,65,1,404,305,870,31,272,151,219,258,931,5,251
69,84,1,338,202,694,28,223,30,184,276,741,5,252
812,35,2,225,203,1277,66,256,55,141,745,1263,5,253
1206,59,2,232,181,1680,82,378,17,175,1057,1709,5,254
1193,54,0,276,197,1720,85,431,30,146,1002,1694,5,255
1035,48,0,257,218,1558,86,434,24,144,898,1586,5,256
529,95,0,280,323,1227,75,367,66,226,591,1325,5,257
144,85,1,788,328,1346,25,530,84,309,486,1434,5,258
126,86,0,545,213,970,36,210,36,212,501,995,5,259
791,24,0,278,191,1284,84,270,23,190,696,1263,5,260
1133,46,1,240,141,1561,73,354,16,166,995,1604,5,261
1134,52,0,235,169,1590,74,363,39,191,987,1654,5,262
1046,48,2,262,238,1596,82,409,17,185,945,1638,5,263
494,103,0,264,190,1051,68,290,50,216,589,1213,5,264
108,91,2,561,322,1084,22,354,164,184,371,1095,5,265
95,64,0,375,166,700,38,256,20,201,225,740,5,266
828,47,0,290,150,1315,80,294,19,161,765,1319,5,267
1182,49,1,288,195,1715,78,427,49,183,1022,1759,5,268
1185,50,4,299,232,1770,62,414,75,149,1041,1741,5,269
1044,72,2,328,200,1646,83,414,41,167,981,1686,5,270
547,98,3,255,266,1169,79,285,113,200,596,1273,5,271
100,94,3,614,375,1186,29,575,97,185,328,1214,5,272
79,66,0,424,143,712,20,309,20,164,249,762,5,273
795,49,2,272,164,1282,94,291,31,142,760,1318,5,274
1172,39,0,235,143,1589,75,331,17,138,1049,1610,5,275
1192,41,0,300,184,1717,93,355,26,200,1058,1732,5,276
935,61,0,395,214,1605,85,458,33,196,846,1618,5,277
515,86,0,292,265,1158,76,352,50,240,624,1342,5,278
129,99,1,550,270,1049,30,426,53,206,368,1083,5,279
81,73,1,453,169,777,15,207,27,202,367,818,5,280
869,51,0,280,140,1340,91,280,11,168,798,1348,5,281
1261,47,1,240,189,1738,89,425,33,180,1114,1841,5,282
1200,53,5,297,204,1759,86,384,44,196,1108,1818,5,283
1052,75,0,311,236,1674,99,439,38,247,962,1785,5,284
561,97,0,329,304,1291,93,332,48,254,704,1431,5,285
165,118,1,556,314,1154,20,509,60,249,390,1228,5,286
114,76,0,441,209,840,27,277,78,224,285,891,5,287
364,60,1,366,209,1000,68,271,10,186,477,1012,5,288
1274,46,2,310,260,1892,82,430,17,173,1108,1810,5,289
1216,51,0,296,187,1750,79,392,16,200,1117,1804,5,290
1018,55,0,290,266,1629,79,417,31,162,966,1655,5,291
572,85,0,339,267,1263,93,314,70,226,681,1384,5,292
92,112,1,480,278,963,37,368,97,240,331,1073,5,293
62,71,1,478,154,766,20,333,19,148,301,821,5,294
842,57,0,340,196,1435,102,274,35,158,819,1388,5,295
1238,64,0,359,153,1814,102,395,12,160,1172,1841,5,296
1274,64,2,285,281,1906,76,479,57,188,1085,1885,5,297
1136,57,0,291,236,1720,82,448,21,141,1043,1735,5,298
517,80,0,298,244,1139,99,277,35,227,692,1330,5,299
156,95,0,464,343,1058,39,344,120,225,362,1090,5,300
261,82,2,505,234,1084,39,321,62,282,411,1115,5,301
849,48,1,276,162,1336,68,278,25,191,833,1395,5,302
1195,51,0,375,389,2010,72,647,31,208,1084,2042,5,303
1212,39,0,342,175,1768,81,439,21,195,1070,1806,5,304
848,69,0,284,240,1441,72,302,25,221,882,1502,5,305
512,128,3,365,300,1308,62,355,53,249,666,1385,5,306
141,110,0,533,304,1088,27,498,69,226,334,1154,5,307
107,78,0,346,194,725,35,222,27,247,289,820,5,308
821,37,0,294,209,1361,71,329,14,182,859,1455,5,309
783,66,10,241,160,1260,73,204,36,272,770,1355,5,310
974,52,3,225,218,1472,69,337,30,147,888,1471,5,311
1025,58,1,229,184,1497,81,315,18,172,921,1507,5,312
582,93,0,233,362,1270,81,298,84,211,559,1233,5,313
123,79,4,377,185,768,29,193,50,213,387,872,5,314
121,62,2,416,190,791,20,194,45,168,392,819,5,315
377,60,0,291,153,881,63,228,14,137,477,919,5,316
1213,51,3,264,178,1709,87,383,25,152,1061,1708,5,317
1198,42,1,275,249,1765,82,397,62,162,1041,1744,5,318
1061,44,1,267,206,1579,89,326,22,210,960,1607,5,319
566,80,0,248,227,1121,76,267,60,233,644,1280,5,320
139,74,0,431,238,882,31,271,51,230,363,946,5,321
76,74,0,347,198,695,24,225,25,164,317,755,5,322
895,51,3,274,174,1397,82,276,26,189,837,1410,5,323
1205,43,1,262,170,1681,84,372,10,162,992,1620,5,324
1195,40,4,259,173,1671,84,373,26,183,1069,1735,5,325
1046,57,0,249,236,1588,81,404,26,185,984,1680,5,326
555,62,0,250,258,1125,72,311,46,247,629,1305,5,327
86,102,0,457,307,952,30,379,80,249,401,1139,5,328
89,80,0,423,189,781,17,272,28,176,442,935,5,329
780,57,0,332,179,1348,80,293,39,196,877,1485,5,330
838,88,1,382,264,1573,74,437,17,234,1008,1770,5,331
489,205,0,509,270,1473,85,465,37,340,784,1711,5,332
46,97,0,129,66,338,14,87,4,261,184,550,5,333
266,109,0,851,242,1468,45,456,30,222,629,1382,5,334
89,70,0,617,204,980,15,258,47,186,386,892,5,335
92,56,0,487,242,877,16,199,14,149,355,733,5,336
825,37,0,255,173,1290,70,247,10,166,751,1244,5,337
1157,35,0,269,199,1660,57,384,17,155,1028,1641,5,338
1161,42,0,248,175,1626,69,364,16,147,1058,1654,5,339
1002,43,0,273,238,1556,74,396,20,165,911,1566,5,340
543,56,0,234,236,1069,56,234,41,185,592,1108,5,341
98,78,2,434,251,863,23,315,64,174,304,880,5,342
41,55,0,352,160,608,15,186,31,175,287,694,5,343
826,45,0,222,166,1259,80,285,19,154,709,1247,5,344
1212,37,0,305,155,1709,80,385,15,174,1052,1706,5,345
1180,40,4,210,186,1620,89,373,34,144,993,1633,5,346
1022,50,0,274,213,1559,78,412,26,171,875,1562,5,347
498,70,0,229,248,1045,68,283,43,188,525,1107,5,348
245,82,0,480,330,1137,30,475,85,294,353,1237,5,349
63,56,3,283,174,579,18,229,23,171,242,683,5,350
740,40,4,258,153,1195,72,291,16,166,726,1271,5,351
1110,73,0,324,271,1778,74,435,63,175,1029,1776,5,352
1049,63,7,311,175,1605,73,362,25,207,961,1628,5,353
848,94,3,370,293,1608,77,453,30,211,827,1598,5,354
375,115,4,352,372,1218,74,421,61,198,473,1227,5,355
81,88,5,440,259,873,27,341,77,166,333,944,5,356
76,53,0,483,155,767,16,377,21,151,300,865,5,357
373,44,1,534,235,1187,69,427,12,176,573,1257,5,358
143,44,0,222,87,496,53,161,21,169,279,683,5,359
24,45,0,99,86,254,8,95,15,103,80,301,5,360
220,74,0,435,292,1021,40,347,45,129,341,902,5,361
239,58,0,470,195,962,46,278,33,201,408,966,5,362
87,88,0,487,187,849,22,296,51,156,320,845,5,363
67,54,0,440,199,760,15,208,61,157,365,806,5,364
362,63,0,606,306,1337,55,398,15,186,669,1323,5,365
315,309,75,482,292,1473,54,221,203,187,564,1229,5,366
153,254,3,702,452,1564,108,400,8,559,696,1771,6,1
1715,351,1,907,1352,4326,1026,591,4,771,2072,4464,6,2
2033,422,7,941,1674,5077,1114,815,17,846,2384,5176,6,3
1966,435,11,985,1568,4965,1160,684,23,857,2329,5053,6,4
1202,584,35,1045,1485,4351,703,980,95,792,1742,4312,6,5
264,489,39,998,655,2445,149,731,104,752,758,2494,6,6
201,281,6,1189,627,2304,101,558,22,867,973,2521,6,7
1737,454,8,917,1414,4530,1063,709,19,788,2008,4587,6,8
2156,364,5,944,1447,4916,1337,575,4,969,2139,5024,6,9
2577,539,4,1153,1786,6059,1302,915,13,1078,2835,6143,6,10
2360,588,13,1229,1991,6181,1258,1029,27,1003,2640,5957,6,11
1429,929,54,1668,2728,6808,832,426,34,856,854,3002,6,12
284,1037,99,1655,2233,5308,160,451,46,1133,785,2575,6,13
199,492,18,1245,1044,2998,121,307,7,711,521,1667,6,14
481,551,6,1059,1032,3129,190,475,7,506,553,1731,6,15
831,338,12,678,972,2831,575,616,17,655,1003,2866,6,16
2264,493,18,997,1723,5495,1131,936,19,1000,2412,5498,6,17
2364,581,3,1169,2046,6163,1369,1116,18,946,2655,6104,6,18
854,705,55,879,1080,3573,494,949,75,760,1169,3447,6,19
275,657,50,1383,1001,3366,159,928,138,944,1237,3406,6,20
155,285,3,1113,651,2207,116,540,9,830,915,2410,6,21
1821,470,12,873,1434,4610,1067,707,21,834,2096,4725,6,22
2586,593,5,1108,2025,6317,1568,1013,9,1028,2854,6472,6,23
2577,562,8,1151,2063,6361,1429,1122,20,995,2808,6374,6,24
2377,627,18,1109,2107,6238,1373,1086,30,1125,2604,6218,6,25
1410,855,100,1301,1624,5290,840,1085,170,1145,2018,5258,6,26
304,723,84,1637,1181,3929,187,940,161,1180,1414,3882,6,27
172,293,3,1076,649,2193,117,495,9,976,900,2497,6,28
1803,446,4,993,1544,4790,1097,727,6,943,2075,4848,6,29
2628,570,4,1135,2044,6381,1534,924,13,1113,2928,6512,6,30
2578,637,0,1208,2034,6457,1508,1083,18,1091,2817,6517,6,31
2429,615,2,1275,1878,6199,1325,987,21,1121,2716,6170,6,32
1402,763,39,1159,1732,5095,864,1112,123,973,1881,4953,6,33
308,689,48,1595,1016,3656,191,963,118,1038,1357,3667,6,34
209,255,3,1244,593,2304,113,456,12,907,1062,2550,6,35
1814,450,1,921,1543,4729,1196,754,8,921,2045,4924,6,36
2661,585,6,1136,2245,6633,1650,1116,12,1083,2846,6707,6,37
2567,647,2,1329,2005,6550,1551,1089,10,1100,2897,6647,6,38
2398,641,4,1197,1963,6203,1401,978,19,1059,2697,6154,6,39
1335,839,72,1264,1583,5093,841,1058,145,1079,1895,5018,6,40
269,707,30,1591,1185,3782,188,1044,121,1040,1442,3835,6,41
192,565,4,1087,765,2613,112,550,44,794,1297,2797,6,42
1718,404,4,911,1452,4489,1077,662,17,851,2106,4713,6,43
2361,673,16,1079,2007,6136,1379,1025,19,1022,2741,6186,6,44
2523,594,8,1236,2023,6384,1275,1047,25,1194,2749,6290,6,45
2356,618,4,1182,1917,6077,1359,940,23,980,2603,5905,6,46
1266,770,39,1182,1597,4854,846,1033,115,993,1813,4800,6,47
274,662,45,1497,1013,3491,165,914,121,951,1295,3446,6,48
242,352,2,1394,673,2663,101,577,15,935,1178,2806,6,49
599,378,15,1341,939,3272,423,561,21,988,1308,3301,6,50
2584,513,12,1140,2119,6368,1508,1089,17,1083,2880,6577,6,51
2664,604,1,1199,1957,6425,1469,967,6,1140,2864,6446,6,52
2485,637,10,1224,2144,6500,1439,1107,10,1025,2748,6329,6,53
1397,861,32,1098,1415,4803,854,1016,92,922,1900,4784,6,54
302,747,31,1545,1150,3775,188,945,190,1071,1409,3803,6,55
202,282,24,1187,744,2439,118,554,21,915,1001,2609,6,56
1797,440,31,982,1661,4911,1157,870,30,912,2077,5046,6,57
2671,591,13,1134,2070,6479,1559,1056,16,1058,2945,6634,6,58
2582,642,20,1122,1893,6259,1405,949,10,1011,2850,6225,6,59
2447,678,3,1222,2101,6451,1423,1028,16,1089,2770,6326,6,60
1424,785,38,1171,1860,5278,909,1225,138,1002,1916,5190,6,61
304,935,52,1462,1042,3795,168,965,137,982,1428,3680,6,62
290,319,5,1571,720,2905,155,661,28,909,1349,3102,6,63
1941,538,3,1054,1463,4999,1132,832,13,935,2243,5155,6,64
2630,602,7,1227,1936,6402,1492,1036,22,1016,2980,6546,6,65
2722,632,4,1199,2022,6579,1441,1092,14,1119,2881,6547,6,66
2518,642,6,1415,2071,6652,1427,1146,42,1148,2774,6537,6,67
1497,855,41,1318,1717,5428,891,1171,150,1103,2079,5394,6,68
344,622,44,1455,937,3402,180,936,120,1076,1194,3506,6,69
236,316,7,1386,713,2658,118,615,15,1001,1070,2819,6,70
1808,502,1,1073,1550,4934,1094,878,11,987,2213,5183,6,71
2658,688,6,1487,2168,7007,1487,1237,8,1180,3232,7144,6,72
2784,706,1,1603,2171,7265,1449,1370,30,1251,3140,7240,6,73
2478,718,5,1682,2383,7266,1385,1376,124,1255,2990,7130,6,74
1430,827,47,1604,1865,5773,839,1211,270,1273,2158,5751,6,75
772,984,50,2421,1480,5707,232,1744,199,1677,1936,5788,6,76
286,370,14,1595,895,3160,159,925,23,1014,1169,3290,6,77
1906,540,2,1137,1611,5196,1120,907,12,999,2330,5368,6,78
2832,666,1,1292,2189,6980,1524,1255,13,1114,3173,7079,6,79
2802,684,3,1453,2471,7413,1499,1499,6,1228,3106,7338,6,80
2564,755,6,1364,2280,6969,1405,1412,32,1166,2830,6845,6,81
1459,954,87,1588,2181,6269,875,1615,133,1247,2261,6131,6,82
343,790,47,1711,1251,4142,176,1276,113,890,1649,4104,6,83
401,391,3,2222,953,3970,135,963,12,1294,1834,4238,6,84
1821,642,6,1551,1820,5840,1059,1055,213,964,2626,5917,6,85
2561,626,6,1676,2057,6926,1417,1311,12,1132,3157,7029,6,86
2479,587,8,1360,1816,6250,1252,1111,25,1225,2709,6322,6,87
2207,668,6,1522,1885,6288,1165,1128,20,1133,2723,6169,6,88
1248,870,28,1617,1695,5458,750,1300,119,1113,2143,5425,6,89
501,726,36,2583,1332,5178,192,1376,112,1365,2078,5123,6,90
261,330,4,1457,669,2721,165,785,9,862,1322,3143,6,91
1629,528,1,1421,1514,5093,954,1172,15,1015,2169,5325,6,92
2665,615,4,1429,2110,6823,1498,1137,12,1135,3153,6935,6,93
2642,629,7,1259,1961,6498,1344,1260,14,1050,2925,6593,6,94
2722,745,6,1651,2257,7381,1343,1458,14,1281,3112,7208,6,95
1545,944,64,1627,2178,6358,884,1535,178,1246,2203,6046,6,96
710,753,35,2204,1330,5032,245,1523,149,1439,1632,4988,6,97
753,350,23,1707,830,3663,143,966,28,1458,1285,3880,6,98
1831,485,20,1261,1433,5030,1103,852,82,983,2120,5140,6,99
2695,683,13,1305,2068,6764,1516,1051,79,1190,2983,6819,6,100
2690,674,8,1429,2003,6804,1369,1154,22,1175,3090,6810,6,101
2444,684,11,1382,2048,6569,1398,1227,31,1085,2708,6449,6,102
1459,869,57,1377,1733,5495,922,1302,127,1073,1882,5306,6,103
438,771,33,2166,1368,4776,212,1405,158,1222,1731,4728,6,104
281,377,2,1570,746,2976,125,794,15,1088,1345,3367,6,105
1889,521,3,1315,1605,5333,1087,1083,11,1017,2278,5476,6,106
2860,642,9,1352,2106,6969,1517,1208,31,1172,3157,7085,6,107
2856,721,22,1382,2105,7086,1473,1279,36,1127,3036,6951,6,108
2653,781,8,1414,2223,7079,1403,1447,34,1137,2961,6982,6,109
1498,783,41,1344,1974,5640,864,1365,161,1113,1943,5446,6,110
374,834,48,2417,1510,5183,184,1776,133,1064,1888,5045,6,111
275,327,1,1485,719,2807,134,641,6,1037,1131,2949,6,112
2139,558,16,1040,1605,5358,1148,900,18,1044,2380,5490,6,113
2975,628,4,1327,2253,7187,1484,1259,28,1263,3217,7251,6,114
2707,687,7,1452,2236,7089,1427,1435,19,1177,3005,7063,6,115
2561,735,4,1428,2126,6854,1335,1359,20,1198,2865,6777,6,116
1380,881,36,1411,1882,5590,815,1450,133,1019,1973,5390,6,117
476,724,45,1682,1212,4139,191,1256,351,1127,1421,4346,6,118
292,394,5,1686,968,3345,122,920,121,1091,1432,3686,6,119
1886,497,38,1074,1535,5030,1118,859,42,1003,2175,5197,6,120
2698,689,14,1266,2085,6752,1529,1149,31,1125,3023,6857,6,121
2761,723,27,1370,2091,6972,1471,1223,61,1183,3014,6952,6,122
2574,742,5,1415,2181,6917,1413,1360,36,1165,2780,6754,6,123
1473,849,43,1483,2058,5906,888,1342,152,1174,2089,5645,6,124
420,618,41,1732,1005,3816,213,1179,92,1000,1338,3822,6,125
278,330,12,1271,676,2567,119,752,33,935,1089,2928,6,126
1849,547,22,1089,1519,5026,1136,804,46,965,2201,5152,6,127
2917,580,26,1299,2316,7138,1502,1388,42,1246,2977,7155,6,128
2733,679,21,1285,2341,7059,1492,1492,50,1063,2949,7046,6,129
2461,676,35,1443,2050,6665,1338,1210,43,1172,2714,6477,6,130
1387,790,39,1216,1589,5021,898,1024,138,1002,1915,4977,6,131
470,623,24,1744,1042,3903,199,965,107,1131,1615,4017,6,132
495,330,13,1258,561,2657,123,639,21,969,1023,2775,6,133
1914,507,33,1134,1589,5177,1092,991,57,981,2279,5400,6,134
2768,643,21,1374,1963,6769,1502,1136,35,1140,3059,6872,6,135
2806,679,15,1300,2111,6911,1443,1300,30,1092,3083,6948,6,136
2648,690,28,1439,2278,7083,1453,1473,50,1283,2824,7083,6,137
1558,854,36,1361,1710,5519,843,1134,129,1140,2078,5324,6,138
468,790,45,1546,1012,3861,186,1072,109,1023,1392,3782,6,139
449,392,3,1575,696,3115,147,853,12,1071,1352,3435,6,140
1960,534,12,1238,1723,5467,1155,1040,19,989,2413,5616,6,141
2709,679,16,1426,2325,7155,1612,1271,25,1215,2987,7110,6,142
2706,620,21,1396,2207,6950,1552,1217,36,1117,3109,7031,6,143
2334,623,29,1218,2032,6236,1363,1148,43,1143,2556,6253,6,144
1240,704,24,1341,1762,5071,778,1246,130,1243,1654,5051,6,145
394,656,36,1683,1215,3984,191,1432,127,1025,1271,4046,6,146
297,422,21,1617,735,3092,129,909,50,952,1271,3311,6,147
339,337,7,1256,571,2510,174,569,14,906,970,2633,6,148
2572,584,3,1205,1853,6217,1441,1028,19,1097,2894,6479,6,149
2756,571,23,1256,1967,6573,1449,1116,31,1203,2931,6730,6,150
2716,728,30,1319,2135,6928,1470,1247,48,1255,2898,6918,6,151
1435,915,26,1350,1594,5320,912,1201,130,1109,1936,5288,6,152
384,800,43,1631,1307,4165,207,1272,124,1207,1360,4170,6,153
257,333,34,1372,625,2621,134,628,35,1079,1087,2963,6,154
2024,516,26,1150,1929,5645,1298,1125,41,1015,2329,5808,6,155
2959,607,10,1366,2352,7294,1689,1280,24,1189,3203,7385,6,156
3006,731,9,1348,2110,7204,1644,1213,25,1236,3195,7313,6,157
2759,746,9,1348,2411,7273,1542,1463,41,1175,3053,7274,6,158
1500,967,57,1343,2574,6441,1003,1819,236,1179,2036,6273,6,159
451,845,59,2616,1835,5806,270,2291,204,1237,1770,5772,6,160
330,424,10,1741,800,3305,149,978,28,1111,1420,3686,6,161
2036,490,20,1242,1802,5590,1262,971,25,1046,2375,5679,6,162
2957,778,30,1326,2249,7340,1686,1286,30,1185,3267,7454,6,163
3054,729,5,1348,2402,7538,1663,1427,41,1276,3181,7588,6,164
2762,722,3,1397,2292,7176,1512,1281,39,1325,2963,7120,6,165
1516,885,52,1425,2064,5942,949,1453,161,1083,1960,5606,6,166
387,738,74,1774,1287,4260,227,1386,123,1144,1503,4383,6,167
333,360,7,1436,708,2844,147,752,22,985,1250,3156,6,168
1947,510,8,1213,1720,5398,1258,902,22,1023,2292,5497,6,169
2840,733,18,1373,2426,7390,1571,1311,66,1235,3064,7247,6,170
929,580,16,1558,1458,4541,629,1140,25,1128,1711,4633,6,171
2515,676,8,1404,2082,6685,1449,1207,31,1171,2817,6675,6,172
1493,862,52,1414,1674,5495,973,1283,146,1108,1977,5487,6,173
484,1012,48,1578,1222,4344,261,1473,168,1192,1303,4397,6,174
292,357,12,1251,731,2643,155,693,24,1010,1007,2889,6,175
1973,549,9,1087,1552,5170,1121,859,17,1149,2357,5503,6,176
2885,677,8,1329,2089,6988,1620,1187,18,1101,3223,7149,6,177
2878,696,5,1421,2237,7237,1695,1330,12,1206,3154,7397,6,178
2757,739,9,1563,2165,7233,1427,1312,58,1238,3091,7126,6,179
1487,879,36,1456,1838,5696,973,1326,113,1080,2168,5660,6,180
478,835,28,1751,1151,4243,216,1099,138,1285,1520,4258,6,181
293,334,11,1382,590,2610,144,615,31,1008,1003,2801,6,182
1844,530,23,1157,1808,5362,1176,1025,45,1015,2248,5509,6,183
2455,650,5,1332,2080,6522,1436,1179,18,1177,2746,6556,6,184
1899,748,7,1533,2094,6281,1161,1379,37,1309,2254,6140,6,185
403,2116,9,1955,1573,6056,161,3077,76,1278,1243,5835,6,186
837,660,31,1565,1247,4340,568,1108,82,1053,1539,4350,6,187
373,645,34,1586,904,3542,233,985,110,1034,1137,3499,6,188
276,348,5,1319,585,2533,184,707,23,919,1108,2941,6,189
1957,467,3,1182,1666,5275,1173,986,16,1127,2325,5627,6,190
2646,700,7,1223,2085,6661,1616,1141,16,1165,3058,6996,6,191
2734,633,4,1295,2155,6821,1566,1183,12,1185,3034,6980,6,192
2458,747,4,1369,2277,6855,1467,1312,24,1169,2830,6802,6,193
1464,849,34,1228,1569,5144,953,1194,143,961,1933,5184,6,194
330,809,54,1800,1333,4326,212,1311,166,1104,1449,4242,6,195
307,366,9,1281,765,2728,175,698,19,1104,998,2994,6,196
1937,521,9,1108,1614,5189,1248,906,18,1005,2261,5438,6,197
2714,655,16,1242,2100,6727,1520,1242,30,1207,3012,7011,6,198
2729,619,19,1273,2024,6664,1573,990,34,1174,3068,6839,6,199
2564,756,16,1334,2109,6779,1453,1273,26,1160,2845,6757,6,200
1394,926,54,1361,2067,5802,909,1433,288,1090,1845,5565,6,201
420,707,53,1635,1473,4288,225,1377,185,1117,1446,4350,6,202
309,352,16,1497,752,2926,163,651,22,1035,1273,3144,6,203
1923,445,4,1121,1575,5068,1170,936,19,932,2131,5188,6,204
2752,680,13,1255,2238,6938,1551,1332,15,1122,3132,7152,6,205
2545,668,6,1204,2298,6721,1436,1361,17,1133,2912,6859,6,206
2517,744,16,1403,2038,6718,1350,1164,37,1199,3042,6792,6,207
1360,823,58,1352,1721,5314,893,1271,246,1039,1995,5444,6,208
397,791,66,1679,1306,4239,195,1314,348,1198,1452,4507,6,209
274,378,15,1410,662,2739,129,752,43,932,1098,2954,6,210
1837,491,17,1120,1764,5229,1191,962,127,885,2288,5453,6,211
2711,703,21,1286,1973,6694,1505,1059,34,1157,3128,6883,6,212
2662,709,11,1255,1991,6628,1486,1063,31,1174,3014,6768,6,213
2423,642,8,1270,1943,6286,1362,1116,30,1102,2736,6346,6,214
1393,787,47,1399,1779,5405,856,1368,139,1119,1821,5303,6,215
425,560,32,1653,927,3597,179,1046,114,1034,1440,3813,6,216
234,296,14,1313,666,2523,138,647,18,976,1118,2897,6,217
1758,493,17,1071,1574,4913,1148,927,23,941,2095,5134,6,218
2570,588,11,1221,2151,6541,1517,1182,24,1134,2908,6765,6,219
2563,656,5,1261,2154,6639,1569,1138,28,1147,2957,6839,6,220
2112,575,4,1250,1826,5767,1292,854,24,1062,2512,5744,6,221
1066,793,35,1050,1535,4479,699,1104,193,795,1582,4373,6,222
356,622,43,1729,1167,3917,171,1202,152,1090,1330,3945,6,223
245,318,1,1363,694,2621,137,659,12,995,1061,2864,6,224
1773,481,2,1042,1423,4721,1118,840,10,937,2024,4929,6,225
2432,624,15,1208,1968,6247,1498,1072,28,992,2777,6367,6,226
2453,649,6,1225,2030,6363,1463,1105,29,1232,2733,6562,6,227
2151,629,6,1299,1930,6015,1248,1131,39,1057,2540,6015,6,228
1209,912,62,1176,1629,4988,819,1148,130,979,1794,4870,6,229
373,705,47,1519,934,3578,178,988,171,1076,1322,3735,6,230
244,401,7,1216,705,2573,126,610,20,957,1021,2734,6,231
1676,457,16,996,1500,4645,1107,768,21,881,2100,4877,6,232
2518,612,15,1138,2144,6427,1513,1156,29,1124,2756,6578,6,233
2505,723,27,1343,2092,6690,1414,1192,59,1145,3031,6841,6,234
2175,681,40,1270,2062,6228,1385,1073,51,1069,2729,6307,6,235
1320,927,45,1230,1691,5213,855,1194,150,987,1906,5092,6,236
398,740,65,1709,1137,4049,212,1189,122,1151,1546,4220,6,237
257,321,8,1285,696,2567,150,671,45,959,1148,2973,6,238
1776,415,7,1065,1773,5036,1195,1003,15,1009,2052,5274,6,239
2712,632,6,1227,2409,6986,1558,1372,11,1119,2922,6982,6,240
2575,560,10,1232,2239,6616,1476,1203,20,1144,2857,6700,6,241
2276,559,5,1258,1891,5989,1309,906,38,1153,2531,5937,6,242
1085,720,47,1283,1631,4766,702,1121,205,1122,1501,4651,6,243
335,636,38,1615,969,3593,175,994,101,1037,1243,3550,6,244
267,446,4,1443,692,2852,110,801,25,858,1244,3038,6,245
270,356,5,1065,640,2336,169,630,14,853,1039,2705,6,246
2571,550,16,1219,1885,6241,1487,918,17,1107,2919,6448,6,247
2685,639,8,1204,2004,6540,1508,1046,16,1125,2959,6654,6,248
2502,623,14,1195,2086,6420,1425,1082,31,1089,2815,6442,6,249
1363,890,41,1112,1582,4988,851,1150,120,1008,1878,5007,6,250
383,751,52,1658,1327,4171,227,1243,242,1268,1444,4424,6,251
276,316,4,1223,690,2509,128,630,20,1102,1063,2943,6,252
1926,442,5,1105,1751,5229,1243,929,15,942,2273,5402,6,253
2960,749,4,1315,2267,7295,1630,1344,21,1198,3212,7405,6,254
2875,671,27,1294,2364,7231,1621,1233,37,1248,3088,7227,6,255
2720,759,5,1268,2432,7184,1458,1439,23,1232,3051,7203,6,256
1459,876,53,1347,1978,5713,916,1403,150,1061,2018,5548,6,257
404,804,38,1864,1341,4451,219,1439,169,1253,1417,4497,6,258
371,328,5,1641,706,3051,167,697,18,1096,1441,3419,6,259
1920,515,15,1196,1682,5328,1245,945,20,1046,2371,5627,6,260
2937,592,12,1351,2260,7152,1653,1120,18,1171,3267,7229,6,261
2873,611,10,1328,2203,7025,1596,1227,21,1121,3077,7042,6,262
2750,760,0,1404,2351,7265,1467,1551,35,1280,2881,7214,6,263
1570,780,61,1389,1870,5670,965,1206,125,1165,2001,5462,6,264
431,801,41,1872,1209,4354,203,1293,186,1234,1601,4517,6,265
260,400,8,1258,704,2630,125,637,17,919,1151,2849,6,266
1937,481,4,1123,1685,5230,1179,875,22,1030,2273,5379,6,267
2850,563,17,1312,2248,6990,1650,1087,38,1153,3115,7043,6,268
2720,679,32,1312,2348,7091,1593,1356,27,1219,3015,7210,6,269
2475,732,6,1446,2149,6808,1434,1227,24,1235,2995,6915,6,270
1481,911,48,1266,1884,5590,959,1496,142,1120,1886,5603,6,271
374,781,53,2290,1523,5021,211,1752,164,1383,1682,5192,6,272
269,289,9,1409,692,2668,113,735,15,967,1084,2914,6,273
1925,446,4,1126,1680,5181,1177,864,12,1047,2255,5355,6,274
2731,598,15,1193,2193,6730,1604,1040,26,1113,3082,6865,6,275
2804,655,2,1336,2235,7032,1546,1185,13,1273,3191,7208,6,276
2446,694,2,1452,2225,6819,1401,1253,19,1284,2899,6856,6,277
1480,921,23,1320,1695,5439,875,1298,119,1185,1994,5471,6,278
339,771,43,1834,1162,4149,189,1187,154,1205,1544,4279,6,279
277,341,4,1436,739,2797,137,653,11,990,1331,3122,6,280
2027,486,1,1152,1626,5292,1216,844,5,1054,2419,5538,6,281
2971,706,4,1384,2265,7330,1678,1099,24,1287,3313,7401,6,282
2800,677,22,1413,2383,7295,1626,1259,44,1284,3179,7392,6,283
2518,842,9,1406,2309,7084,1466,1364,25,1224,2944,7023,6,284
1411,887,37,1533,1822,5690,878,1219,103,1227,2128,5555,6,285
516,717,36,2043,1277,4589,222,1381,137,1198,1719,4657,6,286
503,389,1,1450,919,3262,144,923,27,1304,1170,3568,6,287
1093,429,0,1343,1299,4164,715,852,9,1194,1742,4512,6,288
2872,583,2,1471,2427,7355,1582,1406,19,1247,3255,7509,6,289
2939,683,10,1346,2252,7230,1561,1266,37,1202,3330,7396,6,290
2658,826,12,1432,2479,7407,1464,1621,31,1203,3121,7440,6,291
1519,856,59,1470,1952,5856,938,1396,128,1203,2129,5794,6,292
468,849,43,1898,1195,4453,217,1377,184,1186,1651,4615,6,293
243,364,9,1608,793,3017,119,946,17,1137,1224,3443,6,294
1990,509,17,1254,1788,5558,1225,990,35,1064,2456,5770,6,295
2953,660,9,1355,2269,7246,1679,1126,29,1188,3360,7382,6,296
2910,784,17,1478,2579,7768,1640,1535,51,1347,3259,7832,6,297
2667,769,22,1466,2394,7318,1443,1450,55,1283,3012,7243,6,298
1482,857,49,1477,1683,5548,908,1258,128,1177,2250,5721,6,299
483,867,66,1788,1356,4560,192,1326,150,1280,1575,4523,6,300
1344,385,10,1943,994,4676,206,862,24,2194,1657,4943,6,301
1980,476,7,1245,1667,5375,1229,831,24,1027,2446,5557,6,302
2915,661,6,1537,2880,7999,1646,1928,53,1461,3139,8227,6,303
2910,666,17,1395,2284,7272,1654,1307,29,1268,3283,7541,6,304
2462,771,13,1331,2206,6783,1358,1139,59,1217,2892,6665,6,305
1326,977,53,1349,1648,5353,881,1237,182,1139,1960,5399,6,306
407,867,63,1809,1449,4595,210,1499,172,1160,1530,4571,6,307
309,317,2,1315,694,2637,149,560,7,1027,1096,2839,6,308
1957,466,7,1123,1689,5242,1213,844,18,1025,2421,5521,6,309
2169,523,9,1319,1877,5897,1361,803,49,1241,2623,6077,6,310
2350,606,20,1238,2116,6330,1432,1073,33,1195,2726,6459,6,311
2550,723,31,1347,2234,6885,1501,1151,44,1322,2971,6989,6,312
1444,760,48,1201,1930,5383,935,1178,135,1068,1991,5307,6,313
403,791,58,1858,1076,4186,216,1050,135,1202,1633,4236,6,314
302,349,14,1472,706,2843,122,587,25,1033,1350,3117,6,315
1038,362,11,1250,1145,3806,588,748,26,1055,1721,4138,6,316
2982,607,19,1304,2239,7151,1683,1132,30,1221,3283,7349,6,317
3005,735,14,1394,2596,7744,1754,1387,41,1409,3253,7844,6,318
2628,748,20,1363,2301,7060,1567,1312,44,1268,2940,7131,6,319
1520,867,86,1222,1697,5392,962,1225,117,1169,2080,5553,6,320
347,785,53,1727,1229,4141,218,997,145,1115,1792,4267,6,321
275,305,9,1307,799,2695,135,650,13,1008,1139,2945,6,322
1996,478,18,1106,1754,5352,1252,827,36,971,2352,5438,6,323
3043,644,5,1250,2280,7222,1679,1151,23,1192,3410,7455,6,324
2838,627,6,1357,2335,7163,1662,1108,22,1373,3220,7385,6,325
2571,721,23,1313,2548,7176,1524,1338,34,1198,3029,7123,6,326
1371,761,64,1168,1706,5070,884,1082,120,1050,1933,5069,6,327
346,707,54,1636,1378,4121,175,1147,138,1134,1429,4023,6,328
246,342,11,1324,712,2635,125,530,19,894,1106,2674,6,329
1718,453,8,1061,1503,4743,1043,677,20,972,1964,4676,6,330
1758,576,4,1324,1715,5377,1083,778,14,1111,2232,5218,6,331
1063,456,8,1277,1192,3996,692,686,24,1077,1397,3876,6,332
160,188,4,558,288,1198,83,280,8,434,405,1210,6,333
451,359,15,1415,737,2977,274,690,58,878,1368,3268,6,334
233,406,33,1161,759,2592,151,763,60,865,1076,2915,6,335
199,268,11,955,597,2030,141,656,15,783,1023,2618,6,336
1771,350,9,967,1618,4715,1125,765,18,983,2232,5123,6,337
2661,580,18,1269,2283,6811,1606,1260,19,1132,3125,7142,6,338
2769,684,15,1344,2252,7064,1535,1184,28,1242,3056,7045,6,339
2498,723,14,1285,2367,6887,1462,1361,26,1152,2953,6954,6,340
1339,773,44,1273,1861,5290,890,1257,136,1066,1859,5208,6,341
321,759,73,1906,1379,4438,199,1457,191,1150,1551,4548,6,342
272,313,28,1548,917,3078,130,796,25,1045,1346,3342,6,343
1899,536,15,1075,1736,5261,1195,977,24,945,2305,5446,6,344
2928,757,25,1389,2337,7436,1652,1264,35,1219,3420,7590,6,345
2844,716,15,1300,2139,7014,1614,1165,20,1173,3025,6997,6,346
2660,835,15,1462,2546,7518,1581,1492,44,1266,2998,7381,6,347
1424,800,67,1399,2021,5711,917,1384,134,1137,2019,5591,6,348
522,815,57,1982,1526,4902,189,1533,182,1417,1550,4871,6,349
255,330,6,1288,788,2667,133,696,22,988,1044,2883,6,350
1920,458,14,1086,1619,5097,1190,792,25,1012,2309,5328,6,351
2567,684,9,1434,2371,7065,1543,1135,93,1225,2985,6981,6,352
2400,677,13,1408,2136,6634,1470,1118,20,1159,2818,6585,6,353
2110,559,15,1437,2134,6255,1253,1152,27,1239,2410,6081,6,354
1023,572,25,1105,1395,4120,612,891,49,850,1312,3714,6,355
235,403,21,1168,690,2517,111,550,51,684,891,2287,6,356
187,189,5,931,568,1880,93,419,5,566,694,1777,6,357
642,265,4,891,834,2636,457,466,10,596,958,2487,6,358
396,138,9,654,426,1623,252,209,8,486,485,1440,6,359
68,100,3,231,184,586,57,164,8,160,239,628,6,360
457,263,13,765,586,2084,319,483,22,509,807,2140,6,361
512,348,13,857,731,2461,355,526,28,588,948,2445,6,362
211,323,44,770,544,1892,112,548,52,534,702,1948,6,363
159,203,3,896,517,1778,90,474,34,616,749,1963,6,364
771,355,4,1086,1024,3240,528,715,12,823,1359,3437,6,365
733,858,409,1247,966,4213,511,875,550,1011,1375,4322,6,366
173,127,8,412,243,963,58,208,18,207,314,805,7,1
716,183,10,618,373,1900,145,380,8,362,751,1646,7,2
1013,181,2,566,475,2237,194,379,15,432,910,1930,7,3
989,159,2,623,453,2226,220,360,13,402,879,1874,7,4
932,204,11,592,480,2219,176,403,31,403,902,1915,7,5
212,149,13,422,192,988,60,218,44,216,221,759,7,6
171,148,1,466,237,1023,52,292,13,213,277,847,7,7
960,152,4,586,439,2141,184,377,15,377,853,1806,7,8
1020,105,8,498,307,1938,235,280,17,380,769,1681,7,9
1149,154,7,596,481,2387,224,392,29,439,948,2032,7,10
1077,183,6,613,478,2357,208,398,35,395,996,2032,7,11
986,155,6,611,442,2200,198,332,31,423,817,1801,7,12
222,181,6,561,303,1273,72,255,42,287,377,1033,7,13
203,104,1,412,205,925,56,217,12,226,241,752,7,14
289,151,4,422,242,1108,101,269,22,313,324,1029,7,15
409,132,7,408,253,1209,107,270,22,252,363,1014,7,16
783,155,1,685,404,2028,148,390,18,356,770,1682,7,17
1086,170,5,606,488,2355,229,374,10,406,898,1917,7,18
418,132,6,414,258,1228,116,254,24,255,401,1050,7,19
198,160,8,447,278,1091,55,232,38,247,297,869,7,20
171,127,2,413,180,893,69,234,3,243,295,844,7,21
1071,157,7,537,464,2236,214,380,34,381,942,1951,7,22
1149,152,1,561,457,2320,237,434,12,369,954,2006,7,23
1197,195,9,588,442,2431,246,441,22,430,850,1989,7,24
1123,176,4,630,426,2359,263,421,24,457,1009,2174,7,25
817,216,6,718,489,2246,184,423,41,453,751,1852,7,26
248,187,10,574,291,1310,71,332,43,306,373,1125,7,27
203,139,1,410,210,963,58,255,5,267,292,877,7,28
1114,168,2,599,425,2308,224,380,18,434,917,1973,7,29
1168,160,3,601,493,2425,252,425,10,413,1000,2100,7,30
1171,150,1,632,498,2452,249,417,20,403,949,2038,7,31
1157,194,2,673,444,2470,228,434,18,469,961,2110,7,32
1001,194,4,664,513,2376,215,391,44,457,824,1931,7,33
231,199,10,524,290,1254,69,315,57,306,337,1084,7,34
194,144,10,410,237,995,63,230,21,216,327,857,7,35
1125,163,1,568,455,2312,239,432,12,372,916,1971,7,36
1149,170,32,601,490,2442,249,426,47,365,983,2070,7,37
1160,160,4,594,504,2422,231,430,25,404,948,2038,7,38
1134,186,0,618,520,2458,263,420,19,395,970,2067,7,39
995,214,14,630,477,2330,216,409,38,407,878,1948,7,40
229,156,31,540,321,1277,92,323,65,277,338,1095,7,41
190,140,1,424,230,985,66,242,21,236,261,826,7,42
1046,166,10,580,476,2278,228,375,30,389,971,1993,7,43
1082,171,15,556,508,2332,230,406,24,399,946,2005,7,44
1143,199,1,648,483,2474,321,409,31,435,897,2093,7,45
1133,183,1,647,430,2394,257,418,12,355,816,1858,7,46
790,190,12,605,434,2031,167,434,39,416,693,1749,7,47
196,145,5,463,269,1078,66,310,37,233,316,962,7,48
199,129,2,437,239,1006,54,264,10,194,288,810,7,49
330,146,5,521,300,1302,277,313,28,312,414,1344,7,50
1125,161,4,619,397,2306,229,444,17,390,960,2040,7,51
1185,152,1,562,435,2335,226,407,23,439,991,2086,7,52
914,170,3,616,469,2172,206,457,24,429,923,2039,7,53
984,154,20,653,481,2292,258,385,47,463,838,1991,7,54
237,161,10,512,277,1197,86,270,43,280,354,1033,7,55
187,120,1,428,233,969,69,279,11,224,315,898,7,56
1093,158,1,546,484,2282,245,412,13,396,952,2018,7,57
1204,167,17,569,455,2412,211,394,30,433,989,2057,7,58
1217,164,12,553,412,2358,233,388,21,445,941,2028,7,59
1183,179,5,649,479,2495,266,434,18,414,989,2121,7,60
1049,198,24,664,467,2402,221,420,35,479,888,2043,7,61
13,1,1,4,2,21,10,0,0,2,2,14,7,62
0,4,5,1,1,11,0,0,6,1,1,8,7,63
1096,153,2,544,464,2259,231,403,13,396,916,1959,7,64
1147,162,7,522,480,2318,255,392,14,350,963,1974,7,65
1189,152,3,547,422,2313,239,428,16,435,942,2060,7,66
1165,183,7,547,465,2367,260,417,32,398,1008,2115,7,67
987,196,14,711,479,2387,247,442,33,464,906,2092,7,68
226,169,16,502,238,1151,75,277,37,291,270,950,7,69
185,178,10,427,252,1052,62,288,32,231,326,939,7,70
1071,161,2,518,469,2221,221,402,21,379,910,1933,7,71
1150,201,16,606,505,2478,245,493,24,347,1046,2155,7,72
1210,185,5,705,515,2620,229,467,26,535,1055,2312,7,73
932,230,10,747,499,2418,198,479,27,410,889,2003,7,74
772,229,10,694,452,2157,163,424,47,424,796,1854,7,75
228,217,14,603,324,1386,81,382,58,341,412,1274,7,76
190,172,3,425,260,1050,66,321,15,254,311,967,7,77
1075,191,10,518,459,2253,225,441,19,379,962,2026,7,78
1181,181,10,588,482,2442,231,470,27,404,1038,2170,7,79
1167,235,19,645,502,2568,258,567,31,502,1011,2369,7,80
1163,166,17,647,503,2496,235,458,41,400,1017,2151,7,81
1041,167,6,652,444,2310,201,452,41,437,905,2036,7,82
212,172,8,465,298,1155,68,326,54,233,372,1053,7,83
202,158,3,470,246,1079,62,344,11,264,340,1021,7,84
1041,153,7,575,517,2293,246,480,21,394,1071,2212,7,85
1176,153,3,614,482,2428,275,476,22,426,1064,2263,7,86
1185,135,22,573,377,2292,239,402,30,451,983,2105,7,87
1055,152,12,616,432,2267,258,425,25,400,1020,2128,7,88
849,128,9,649,418,2053,199,418,44,431,833,1925,7,89
234,114,18,511,256,1133,69,278,46,248,356,997,7,90
171,90,1,350,156,768,59,222,15,196,230,722,7,91
876,106,3,463,359,1807,183,364,20,334,894,1795,7,92
981,88,10,479,367,1925,213,382,23,326,919,1863,7,93
1007,130,23,396,308,1864,219,443,34,300,891,1887,7,94
1087,113,0,551,364,2115,236,401,14,334,946,1931,7,95
784,127,1,558,382,1852,156,407,28,379,709,1679,7,96
223,96,5,557,227,1108,75,302,38,243,439,1097,7,97
211,87,5,399,204,906,59,306,14,200,300,879,7,98
980,126,0,444,361,1911,217,328,3,348,882,1778,7,99
1073,122,11,501,387,2094,206,405,28,368,996,2003,7,100
1039,97,0,483,380,1999,213,366,21,369,946,1915,7,101
1086,116,2,516,322,2042,249,343,20,375,900,1887,7,102
927,131,8,519,359,1944,187,355,37,379,793,1751,7,103
209,102,2,456,216,985,68,283,38,265,343,997,7,104
185,93,1,460,190,929,57,308,18,213,295,891,7,105
696,103,4,575,267,1645,116,354,20,344,702,1536,7,106
730,123,0,539,318,1710,106,402,15,318,725,1566,7,107
837,108,1,481,259,1686,132,354,18,342,698,1544,7,108
773,147,0,573,302,1795,135,411,15,343,759,1663,7,109
661,110,15,516,308,1610,120,366,36,318,628,1468,7,110
173,158,12,373,378,1094,193,28,3,708,339,1271,7,111
86,67,13,237,232,635,143,31,5,412,109,700,7,112
971,93,1,415,339,1819,245,345,20,336,840,1786,7,113
1031,102,20,507,401,2061,230,426,29,345,1032,2062,7,114
1066,114,0,523,365,2068,235,384,14,389,1014,2036,7,115
1052,91,3,520,369,2035,267,363,22,358,909,1919,7,116
933,146,7,504,412,2002,241,463,43,337,877,1961,7,117
62,2,0,55,3,122,69,2,1,30,1,103,7,118
174,93,3,370,178,818,44,273,23,200,298,838,7,119
949,90,0,464,344,1847,226,380,19,372,832,1829,7,120
1093,88,4,477,368,2030,253,337,18,376,944,1928,7,121
1080,121,1,551,422,2175,258,411,15,399,1033,2116,7,122
1093,104,1,572,369,2139,272,383,21,398,911,1985,7,123
996,130,5,567,387,2085,243,392,33,433,850,1951,7,124
196,90,5,449,164,904,72,237,28,231,273,841,7,125
155,87,8,365,142,757,49,232,25,163,240,709,7,126
955,94,2,442,318,1811,223,349,16,352,801,1741,7,127
1104,89,4,532,382,2111,256,405,14,381,922,1978,7,128
1144,113,2,535,373,2167,294,454,19,444,896,2107,7,129
1108,150,15,531,445,2249,283,417,31,410,991,2132,7,130
997,132,4,581,414,2128,270,369,43,402,869,1953,7,131
231,123,7,500,236,1097,73,319,37,279,396,1104,7,132
187,104,10,434,140,875,56,285,14,212,232,799,7,133
1025,112,1,542,416,2096,242,431,18,396,1050,2137,7,134
1138,101,5,541,356,2141,275,380,24,409,1006,2094,7,135
1144,110,4,581,367,2206,270,413,25,420,982,2110,7,136
1210,148,6,601,375,2340,310,472,28,415,952,2177,7,137
1021,130,6,698,419,2274,264,361,34,526,986,2171,7,138
232,133,3,449,215,1032,76,300,51,217,338,982,7,139
226,104,3,408,163,904,55,280,18,233,295,881,7,140
1116,126,2,518,429,2191,301,497,20,368,1004,2190,7,141
1230,110,6,583,412,2341,303,500,26,396,1040,2265,7,142
1138,109,9,574,392,2222,260,450,19,412,987,2128,7,143
1131,150,2,612,440,2335,274,437,27,400,964,2102,7,144
1087,140,6,619,338,2190,243,398,41,468,721,1871,7,145
229,125,4,558,224,1140,79,369,36,271,354,1109,7,146
198,123,5,447,170,943,57,320,24,227,297,925,7,147
218,102,5,377,176,878,70,255,14,227,295,861,7,148
1077,108,2,516,362,2065,275,347,25,386,936,1969,7,149
1204,86,8,602,331,2231,332,349,20,434,884,2019,7,150
1138,96,9,593,405,2241,306,409,17,442,932,2106,7,151
988,142,4,639,375,2148,263,408,36,408,824,1939,7,152
240,160,5,534,254,1193,92,351,52,258,322,1075,7,153
186,128,4,427,155,900,56,317,20,205,293,891,7,154
1016,118,2,568,354,2058,259,404,21,448,892,2024,7,155
1013,122,4,615,358,2112,272,429,25,451,863,2040,7,156
1128,128,3,579,335,2173,254,414,16,471,931,2086,7,157
1075,147,9,571,406,2208,292,441,36,405,919,2093,7,158
932,184,8,593,353,2070,184,454,57,413,818,1926,7,159
244,185,18,579,366,1392,67,495,84,271,376,1293,7,160
191,143,6,416,208,964,53,340,24,216,324,957,7,161
979,103,7,530,358,1977,219,330,36,391,876,1852,7,162
1044,143,2,606,366,2161,248,439,30,442,955,2114,7,163
1121,137,4,623,386,2271,257,477,45,444,970,2193,7,164
1024,154,3,641,367,2189,265,393,34,483,885,2060,7,165
934,130,13,678,437,2192,234,491,45,462,832,2064,7,166
242,168,12,543,285,1250,79,396,62,321,430,1288,7,167
205,125,3,443,202,978,59,343,37,238,328,1005,7,168
880,129,6,581,298,1894,228,430,39,395,696,1788,7,169
878,128,16,626,344,1992,178,416,49,398,799,1840,7,170
432,158,5,514,261,1370,128,425,22,288,445,1308,7,171
793,148,17,557,350,1865,165,419,38,356,712,1690,7,172
717,139,7,509,317,1689,159,454,56,345,668,1682,7,173
248,159,14,461,275,1157,79,341,64,277,321,1082,7,174
198,129,15,388,177,907,55,269,30,198,305,857,7,175
873,123,7,559,376,1938,178,322,26,407,660,1593,7,176
915,114,4,524,333,1890,177,334,33,386,892,1822,7,177
1005,95,6,541,335,1982,174,359,25,398,877,1833,7,178
984,144,9,598,333,2068,207,421,17,451,813,1909,7,179
831,168,10,583,353,1945,178,366,51,415,763,1773,7,180
248,135,12,486,209,1090,74,275,51,262,318,980,7,181
197,85,9,360,183,834,56,242,22,197,265,782,7,182
885,150,7,574,330,1946,167,421,26,436,826,1876,7,183
999,130,6,561,395,2091,219,439,30,451,925,2064,7,184
917,169,9,598,346,2039,178,427,30,489,802,1926,7,185
237,389,21,367,352,1366,84,565,36,226,375,1286,7,186
543,139,11,499,259,1451,106,387,40,310,509,1352,7,187
222,112,7,430,224,995,82,247,47,252,288,916,7,188
212,97,2,404,169,884,62,238,14,231,296,841,7,189
860,130,8,477,272,1747,188,369,21,358,706,1642,7,190
935,130,5,518,357,1945,184,398,14,421,821,1838,7,191
998,111,17,521,299,1946,217,345,31,442,804,1839,7,192
946,156,7,539,345,1993,223,423,30,416,774,1866,7,193
825,182,16,530,286,1839,168,428,47,422,642,1707,7,194
240,150,9,491,237,1127,80,296,43,268,343,1030,7,195
189,121,5,403,140,858,58,235,18,238,254,803,7,196
861,113,3,444,276,1697,159,278,31,356,727,1551,7,197
910,91,7,450,289,1747,187,358,32,314,749,1640,7,198
928,108,5,535,281,1857,172,316,31,411,771,1701,7,199
960,115,7,538,320,1940,213,370,33,429,764,1809,7,200
823,142,12,574,346,1897,172,405,55,422,685,1739,7,201
223,116,10,396,188,933,69,326,42,230,258,925,7,202
188,122,4,380,185,879,50,278,11,248,229,816,7,203
859,86,2,328,212,1487,171,293,29,256,666,1415,7,204
948,138,10,575,346,2017,210,416,40,474,777,1917,7,205
932,110,7,545,389,1983,214,383,25,421,818,1861,7,206
914,121,8,567,349,1959,196,366,25,444,760,1791,7,207
792,162,12,578,331,1875,149,401,49,442,688,1729,7,208
219,124,12,474,247,1076,76,312,78,240,348,1054,7,209
177,97,7,359,169,809,51,240,42,204,276,813,7,210
773,98,1,497,298,1667,140,358,16,358,695,1567,7,211
918,119,1,484,347,1869,189,383,15,409,798,1794,7,212
875,132,3,548,308,1866,187,377,19,377,777,1737,7,213
794,150,3,584,370,1901,200,405,22,408,798,1833,7,214
755,146,13,640,339,1893,176,438,49,434,641,1738,7,215
218,128,21,448,240,1055,80,288,46,235,322,971,7,216
172,118,10,358,194,852,57,265,15,189,274,800,7,217
753,141,4,503,289,1690,167,412,26,382,688,1675,7,218
826,111,1,507,297,1742,170,394,21,359,729,1673,7,219
870,107,10,551,334,1872,183,377,21,417,727,1725,7,220
728,132,5,513,254,1632,180,378,24,332,638,1552,7,221
654,161,14,497,285,1611,160,375,58,305,593,1491,7,222
217,112,9,419,238,995,82,321,35,235,313,986,7,223
209,130,0,397,198,934,60,270,6,237,289,862,7,224
746,111,2,494,290,1643,161,350,27,342,669,1549,7,225
820,130,2,508,292,1752,181,399,20,352,752,1704,7,226
830,137,2,488,379,1836,178,374,15,328,795,1690,7,227
797,160,2,543,354,1856,209,427,21,359,684,1700,7,228
716,115,10,557,356,1754,177,369,50,410,660,1666,7,229
208,125,14,408,219,974,64,291,47,252,337,991,7,230
190,138,2,305,169,804,43,310,16,152,278,799,7,231
782,90,6,432,297,1607,182,325,18,336,680,1541,7,232
864,166,3,541,445,2019,189,467,18,373,854,1901,7,233
883,110,5,486,346,1830,208,407,20,331,759,1725,7,234
828,129,7,584,359,1907,190,385,17,398,804,1794,7,235
791,152,12,557,315,1827,192,364,39,380,666,1641,7,236
235,103,9,464,192,1003,81,276,36,276,325,994,7,237
161,95,8,351,170,785,47,255,33,192,257,784,7,238
949,111,1,478,426,1965,213,402,20,354,1046,2035,7,239
1082,135,3,464,357,2041,242,432,13,305,986,1978,7,240
1051,105,15,460,368,1999,251,391,22,340,889,1893,7,241
1152,94,6,452,325,2029,249,336,17,351,937,1890,7,242
971,184,11,531,331,2028,204,438,34,411,759,1846,7,243
218,130,15,485,223,1071,73,365,34,255,347,1074,7,244
176,127,4,421,183,911,64,265,12,194,315,850,7,245
191,140,3,391,243,968,69,265,16,291,298,939,7,246
1078,127,3,483,385,2076,218,415,18,380,900,1931,7,247
1117,119,3,467,374,2080,238,409,11,387,920,1965,7,248
1170,128,8,510,359,2175,265,439,20,382,903,2009,7,249
1061,141,9,533,372,2116,273,413,49,393,795,1923,7,250
235,133,13,438,223,1042,88,301,51,257,310,1007,7,251
201,95,4,371,171,842,56,247,6,217,320,846,7,252
1011,128,1,454,360,1954,202,403,11,312,922,1850,7,253
1147,125,4,554,364,2194,240,436,18,389,983,2066,7,254
1190,149,3,497,400,2239,271,491,20,424,985,2191,7,255
1189,141,3,510,427,2270,254,475,16,395,952,2092,7,256
1111,151,9,531,470,2272,261,444,41,405,894,2045,7,257
260,154,10,515,707,1646,92,352,50,702,395,1591,7,258
206,94,4,424,201,929,61,260,8,218,360,907,7,259
1132,117,1,513,388,2151,276,392,19,380,936,2003,7,260
1258,115,2,498,384,2257,296,393,18,432,1054,2193,7,261
1219,108,2,478,360,2167,287,419,22,358,940,2026,7,262
1240,141,4,518,387,2290,307,441,12,365,956,2081,7,263
1047,158,10,580,404,2199,267,425,37,393,847,1969,7,264
20,0,0,13,2,35,20,1,4,12,2,39,7,265
0,0,0,0,0,0,1,8,3,0,3,15,7,266
1122,103,3,501,338,2067,271,355,20,376,985,2007,7,267
1208,101,9,550,420,2288,277,394,28,384,1112,2195,7,268
1146,111,4,486,404,2151,249,438,17,379,964,2047,7,269
1230,129,9,616,427,2411,289,423,24,446,1068,2250,7,270
1033,171,7,521,392,2124,292,445,36,406,827,2006,7,271
260,177,10,541,267,1255,83,382,76,293,401,1235,7,272
190,109,7,357,207,870,60,256,24,223,319,882,7,273
1114,113,1,475,330,2033,263,405,15,337,912,1932,7,274
1184,115,1,541,438,2279,305,428,15,364,998,2110,7,275
1199,98,4,589,401,2291,314,408,18,423,1057,2220,7,276
1206,146,9,611,418,2390,309,438,14,411,1040,2212,7,277
1120,145,8,574,473,2320,303,375,28,426,941,2073,7,278
236,130,36,522,287,1211,99,306,75,324,353,1157,7,279
188,102,2,434,214,940,58,274,9,230,369,940,7,280
1168,99,2,538,418,2225,307,413,15,420,996,2151,7,281
1295,109,4,565,378,2351,315,448,25,389,1107,2284,7,282
1255,111,3,592,404,2365,288,430,16,438,1002,2174,7,283
995,121,1,555,396,2068,257,410,21,388,866,1942,7,284
780,168,11,566,389,1914,153,394,34,379,708,1668,7,285
247,161,10,496,283,1197,73,362,41,281,378,1135,7,286
184,138,4,427,221,974,63,282,17,215,301,878,7,287
450,107,5,443,306,1311,112,319,22,282,546,1281,7,288
1228,115,9,557,432,2341,312,421,29,412,1060,2234,7,289
1202,106,8,516,426,2258,286,401,23,458,992,2160,7,290
1199,151,3,513,430,2296,284,430,21,357,1086,2178,7,291
1102,155,17,581,477,2332,300,452,43,391,936,2122,7,292
243,162,7,597,290,1299,87,406,59,342,357,1251,7,293
176,105,10,409,213,913,64,320,21,222,309,936,7,294
1177,102,2,491,422,2194,288,398,23,378,1006,2093,7,295
1214,110,13,547,465,2349,285,416,33,434,1107,2275,7,296
1252,117,4,584,531,2488,324,444,18,488,1132,2406,7,297
1249,137,2,604,465,2457,314,438,24,436,1071,2283,7,298
1001,144,8,611,440,2204,243,421,42,444,851,2001,7,299
232,143,6,484,292,1157,69,326,63,274,368,1100,7,300
195,108,4,391,201,899,69,291,14,215,287,876,7,301
1156,105,1,513,394,2169,289,406,20,398,982,2095,7,302
1221,98,2,551,515,2387,284,503,25,409,1039,2260,7,303
1256,146,2,595,499,2498,298,572,24,462,1144,2500,7,304
1190,240,3,562,582,2577,303,620,24,410,1134,2491,7,305
962,151,12,600,462,2187,250,420,39,433,891,2033,7,306
263,180,7,512,316,1278,81,375,39,358,398,1251,7,307
187,103,4,410,223,927,67,281,10,268,337,963,7,308
906,103,11,532,358,1910,226,351,29,415,818,1839,7,309
869,125,9,525,334,1862,200,341,39,444,762,1786,7,310
1155,126,34,535,401,2251,292,385,45,420,946,2088,7,311
1203,130,8,532,415,2288,323,427,18,398,1017,2183,7,312
1079,140,12,555,478,2264,270,430,41,450,916,2107,7,313
231,127,16,457,230,1061,78,256,45,257,393,1029,7,314
209,79,3,395,184,870,68,223,13,238,355,897,7,315
433,115,8,439,289,1284,97,359,21,286,499,1262,7,316
1276,101,10,476,408,2271,313,396,21,383,1065,2178,7,317
1255,93,12,519,407,2286,313,426,18,392,1030,2179,7,318
1204,103,20,557,401,2285,313,376,34,466,980,2169,7,319
1032,121,9,518,465,2145,299,379,30,378,958,2044,7,320
255,110,12,504,236,1117,100,262,32,288,335,1017,7,321
184,80,11,376,220,871,62,242,19,224,320,867,7,322
1121,81,1,508,383,2094,270,361,16,384,926,1957,7,323
1220,104,13,528,435,2300,281,387,33,407,1057,2165,7,324
1174,78,3,531,433,2219,298,372,18,406,1060,2154,7,325
1181,113,4,554,432,2284,277,366,14,461,1112,2230,7,326
1053,110,8,509,365,2045,265,318,38,453,876,1950,7,327
227,105,8,518,251,1109,95,274,29,272,370,1040,7,328
185,111,4,411,191,902,72,239,13,225,305,854,7,329
986,122,6,489,390,1993,199,368,42,371,943,1923,7,330
950,135,3,536,384,2008,215,340,15,407,849,1826,7,331
655,112,3,550,274,1594,165,278,14,410,533,1400,7,332
107,82,2,240,151,582,65,127,9,212,181,594,7,333
374,84,5,477,184,1124,103,245,22,269,427,1066,7,334
182,87,15,430,217,931,71,231,27,246,334,909,7,335
165,97,3,322,187,774,50,219,15,196,302,782,7,336
1048,106,4,454,382,1994,262,350,14,357,944,1927,7,337
1140,129,9,557,361,2196,276,396,30,398,994,2094,7,338
1160,101,3,497,401,2162,278,353,21,443,945,2040,7,339
1122,114,1,511,397,2145,274,353,14,363,897,1901,7,340
991,121,11,536,399,2058,255,344,40,412,823,1874,7,341
11,13,3,3,9,39,8,11,3,3,7,32,7,342
5,14,5,10,6,40,6,11,6,9,5,37,7,343
1087,99,1,453,395,2035,280,396,10,318,872,1876,7,344
1211,89,35,524,429,2288,308,362,46,357,876,1949,7,345
1165,120,2,470,386,2143,297,351,17,388,930,1983,7,346
1172,130,4,573,421,2300,351,428,23,391,1002,2195,7,347
1023,124,7,583,465,2202,259,421,62,382,941,2065,7,348
231,128,4,488,233,1084,82,339,33,293,345,1092,7,349
188,86,7,374,190,845,58,262,12,215,296,843,7,350
1034,96,1,493,411,2035,294,333,17,382,938,1964,7,351
1204,91,4,559,395,2253,309,359,14,426,972,2080,7,352
1144,103,2,535,410,2194,316,386,20,424,932,2078,7,353
1100,129,5,517,382,2133,278,426,28,409,874,2015,7,354
822,89,10,528,362,1811,212,289,32,350,602,1485,7,355
166,102,12,366,221,867,63,260,35,207,264,829,7,356
144,65,0,294,138,641,42,200,7,164,211,624,7,357
506,82,2,450,232,1272,127,275,23,263,435,1123,7,358
345,83,2,390,141,961,106,177,17,261,338,899,7,359
67,76,2,136,122,403,36,80,11,134,107,368,7,360
374,92,8,391,272,1137,102,253,26,222,453,1056,7,361
393,94,3,379,262,1131,93,239,39,211,408,990,7,362
135,59,4,280,177,655,42,196,21,158,190,607,7,363
105,87,10,294,141,637,33,184,52,136,198,603,7,364
430,97,5,419,233,1184,99,328,15,255,495,1192,7,365
491,148,25,480,229,1373,125,225,57,351,562,1320,7,366
89,186,3,423,282,983,63,181,6,416,432,1098,8,1
1015,376,10,909,1326,3636,1013,409,30,798,1549,3799,8,2
1265,419,18,880,1658,4240,1184,593,27,878,1728,4410,8,3
1233,387,9,942,1608,4179,1156,508,19,882,1682,4247,8,4
833,475,14,872,1361,3555,748,658,60,796,1314,3576,8,5
143,321,24,680,550,1718,167,423,60,603,534,1787,8,6
112,233,13,1002,508,1868,116,304,16,690,804,1930,8,7
1306,376,22,758,1487,3949,1107,509,31,785,1651,4083,8,8
1544,249,22,972,1116,3903,1245,380,23,915,1494,4057,8,9
1747,510,13,1008,1755,5033,1369,662,21,976,2048,5076,8,10
1658,543,2,1029,1922,5154,1335,837,18,1008,1988,5186,8,11
903,464,32,988,1288,3675,809,487,49,896,1353,3594,8,12
240,491,29,1516,774,3050,183,581,90,931,1297,3082,8,13
131,267,6,909,555,1868,134,339,18,724,735,1950,8,14
233,345,0,927,691,2196,359,292,18,721,785,2175,8,15
559,330,4,596,933,2422,623,467,8,656,683,2437,8,16
1453,452,12,923,1533,4373,1213,609,22,860,1767,4471,8,17
1748,473,23,998,1920,5162,1299,934,27,936,1936,5132,8,18
595,465,20,739,822,2641,461,596,61,617,935,2670,8,19
169,372,21,985,770,2317,155,575,99,754,773,2356,8,20
116,248,10,812,559,1745,113,340,13,676,665,1807,8,21
1397,415,3,821,1461,4097,1093,501,10,813,1729,4146,8,22
1836,568,7,1004,1874,5289,1496,734,21,972,2156,5379,8,23
1885,575,8,1103,1943,5514,1405,839,14,1161,2167,5586,8,24
1656,591,22,1019,1797,5085,1334,770,36,968,2062,5170,8,25
1046,716,32,1010,1479,4283,843,707,69,1048,1708,4375,8,26
189,578,26,1337,905,3035,235,604,79,1027,1181,3126,8,27
124,285,11,928,646,1994,157,363,16,827,666,2029,8,28
1424,443,8,900,1408,4183,1057,558,21,950,1799,4385,8,29
1933,531,8,1024,1805,5301,1470,681,17,951,2208,5327,8,30
1849,536,10,1135,1825,5355,1432,817,22,1128,2118,5517,8,31
1736,560,6,1036,1824,5162,1269,736,19,1086,2076,5186,8,32
1059,672,33,987,1484,4235,856,771,91,1007,1566,4291,8,33
144,483,31,953,741,2352,176,369,57,774,750,2126,8,34
94,236,14,786,480,1610,117,256,18,654,580,1625,8,35
1427,477,12,858,1396,4170,1122,557,14,864,1766,4323,8,36
1900,609,4,1070,1916,5499,1499,881,10,953,2230,5573,8,37
1968,600,12,1033,1908,5521,1515,819,11,1042,2233,5620,8,38
1804,620,9,1047,1784,5264,1394,755,15,1058,2157,5379,8,39
1104,698,25,1115,1386,4328,841,704,101,1080,1637,4363,8,40
241,610,37,1435,969,3292,220,745,116,1102,1104,3287,8,41
132,349,13,1069,602,2165,121,374,18,800,967,2280,8,42
1387,403,5,873,1371,4039,1072,539,15,853,1703,4182,8,43
1580,563,5,975,1822,4945,1366,907,15,831,1926,5045,8,44
1856,533,14,1070,1794,5267,1359,714,17,1040,2244,5374,8,45
1694,615,9,1090,1741,5149,1339,744,12,927,2123,5145,8,46
991,629,26,1060,1365,4071,845,657,85,983,1481,4051,8,47
211,535,34,1172,767,2719,171,565,95,772,1091,2694,8,48
151,352,10,1196,635,2344,136,474,21,781,961,2373,8,49
354,354,8,989,861,2566,449,381,9,843,946,2628,8,50
1794,537,8,1056,1935,5330,1489,854,8,1026,2082,5459,8,51
1902,556,12,1114,1882,5466,1494,894,15,979,2104,5486,8,52
1796,542,4,1062,1868,5272,1421,885,18,990,1977,5291,8,53
1046,632,30,1005,1333,4046,823,743,58,940,1529,4093,8,54
7,5,1,1,4,18,3,3,1,5,3,15,8,55
2,3,4,7,7,23,1,2,4,9,10,26,8,56
1444,464,16,898,1585,4407,1126,745,19,850,1740,4480,8,57
1867,570,17,1051,1852,5357,1504,782,20,967,2132,5405,8,58
1850,544,11,1038,1719,5162,1436,723,15,968,2056,5198,8,59
1818,588,14,1100,1761,5281,1319,797,21,1048,2202,5387,8,60
1085,777,29,1036,1544,4471,829,884,99,1057,1680,4549,8,61
168,549,31,1015,758,2521,162,512,106,820,994,2594,8,62
152,334,14,1171,596,2267,133,358,21,837,1060,2409,8,63
1449,423,2,947,1469,4290,1132,554,5,844,1806,4341,8,64
1940,523,14,1122,1810,5409,1409,788,10,1002,2210,5419,8,65
2031,548,12,1139,1949,5679,1465,893,18,1122,2239,5737,8,66
1815,649,8,1172,1903,5547,1347,937,28,1060,2091,5463,8,67
1079,712,41,1164,1518,4514,838,860,104,1064,1661,4527,8,68
22,11,9,18,13,73,28,10,9,22,16,85,8,69
17,13,2,7,6,45,14,10,4,14,7,49,8,70
1354,514,4,995,1397,4264,1086,625,7,858,1766,4342,8,71
1872,601,7,1260,1915,5655,1457,923,11,1040,2311,5742,8,72
1972,641,18,1362,1981,5974,1452,1041,27,1140,2358,6018,8,73
1803,654,10,1474,1971,5912,1351,1058,73,1112,2467,6061,8,74
1059,675,38,1307,1518,4597,845,894,172,974,1743,4628,8,75
24,6,10,14,10,64,25,5,13,17,13,73,8,76
10,17,9,16,10,62,5,10,16,13,16,60,8,77
1445,444,16,1076,1603,4584,1164,657,20,935,1980,4756,8,78
2036,591,13,1183,1950,5773,1521,951,23,1134,2306,5935,8,79
1992,644,10,1283,2297,6226,1561,1188,22,1131,2325,6227,8,80
1858,591,14,1326,2012,5801,1388,986,29,1106,2236,5745,8,81
1136,690,25,1491,1716,5058,867,1150,110,1156,1760,5043,8,82
194,518,25,1212,965,2914,187,835,92,780,1175,3069,8,83
255,335,13,2011,746,3360,157,720,18,1070,1425,3390,8,84
1316,480,5,1446,1667,4914,1091,794,74,908,1993,4860,8,85
1686,575,9,1527,2044,5841,1391,1063,17,1146,2306,5923,8,86
1619,559,16,1417,1713,5324,1345,870,12,1074,2029,5330,8,87
1509,600,11,1533,1593,5246,1155,915,19,1091,2066,5246,8,88
936,629,27,1984,1472,5048,725,1048,85,1158,1977,4993,8,89
376,537,29,2256,1191,4389,225,1113,98,1272,1763,4471,8,90
226,348,14,1415,573,2576,149,550,20,847,1117,2683,8,91
1200,530,18,1327,1429,4504,1027,887,38,832,1740,4524,8,92
1903,535,15,1231,1900,5584,1444,941,16,1000,2250,5651,8,93
1816,553,19,1245,1862,5495,1384,1064,18,939,2232,5637,8,94
1851,618,14,1465,2018,5966,1399,1152,14,1091,2323,5979,8,95
1204,683,46,1478,1664,5075,931,1090,94,1073,2027,5215,8,96
368,619,39,1720,982,3728,256,843,99,1195,1296,3689,8,97
401,361,12,1370,835,2979,153,663,19,1149,1085,3069,8,98
1392,495,14,1156,1491,4548,1161,680,26,925,1778,4570,8,99
1840,574,26,1280,2046,5766,1493,979,35,1141,2235,5883,8,100
1914,603,14,1431,1944,5906,1439,991,23,1280,2247,5980,8,101
1852,599,17,1274,1908,5650,1395,946,39,1123,2157,5660,8,102
1122,787,20,1325,1619,4873,895,1074,58,1062,1788,4877,8,103
381,678,24,1622,1157,3862,243,1037,101,1115,1423,3919,8,104
221,375,12,1552,731,2891,170,565,19,1044,1199,2997,8,105
1513,586,29,1209,1774,5111,1217,930,36,951,2027,5161,8,106
2022,669,15,1279,1959,5944,1465,970,19,1157,2395,6006,8,107
2123,661,13,1276,1917,5990,1515,1073,28,1089,2301,6006,8,108
1997,630,6,1284,1907,5824,1378,1073,26,1107,2357,5941,8,109
1215,681,27,1378,1584,4885,901,955,76,1110,1856,4898,8,110
291,596,33,1955,1156,4031,230,1228,107,990,1434,3989,8,111
170,332,11,1227,591,2331,144,383,13,770,1017,2327,8,112
1378,493,12,1133,1414,4430,1081,592,28,934,1935,4570,8,113
1866,623,6,1264,2124,5883,1491,999,11,1044,2317,5862,8,114
1916,599,5,1241,2268,6029,1544,1207,10,1087,2258,6106,8,115
1929,623,12,1586,2106,6256,1418,1132,37,1236,2312,6135,8,116
1228,736,26,1352,1818,5160,883,1183,91,1115,1778,5050,8,117
256,564,23,1201,1004,3048,201,798,131,896,984,3010,8,118
184,432,10,1247,749,2622,147,676,34,832,988,2677,8,119
1464,468,11,1017,1495,4455,1143,649,16,992,1782,4582,8,120
1898,625,8,1173,1968,5672,1510,820,21,1121,2224,5696,8,121
1880,706,5,1333,2058,5982,1495,912,26,1117,2330,5880,8,122
1800,719,3,1254,1773,5549,1406,873,21,1141,2189,5630,8,123
1087,744,24,1272,1626,4753,857,976,64,1098,1737,4732,8,124
245,476,34,1479,821,3055,194,808,86,904,1051,3043,8,125
143,321,7,1092,554,2117,142,394,15,715,883,2149,8,126
1461,468,9,1068,1611,4617,1217,642,19,1032,1785,4695,8,127
1973,597,16,1215,2191,5992,1517,1086,30,1119,2324,6076,8,128
1992,609,6,1319,2218,6144,1507,1221,26,1275,2194,6223,8,129
1860,700,15,1242,1892,5709,1412,922,24,1176,2197,5731,8,130
1109,644,39,1175,1408,4375,885,732,77,1075,1687,4456,8,131
296,472,27,1498,977,3270,221,618,67,1177,1257,3340,8,132
190,346,11,1042,703,2292,166,419,15,911,829,2340,8,133
1433,563,7,1065,1639,4707,1196,725,15,944,1926,4806,8,134
1872,511,7,1161,1840,5391,1479,719,16,1062,2239,5515,8,135
1881,618,12,1162,2094,5767,1498,1060,34,1082,2167,5841,8,136
1825,739,7,1471,2111,6153,1488,1001,30,1229,2381,6129,8,137
1125,726,37,1410,1522,4820,929,920,103,1096,1936,4984,8,138
303,610,29,1305,877,3124,223,810,108,919,1078,3138,8,139
338,391,3,1422,702,2856,168,626,20,994,1025,2833,8,140
1503,548,4,1167,1723,4945,1253,913,13,938,1903,5020,8,141
1946,623,6,1215,2136,5926,1519,1100,18,1065,2312,6014,8,142
1898,584,9,1383,2053,5927,1555,976,20,1092,2375,6018,8,143
1742,597,18,1195,1847,5399,1305,833,28,1069,2213,5448,8,144
957,714,38,1346,1449,4504,803,911,90,1152,1631,4587,8,145
244,471,23,1511,1014,3263,230,1010,96,928,1058,3322,8,146
219,412,4,1480,643,2758,131,572,27,919,1119,2768,8,147
188,304,1,1005,518,2016,168,367,10,772,771,2088,8,148
1788,544,2,1111,1853,5298,1422,741,33,1058,2127,5381,8,149
1831,578,13,1279,1938,5639,1499,822,27,1198,2176,5722,8,150
1792,640,4,1320,2006,5762,1450,934,10,1144,2197,5735,8,151
1108,680,24,1242,1457,4511,925,861,81,1118,1552,4537,8,152
226,640,21,1402,1137,3426,216,864,83,1176,1077,3416,8,153
169,370,11,1231,750,2531,164,486,18,1027,968,2663,8,154
1603,522,11,1167,1829,5132,1359,874,13,1027,2040,5313,8,155
2137,592,9,1296,2362,6396,1714,1082,23,1249,2472,6540,8,156
2076,662,12,1399,2128,6277,1597,1011,38,1231,2536,6413,8,157
1995,730,4,1405,2295,6429,1556,1185,32,1243,2451,6467,8,158
1220,873,34,1458,2148,5733,965,1317,144,1160,1941,5527,8,159
347,710,40,2207,1461,4765,234,1593,121,1141,1583,4672,8,160
180,425,3,1477,838,2923,155,690,18,1127,1139,3129,8,161
1603,532,2,1182,1686,5005,1317,730,15,1035,2069,5166,8,162
2164,761,3,1286,2177,6391,1696,1004,8,1199,2575,6482,8,163
2105,687,4,1402,2229,6427,1669,1104,20,1271,2561,6625,8,164
1975,717,5,1389,2067,6153,1511,1013,15,1182,2309,6030,8,165
1096,798,30,1349,1792,5065,945,988,115,1199,1793,5040,8,166
284,685,36,1545,1112,3662,244,970,97,1228,1217,3756,8,167
192,417,6,1188,674,2477,196,547,15,918,989,2665,8,168
1564,559,21,1046,1675,4865,1349,727,35,933,1979,5023,8,169
1975,701,10,1283,2278,6247,1671,1090,35,1178,2260,6234,8,170
598,616,5,1352,1446,4017,750,899,16,1172,1318,4155,8,171
1926,758,8,1363,1922,5977,1456,861,29,1137,2433,5916,8,172
1168,720,28,1256,1453,4625,936,751,78,1085,1783,4633,8,173
401,637,35,1253,1000,3326,240,893,137,1054,943,3267,8,174
166,354,5,964,709,2198,165,437,36,855,802,2295,8,175
1608,568,3,1062,1710,4951,1317,709,19,980,2008,5033,8,176
2074,675,3,1264,2153,6169,1708,907,13,1160,2517,6305,8,177
1984,669,10,1258,2192,6113,1681,921,15,1209,2397,6223,8,178
1898,738,5,1471,2019,6131,1538,955,34,1231,2364,6122,8,179
1126,797,28,1403,1507,4861,908,925,86,1124,1817,4860,8,180
286,659,25,1475,907,3352,222,840,100,1058,1093,3313,8,181
201,422,3,1027,623,2276,169,447,34,844,855,2349,8,182
1474,506,0,1185,1788,4953,1279,852,9,937,1982,5059,8,183
1752,632,11,1239,2106,5740,1447,980,23,1105,2225,5780,8,184
1498,588,10,1378,1990,5464,1134,1101,40,1235,1978,5488,8,185
310,1759,19,1589,1416,5093,170,2444,70,1008,903,4595,8,186
682,605,16,1390,1079,3772,549,839,97,950,1352,3787,8,187
303,526,18,1305,771,2923,215,840,63,878,1016,3012,8,188
208,379,4,1200,585,2376,168,496,15,837,1002,2518,8,189
1546,547,5,1148,1643,4889,1307,774,6,1006,2067,5160,8,190
1938,631,1,1100,2048,5718,1670,907,5,1127,2200,5909,8,191
1925,620,2,1191,2131,5869,1641,855,8,1126,2293,5923,8,192
1760,676,24,1351,2009,5820,1488,943,36,1124,2119,5710,8,193
1155,740,37,1191,1475,4598,911,847,94,946,1727,4525,8,194
256,697,31,1396,993,3373,206,895,126,1029,1062,3318,8,195
181,414,10,1039,636,2280,183,500,15,862,800,2360,8,196
1534,537,4,926,1569,4570,1298,648,9,924,1906,4785,8,197
1943,634,5,1132,2038,5752,1583,941,19,1029,2265,5837,8,198
1971,582,7,1199,1925,5684,1620,730,13,1178,2267,5808,8,199
1764,707,0,1276,1947,5694,1429,893,17,1182,2231,5752,8,200
1102,732,31,1350,1667,4882,921,965,198,1042,1637,4763,8,201
279,578,35,1380,1148,3420,230,966,105,1066,955,3322,8,202
204,379,7,1268,732,2590,192,619,14,1092,824,2741,8,203
1476,493,5,1038,1607,4619,1267,684,19,927,1924,4821,8,204
1946,585,3,1225,2208,5967,1558,1085,16,1140,2333,6132,8,205
1785,625,4,1287,2179,5880,1509,993,20,1244,2208,5974,8,206
1767,732,5,1453,1907,5864,1424,856,22,1151,2315,5768,8,207
1118,752,33,1322,1442,4667,878,836,114,1035,1763,4626,8,208
280,636,56,1481,953,3406,244,918,143,1050,1115,3470,8,209
189,367,4,1117,720,2397,160,553,19,860,884,2476,8,210
1384,477,6,1051,1890,4808,1223,715,114,985,1865,4902,8,211
1856,568,6,1175,1977,5582,1530,804,7,1093,2208,5642,8,212
1766,606,21,1195,1895,5483,1363,838,30,1156,1973,5360,8,213
1636,632,7,1154,1778,5207,1343,796,36,1012,2068,5255,8,214
1112,730,37,1194,1540,4613,887,988,98,1057,1603,4633,8,215
296,505,21,1497,810,3129,243,722,96,985,1053,3099,8,216
235,338,4,1217,581,2375,181,473,14,825,916,2409,8,217
1323,473,6,1011,1664,4477,1152,726,14,920,1792,4604,8,218
1725,586,7,1116,2003,5437,1432,843,19,1018,2200,5512,8,219
1636,535,15,1196,1955,5337,1432,825,50,1015,2178,5500,8,220
1450,521,14,1123,1550,4658,1226,708,25,972,1846,4777,8,221
772,666,34,913,1303,3688,749,693,140,837,1314,3733,8,222
256,622,32,1382,963,3255,228,830,114,1032,1005,3209,8,223
194,324,6,1288,663,2475,169,478,17,822,1002,2488,8,224
1335,509,4,1041,1479,4368,1183,602,9,926,1769,4489,8,225
1759,580,7,1162,1906,5414,1413,776,10,1047,2233,5479,8,226
1666,512,7,1126,1880,5191,1410,786,16,1053,2169,5434,8,227
1535,673,14,1149,1767,5138,1210,825,42,1057,2029,5163,8,228
1013,669,28,1146,1365,4221,818,835,52,1000,1612,4317,8,229
271,627,43,1366,940,3247,216,734,97,1010,1059,3116,8,230
155,303,2,1077,637,2174,173,414,15,853,868,2323,8,231
1311,548,6,1034,1439,4338,1138,591,12,947,1828,4516,8,232
1670,588,12,1196,2032,5498,1367,904,17,1051,2187,5526,8,233
1687,698,7,1288,1959,5639,1354,1017,36,1119,2245,5771,8,234
1519,672,3,1255,1705,5154,1268,718,14,1076,2125,5201,8,235
907,770,30,1304,1479,4490,856,917,91,1074,1544,4482,8,236
305,607,39,1381,1058,3390,220,952,92,993,1204,3461,8,237
169,339,7,1198,737,2450,174,462,22,1007,912,2577,8,238
1463,476,6,1015,1731,4691,1158,809,9,902,1838,4716,8,239
1951,584,3,1173,2077,5788,1460,959,10,1079,2356,5864,8,240
1848,561,29,1130,1930,5498,1334,954,24,1023,2105,5440,8,241
1645,534,1,1114,1707,5001,1238,690,28,1053,2141,5150,8,242
966,659,29,1137,1451,4242,771,796,108,1143,1531,4349,8,243
236,576,27,1400,954,3193,224,809,75,958,1048,3114,8,244
176,458,7,1359,746,2746,186,562,35,960,1048,2791,8,245
161,355,7,971,653,2147,183,404,8,859,800,2254,8,246
1856,566,8,1048,1822,5300,1462,733,14,1022,2172,5403,8,247
1940,541,6,1139,1982,5608,1543,795,12,1152,2237,5739,8,248
1803,615,7,1076,1897,5398,1448,788,24,1095,2223,5578,8,249
1122,720,42,1111,1475,4470,979,753,78,997,1610,4417,8,250
215,655,36,1360,1424,3690,229,913,212,1375,1065,3794,8,251
191,369,8,1324,900,2792,193,420,9,1333,945,2900,8,252
1565,540,9,1030,1686,4830,1295,744,18,960,2018,5035,8,253
2142,689,3,1188,2156,6178,1641,1024,21,1170,2462,6318,8,254
2205,677,15,1366,2190,6453,1682,1109,31,1243,2576,6641,8,255
2181,704,13,1257,2213,6368,1514,1090,21,1163,2448,6236,8,256
1269,890,43,1303,1743,5248,1001,1030,108,1102,2033,5274,8,257
293,686,30,1658,1418,4085,229,1238,157,1249,1315,4188,8,258
207,341,3,1614,827,2992,175,589,19,1025,1260,3068,8,259
1667,552,13,1113,1854,5199,1366,863,19,1018,2135,5401,8,260
2220,574,7,1183,2081,6065,1639,935,18,1025,2513,6130,8,261
2112,580,8,1288,2101,6089,1565,1030,24,1199,2423,6241,8,262
2079,707,8,1376,2260,6430,1534,1252,18,1186,2394,6384,8,263
1411,809,39,1412,1696,5367,1002,953,108,1240,1971,5274,8,264
274,668,38,1597,1045,3622,224,888,129,1177,1214,3632,8,265
189,329,13,1178,717,2426,172,483,14,991,940,2600,8,266
1609,491,3,1144,1673,4920,1305,635,17,1045,2028,5030,8,267
2114,627,8,1191,2157,6097,1687,938,24,1068,2584,6301,8,268
2017,623,17,1277,2368,6302,1663,1143,38,1109,2381,6334,8,269
1869,815,6,1440,1938,6068,1440,1037,24,1143,2510,6154,8,270
1291,712,27,1421,1811,5262,943,1228,95,1185,1837,5288,8,271
351,705,44,1797,1419,4316,268,1300,121,1277,1346,4312,8,272
236,382,8,1377,746,2749,209,535,18,995,960,2717,8,273
1582,515,2,1051,1634,4784,1234,672,38,955,2007,4906,8,274
2090,572,5,1114,1980,5761,1612,827,35,986,2399,5859,8,275
1969,598,4,1252,2098,5921,1587,878,22,1196,2364,6047,8,276
1659,686,3,1383,1974,5705,1346,874,38,1249,2230,5737,8,277
1262,773,34,1268,1592,4929,960,892,93,1188,1862,4995,8,278
278,748,32,1584,1430,4072,259,914,140,1526,1205,4044,8,279
218,373,6,1363,737,2697,168,465,18,958,1078,2687,8,280
1612,539,6,1136,1755,5048,1295,832,12,980,2016,5135,8,281
2119,587,14,1280,2119,6119,1615,939,16,1191,2470,6231,8,282
2050,635,15,1382,2156,6238,1666,1012,17,1244,2462,6401,8,283
1928,674,3,1390,2105,6100,1440,1017,25,1250,2487,6219,8,284
1227,731,27,1444,1774,5203,992,1018,94,1282,1907,5293,8,285
435,567,28,1791,1197,4018,219,1089,138,1159,1437,4042,8,286
306,421,2,1423,881,3033,157,769,11,999,1073,3009,8,287
798,417,4,1284,1392,3895,865,590,18,1021,1312,3806,8,288
2196,566,19,1300,2305,6386,1567,1199,29,1163,2592,6550,8,289
2161,567,13,1380,2175,6296,1623,1037,18,1174,2550,6402,8,290
2004,691,6,1398,2304,6403,1551,1245,19,1223,2397,6435,8,291
1258,842,58,1501,1680,5339,929,1048,118,1203,2096,5394,8,292
322,712,45,1594,1157,3830,238,929,146,1205,1326,3844,8,293
213,449,6,1388,811,2867,198,716,23,989,993,2919,8,294
1704,520,10,1127,1724,5085,1299,771,12,1005,2235,5322,8,295
2214,618,7,1258,2171,6268,1680,966,15,1066,2677,6404,8,296
2205,626,7,1382,2402,6622,1594,1212,27,1266,2622,6721,8,297
2034,684,6,1412,2248,6384,1499,1195,36,1159,2480,6369,8,298
1426,818,39,1642,1715,5640,976,1038,109,1314,2120,5557,8,299
374,675,34,1692,1140,3915,267,937,151,1176,1306,3837,8,300
647,434,6,1519,907,3513,218,646,22,1414,1205,3505,8,301
1652,534,6,1293,1687,5172,1267,761,19,1110,2125,5282,8,302
2068,734,12,1448,2856,7118,1633,1660,30,1311,2499,7133,8,303
2112,679,6,1421,2285,6503,1612,1056,18,1271,2526,6483,8,304
1715,709,13,1254,1974,5665,1374,911,50,1084,2300,5719,8,305
1151,776,31,1272,1466,4696,904,818,77,1170,1746,4715,8,306
249,607,35,1553,1317,3761,236,1022,104,1063,1244,3669,8,307
204,350,10,1126,745,2435,179,446,12,1027,921,2585,8,308
1582,574,4,1084,1765,5009,1326,701,15,1060,2093,5195,8,309
1576,540,19,1157,1763,5055,1321,572,57,1131,2108,5189,8,310
1721,561,1,1152,2119,5554,1489,837,16,1130,2247,5719,8,311
1906,594,10,1239,1984,5733,1466,842,29,1176,2314,5827,8,312
1192,723,30,1433,1875,5253,1021,996,90,1185,1820,5112,8,313
276,566,28,1642,975,3487,252,658,100,1135,1327,3472,8,314
239,332,5,1584,720,2880,151,506,17,967,1248,2889,8,315
931,418,3,1117,1407,3876,827,640,22,998,1466,3953,8,316
2068,552,19,1198,2106,5943,1651,894,24,1106,2608,6283,8,317
2192,653,24,1310,2407,6586,1639,1109,50,1268,2602,6668,8,318
1985,591,13,1246,2002,5837,1457,912,29,1181,2407,5986,8,319
1225,759,41,1309,1656,4990,957,843,69,1131,2000,5000,8,320
325,591,26,1625,963,3530,267,683,76,1134,1371,3531,8,321
184,394,5,1291,896,2770,202,562,16,1041,1086,2907,8,322
1630,524,7,1097,1774,5032,1316,672,23,1043,2128,5182,8,323
2244,635,9,1222,2162,6272,1584,933,12,1251,2619,6399,8,324
2177,639,7,1423,2189,6435,1671,853,17,1315,2580,6436,8,325
1956,651,5,1275,2324,6211,1468,1056,22,1239,2361,6146,8,326
1385,590,25,1024,1604,4628,943,793,69,1262,1717,4784,8,327
232,566,34,1499,1195,3526,240,835,89,1175,1199,3538,8,328
132,374,8,1178,804,2496,149,409,13,984,1034,2589,8,329
1405,504,2,1167,1662,4740,1165,626,14,1056,1914,4775,8,330
1504,566,3,1294,1787,5154,1172,843,21,1218,2170,5424,8,331
868,625,13,1469,1346,4321,735,785,43,1314,1547,4424,8,332
145,223,1,460,276,1105,87,170,6,513,361,1137,8,333
314,429,16,1561,836,3156,325,566,29,946,1312,3178,8,334
149,531,20,1198,888,2786,212,559,54,860,1044,2729,8,335
147,373,15,999,711,2245,155,476,13,793,827,2264,8,336
1503,496,8,977,1589,4573,1211,584,18,976,1821,4610,8,337
2011,603,10,1126,2223,5973,1540,1039,20,1091,2409,6099,8,338
2073,603,11,1193,2109,5989,1546,917,26,1193,2406,6088,8,339
1898,544,23,1226,2128,5819,1336,1052,30,1104,2209,5731,8,340
1250,652,42,1108,1645,4697,947,893,65,1081,1670,4656,8,341
187,601,41,1487,1360,3676,243,1063,101,1163,1153,3723,8,342
146,370,9,1365,1042,2932,166,646,31,1068,1149,3060,8,343
1662,556,9,1007,1671,4905,1225,787,14,980,2118,5124,8,344
2281,802,9,1291,2118,6501,1577,1111,24,1269,2699,6680,8,345
2233,596,5,1207,1981,6022,1541,987,15,1130,2452,6125,8,346
2148,829,7,1333,2358,6675,1478,1236,17,1341,2522,6594,8,347
1309,861,30,1400,1868,5468,1007,999,121,1248,1954,5329,8,348
273,673,19,1659,1419,4043,225,992,126,1241,1304,3888,8,349
159,348,21,1153,917,2598,163,577,32,1017,868,2657,8,350
1485,524,3,1083,1660,4755,1247,664,4,1020,1886,4821,8,351
1927,751,11,1412,2387,6488,1505,1167,68,1272,2449,6461,8,352
1817,648,5,1387,2020,5877,1489,804,22,1277,2385,5977,8,353
1605,619,9,1330,2085,5648,1228,947,36,1177,2121,5509,8,354
914,673,41,1192,1653,4473,839,899,75,1098,1505,4416,8,355
174,511,26,1209,894,2814,220,567,55,943,961,2746,8,356
126,259,3,1009,895,2292,147,590,9,735,791,2272,8,357
640,375,3,1142,1133,3293,638,531,9,898,1253,3329,8,358
339,298,6,834,525,2002,412,226,3,746,601,1988,8,359
49,116,1,253,228,647,37,172,7,217,226,659,8,360
359,408,4,933,964,2668,455,482,13,671,1056,2677,8,361
388,438,13,1123,1030,2992,493,503,35,792,1116,2939,8,362
128,394,19,1024,794,2359,169,592,48,693,800,2302,8,363
118,309,14,1029,616,2086,149,315,29,807,853,2153,8,364
622,426,4,1213,1301,3566,668,587,18,920,1383,3576,8,365
497,675,172,1326,990,3660,600,463,380,946,1200,3589,8,366
57,75,1,263,163,559,40,135,5,220,232,632,9,1
883,119,7,353,345,1707,261,218,11,366,1072,1928,9,2
1146,122,8,405,464,2145,260,338,9,362,1278,2247,9,3
1174,126,12,405,406,2123,274,324,10,348,1282,2238,9,4
724,181,12,346,505,1768,253,394,36,323,907,1913,9,5
74,128,11,355,245,813,67,252,34,265,275,893,9,6
72,91,12,500,210,885,53,198,19,308,385,963,9,7
1028,127,16,363,468,2002,268,327,24,344,1132,2095,9,8
1234,101,15,312,318,1980,287,240,22,387,1174,2110,9,9
1361,143,4,425,452,2385,328,404,9,361,1388,2490,9,10
1244,164,10,461,565,2444,280,481,12,357,1317,2447,9,11
646,146,12,449,440,1693,238,244,20,393,751,1646,9,12
105,151,13,742,326,1337,77,274,42,309,635,1337,9,13
70,98,2,453,189,812,57,168,10,327,358,920,9,14
182,96,17,364,190,849,103,181,28,272,367,951,9,15
359,99,4,248,260,970,163,252,7,222,396,1040,9,16
1175,123,9,383,411,2101,281,373,13,322,1291,2280,9,17
1284,156,18,425,516,2399,269,540,24,372,1374,2579,9,18
465,126,9,425,356,1381,149,280,38,305,624,1396,9,19
131,121,9,434,339,1034,70,260,45,355,385,1115,9,20
88,91,2,371,204,756,56,189,7,292,342,886,9,21
1001,103,2,357,345,1808,242,283,11,320,1097,1953,9,22
1411,151,6,430,479,2477,325,434,11,358,1487,2615,9,23
1386,157,2,455,479,2479,305,469,8,335,1425,2542,9,24
1256,153,1,409,474,2293,289,482,8,327,1347,2453,9,25
791,272,13,469,517,2062,254,447,37,422,1003,2163,9,26
114,216,5,703,428,1466,81,349,45,437,611,1523,9,27
65,112,3,477,206,863,65,208,7,337,383,1000,9,28
1029,135,1,326,401,1892,265,273,8,314,1190,2050,9,29
1405,146,15,388,475,2429,300,411,14,306,1462,2493,9,30
1321,138,13,399,486,2357,332,438,14,362,1412,2558,9,31
1304,192,42,432,476,2446,311,417,41,373,1370,2512,9,32
755,170,27,398,525,1875,243,383,42,396,895,1959,9,33
119,199,19,618,351,1306,98,289,58,412,533,1390,9,34
103,107,16,432,277,935,59,207,23,358,351,998,9,35
1026,106,1,372,415,1920,285,290,2,326,1132,2035,9,36
1453,161,10,414,562,2600,339,494,9,396,1462,2700,9,37
1411,150,16,416,523,2516,358,460,15,391,1425,2649,9,38
1331,180,5,430,502,2448,307,449,9,400,1398,2563,9,39
783,198,10,446,520,1957,243,368,50,387,956,2004,9,40
115,188,10,647,436,1396,90,368,42,448,497,1445,9,41
90,142,3,403,261,899,63,189,18,301,452,1023,9,42
1033,116,2,365,405,1921,271,299,8,358,1163,2099,9,43
1346,132,6,398,511,2393,315,502,11,339,1384,2551,9,44
1379,176,5,462,514,2536,303,405,13,401,1499,2621,9,45
1277,172,4,438,448,2339,299,446,21,353,1332,2451,9,46
653,204,13,428,459,1757,224,359,29,424,792,1828,9,47
127,173,9,581,350,1240,72,222,40,402,453,1189,9,48
89,109,1,465,302,966,62,247,7,333,411,1060,9,49
233,123,2,412,324,1094,128,236,7,460,478,1309,9,50
1438,151,3,403,509,2504,334,450,10,356,1493,2643,9,51
1347,120,4,484,484,2439,337,403,7,364,1506,2617,9,52
1357,187,5,436,541,2526,308,510,13,364,1371,2566,9,53
835,199,9,432,487,1962,232,400,43,466,898,2039,9,54
129,165,12,565,461,1332,84,328,60,361,520,1353,9,55
100,116,13,413,275,917,62,208,13,309,361,953,9,56
1083,137,11,336,500,2067,320,362,26,338,1173,2219,9,57
1452,142,12,388,507,2501,335,425,14,382,1495,2651,9,58
1359,133,21,412,455,2380,312,407,13,398,1401,2531,9,59
1319,184,9,452,484,2448,307,486,18,364,1358,2533,9,60
802,220,12,441,620,2095,231,468,42,442,989,2172,9,61
102,169,19,512,357,1159,68,279,39,349,443,1178,9,62
131,110,5,564,327,1137,56,182,15,439,506,1198,9,63
1047,146,7,381,423,2004,281,350,15,311,1200,2157,9,64
1397,146,6,441,513,2503,290,419,11,401,1543,2664,9,65
1423,138,2,436,474,2473,338,463,9,386,1457,2653,9,66
1307,216,1,498,575,2597,312,525,23,427,1383,2670,9,67
930,244,8,489,572,2243,333,417,50,448,1019,2267,9,68
129,172,8,527,321,1157,73,365,27,392,401,1258,9,69
91,125,1,547,261,1025,55,236,6,381,459,1137,9,70
1029,165,8,427,491,2120,254,397,10,369,1194,2224,9,71
1447,205,2,560,562,2776,334,530,16,389,1641,2910,9,72
1413,201,17,551,620,2802,339,632,22,395,1613,3001,9,73
1326,236,8,700,680,2950,313,621,37,486,1555,3012,9,74
799,253,8,645,637,2342,231,428,103,502,1147,2411,9,75
281,310,12,990,517,2110,93,571,48,654,802,2168,9,76
107,130,5,665,326,1233,65,381,16,393,625,1480,9,77
1066,147,10,476,467,2166,286,408,13,379,1222,2308,9,78
1529,165,12,551,510,2767,319,531,10,394,1596,2850,9,79
1524,198,10,614,663,3009,342,707,11,435,1579,3074,9,80
1437,225,15,578,565,2820,276,646,21,489,1483,2915,9,81
805,228,12,646,787,2478,243,569,57,489,1181,2539,9,82
92,229,12,582,426,1341,54,437,68,341,565,1465,9,83
156,141,16,860,371,1544,73,314,19,476,925,1807,9,84
1099,190,6,665,489,2449,272,424,40,405,1308,2449,9,85
1464,160,17,672,606,2919,297,610,19,436,1675,3037,9,86
1341,157,16,521,472,2507,275,488,21,353,1494,2631,9,87
1142,184,11,546,493,2376,279,457,16,397,1386,2535,9,88
731,249,20,689,572,2261,212,462,60,495,1080,2309,9,89
184,267,11,944,535,1941,82,503,43,592,767,1987,9,90
107,153,1,586,301,1148,80,235,6,419,499,1239,9,91
976,162,5,640,473,2256,290,553,11,426,1208,2488,9,92
1488,175,6,615,496,2780,325,469,12,396,1756,2958,9,93
1409,200,13,493,493,2608,307,477,21,341,1565,2711,9,94
1395,249,10,634,617,2905,314,639,17,431,1558,2959,9,95
863,272,31,544,624,2334,278,512,47,455,1110,2402,9,96
223,198,17,813,479,1730,97,468,52,532,595,1744,9,97
323,153,1,691,395,1563,89,369,10,580,562,1610,9,98
1027,153,10,505,427,2122,297,353,18,383,1187,2238,9,99
1411,194,8,515,549,2677,375,530,16,445,1513,2879,9,100
1399,181,7,500,513,2600,302,566,7,454,1493,2822,9,101
1366,181,7,463,517,2534,343,522,19,429,1383,2696,9,102
850,249,8,521,585,2213,235,470,33,476,1066,2280,9,103
182,259,11,772,580,1804,109,565,63,484,654,1875,9,104
135,163,2,712,372,1384,83,308,11,556,574,1532,9,105
1083,167,1,532,559,2342,338,449,10,419,1198,2414,9,106
1484,210,4,542,601,2841,365,495,11,412,1619,2902,9,107
1481,171,9,570,576,2807,381,583,12,462,1439,2877,9,108
1378,243,8,594,587,2810,350,615,20,462,1498,2945,9,109
806,228,8,570,682,2294,287,513,30,475,1023,2328,9,110
165,260,19,878,583,1905,97,627,55,420,751,1950,9,111
128,145,4,537,258,1072,66,234,7,392,547,1246,9,112
1031,158,2,395,478,2064,301,317,8,390,1200,2216,9,113
1484,221,6,467,643,2821,354,588,12,411,1578,2943,9,114
1387,208,8,511,644,2758,331,649,12,479,1436,2907,9,115
1342,183,9,526,710,2770,313,627,20,454,1375,2789,9,116
824,249,10,487,683,2253,261,569,38,455,1047,2370,9,117
171,217,10,623,438,1459,77,439,65,452,494,1527,9,118
120,187,11,777,345,1440,115,356,16,425,462,1374,9,119
1069,175,23,392,448,2107,317,376,27,384,1179,2283,9,120
1499,218,15,457,546,2735,363,442,16,412,1634,2867,9,121
1442,231,19,525,553,2770,357,546,26,445,1566,2940,9,122
1319,237,8,475,584,2623,333,502,21,458,1421,2735,9,123
797,271,11,527,663,2269,260,507,33,467,1007,2274,9,124
165,199,7,648,384,1403,69,395,41,411,494,1410,9,125
125,161,3,471,241,1001,70,293,5,408,476,1252,9,126
1111,148,20,422,473,2174,343,352,38,389,1236,2358,9,127
1529,189,11,495,638,2862,368,570,22,437,1602,2999,9,128
1535,215,12,554,626,2942,357,641,28,463,1593,3082,9,129
1384,186,9,470,583,2632,333,545,18,429,1430,2755,9,130
796,219,12,470,519,2016,275,390,31,443,969,2108,9,131
209,184,11,778,378,1560,99,339,37,540,651,1666,9,132
123,171,3,526,274,1097,85,245,8,416,453,1207,9,133
1099,174,5,439,518,2235,317,365,10,395,1251,2338,9,134
1556,184,7,486,524,2757,357,468,13,443,1665,2946,9,135
1467,189,5,481,562,2704,348,529,18,433,1524,2852,9,136
1425,276,14,562,634,2911,345,561,24,533,1497,2960,9,137
829,285,15,517,609,2255,281,443,49,507,1064,2344,9,138
132,223,10,573,344,1282,86,349,51,385,449,1320,9,139
206,177,3,585,299,1270,100,307,9,497,543,1456,9,140
1141,192,7,448,554,2342,333,443,14,424,1291,2505,9,141
1514,234,7,487,635,2877,356,622,11,438,1625,3052,9,142
1472,251,9,592,537,2861,359,577,15,482,1601,3034,9,143
1270,203,15,499,555,2542,343,462,17,443,1357,2622,9,144
656,270,11,547,661,2145,244,510,42,559,798,2153,9,145
147,236,9,675,475,1542,83,550,46,476,544,1699,9,146
142,209,3,708,310,1372,81,350,13,453,576,1473,9,147
139,148,3,471,232,993,65,235,19,441,463,1223,9,148
1402,178,18,489,527,2614,377,431,26,434,1573,2841,9,149
1455,199,3,526,455,2638,366,434,8,477,1514,2799,9,150
1399,212,9,561,545,2726,342,513,17,496,1471,2839,9,151
850,258,20,537,627,2292,263,484,43,531,1030,2351,9,152
168,253,17,701,496,1635,101,424,58,509,564,1656,9,153
122,175,2,501,283,1083,84,263,8,422,445,1222,9,154
1125,179,6,493,551,2354,338,451,17,430,1255,2491,9,155
1505,200,5,519,642,2871,401,535,14,418,1633,3001,9,156
1455,166,15,549,555,2740,410,503,24,494,1537,2968,9,157
1430,195,17,530,668,2840,362,674,28,467,1483,3014,9,158
878,314,18,558,843,2611,251,778,71,497,1063,2660,9,159
205,310,20,1133,787,2455,90,966,74,522,752,2404,9,160
124,169,2,728,336,1359,75,334,17,422,607,1455,9,161
1090,165,8,528,503,2294,317,380,12,402,1273,2384,9,162
1546,192,9,540,599,2886,418,567,20,440,1645,3090,9,163
1542,262,18,544,669,3035,352,691,33,446,1610,3132,9,164
1416,243,22,506,543,2730,330,616,35,430,1459,2870,9,165
864,299,17,509,698,2387,238,611,46,498,1061,2454,9,166
195,281,8,633,459,1576,105,545,40,489,468,1647,9,167
124,167,4,525,307,1127,86,287,7,419,512,1311,9,168
1102,168,7,497,497,2271,321,408,12,415,1242,2398,9,169
1430,232,20,495,660,2837,350,636,31,512,1440,2969,9,170
400,204,8,569,522,1703,175,440,19,485,594,1713,9,171
1229,218,2,566,540,2555,324,459,18,429,1378,2608,9,172
772,306,12,469,485,2044,235,368,30,456,943,2032,9,173
167,318,13,563,449,1510,110,522,36,422,463,1553,9,174
139,182,7,439,258,1025,98,232,18,376,462,1186,9,175
1079,183,4,419,430,2115,304,405,12,389,1167,2277,9,176
1492,210,2,523,549,2776,350,491,12,476,1569,2898,9,177
1442,200,17,525,564,2748,323,560,20,471,1513,2887,9,178
1335,260,11,567,581,2754,293,558,28,486,1425,2790,9,179
826,269,38,486,599,2218,230,494,41,473,1009,2247,9,180
153,232,31,638,437,1491,110,395,44,512,493,1554,9,181
99,167,9,400,256,931,83,290,17,396,418,1204,9,182
1028,164,10,467,605,2274,302,467,20,419,1228,2436,9,183
1350,220,15,467,616,2668,336,515,30,441,1487,2809,9,184
1070,289,2,583,746,2690,323,648,19,594,1101,2685,9,185
156,700,13,812,621,2302,72,1185,27,545,520,2349,9,186
407,234,11,612,495,1759,192,409,35,454,690,1780,9,187
138,216,9,531,377,1271,90,349,25,470,425,1359,9,188
79,160,3,421,265,928,70,277,8,431,442,1228,9,189
1058,183,7,435,467,2150,314,399,16,394,1220,2343,9,190
1387,190,5,502,539,2623,374,496,13,409,1449,2741,9,191
1360,167,7,428,519,2481,364,449,16,420,1401,2650,9,192
1301,231,4,474,505,2515,324,514,11,441,1319,2609,9,193
777,229,11,450,550,2017,248,487,38,458,886,2117,9,194
152,546,23,615,487,1823,101,664,54,453,641,1913,9,195
77,155,12,429,267,940,92,315,19,350,375,1151,9,196
1073,146,13,407,397,2036,276,401,25,319,1033,2054,9,197
1339,215,9,434,469,2466,330,463,18,413,1418,2642,9,198
1342,157,12,458,477,2446,345,386,18,424,1442,2615,9,199
1293,206,11,525,571,2606,339,544,18,403,1410,2714,9,200
761,314,21,455,796,2347,246,589,179,465,949,2428,9,201
158,284,6,639,578,1665,113,552,48,477,495,1685,9,202
122,184,5,561,295,1167,76,291,19,434,494,1314,9,203
1084,155,15,369,458,2081,293,371,19,347,1144,2174,9,204
1484,237,7,460,596,2784,384,572,17,404,1612,2989,9,205
1396,182,4,528,698,2808,337,572,18,476,1476,2879,9,206
1260,213,2,541,513,2529,299,535,12,418,1422,2686,9,207
826,306,7,479,576,2194,260,443,82,440,1007,2232,9,208
148,307,4,599,479,1537,111,444,73,510,542,1680,9,209
100,185,27,477,289,1078,102,273,44,364,422,1205,9,210
1065,150,12,489,552,2268,317,454,39,414,1166,2390,9,211
1446,204,9,483,505,2647,353,463,18,442,1523,2799,9,212
1407,211,17,546,536,2717,349,487,27,474,1456,2793,9,213
1311,234,10,517,524,2596,316,479,12,485,1366,2658,9,214
793,330,11,570,615,2319,301,540,60,489,941,2331,9,215
160,200,11,674,333,1378,106,343,54,429,509,1441,9,216
137,174,4,495,279,1089,68,223,14,408,469,1182,9,217
1035,182,12,414,483,2126,284,374,23,380,1158,2219,9,218
1343,223,26,450,559,2601,343,506,36,414,1446,2745,9,219
1312,161,11,482,538,2504,340,445,23,436,1405,2649,9,220
1192,154,4,421,393,2164,282,374,11,395,1235,2297,9,221
604,218,6,390,456,1674,197,399,66,360,706,1728,9,222
126,232,6,559,481,1404,96,418,37,458,438,1447,9,223
98,162,17,481,272,1030,99,225,29,381,384,1118,9,224
1007,160,6,405,387,1965,277,292,6,391,1094,2060,9,225
1288,194,26,437,539,2484,338,424,26,403,1448,2639,9,226
1310,170,20,469,527,2496,335,405,26,417,1362,2545,9,227
1211,211,17,481,529,2449,298,448,41,447,1346,2580,9,228
734,229,11,461,510,1945,250,394,53,424,889,2010,9,229
102,230,13,586,395,1326,87,307,47,494,563,1498,9,230
92,144,5,457,234,932,63,210,12,370,414,1069,9,231
957,139,13,424,425,1958,280,267,17,366,1126,2056,9,232
1342,184,24,460,595,2605,344,515,31,414,1468,2772,9,233
1266,184,9,473,558,2490,336,466,21,420,1401,2644,9,234
1187,213,10,538,528,2476,326,476,16,468,1257,2543,9,235
713,244,18,474,537,1986,253,402,47,463,974,2139,9,236
187,291,7,785,613,1883,94,516,37,665,667,1979,9,237
96,149,10,478,271,1004,65,279,24,398,417,1183,9,238
972,132,10,437,542,2093,312,458,18,410,1102,2300,9,239
1417,187,10,432,648,2694,352,562,16,435,1496,2861,9,240
1309,185,13,406,526,2439,333,468,18,439,1370,2628,9,241
1211,152,11,493,474,2341,316,437,19,494,1288,2554,9,242
607,193,8,478,644,1930,227,434,59,486,694,1900,9,243
135,223,5,661,348,1372,88,397,35,368,473,1361,9,244
90,154,13,678,276,1211,68,317,22,414,549,1370,9,245
106,136,2,500,269,1013,71,229,9,422,416,1147,9,246
1313,170,5,434,451,2373,346,373,9,440,1452,2620,9,247
1375,135,2,453,488,2453,333,414,10,445,1462,2664,9,248
1294,177,3,525,524,2523,332,445,11,441,1371,2600,9,249
797,287,8,455,525,2072,269,426,49,427,976,2147,9,250
154,223,8,652,514,1551,86,483,73,489,462,1593,9,251
110,146,4,501,269,1030,82,223,6,471,408,1190,9,252
1122,141,3,457,497,2220,369,422,10,408,1187,2396,9,253
1584,196,13,486,609,2888,385,565,23,405,1617,2995,9,254
1487,191,5,561,661,2905,378,599,11,476,1601,3065,9,255
1415,235,8,551,645,2854,373,612,15,515,1459,2974,9,256
835,296,8,509,638,2286,294,539,45,463,1005,2346,9,257
154,296,10,681,536,1677,103,523,83,533,506,1748,9,258
140,159,5,604,321,1229,78,273,16,492,564,1423,9,259
1167,137,2,440,532,2278,346,360,8,418,1247,2379,9,260
1503,164,5,536,504,2712,381,473,17,453,1573,2897,9,261
1487,179,4,508,544,2722,371,584,13,403,1488,2859,9,262
1432,218,4,552,669,2875,341,619,15,503,1508,2986,9,263
906,271,20,554,615,2366,316,413,72,560,1088,2449,9,264
180,228,11,781,453,1653,144,474,77,505,570,1770,9,265
117,148,5,467,254,991,90,246,12,408,455,1211,9,266
1104,147,9,465,498,2223,348,365,19,423,1245,2400,9,267
1509,164,7,515,606,2801,408,560,10,422,1637,3037,9,268
1491,226,10,503,614,2844,440,662,17,401,1508,3028,9,269
1372,183,6,610,538,2709,329,588,16,507,1508,2948,9,270
882,215,12,530,658,2297,290,528,66,452,1028,2364,9,271
174,247,16,836,564,1837,97,630,52,508,583,1870,9,272
100,141,5,564,267,1077,88,261,10,418,518,1295,9,273
1105,153,10,464,492,2224,336,374,12,414,1214,2350,9,274
1558,161,6,458,561,2744,380,470,12,432,1539,2833,9,275
1450,171,7,550,557,2735,344,501,8,467,1565,2885,9,276
1372,204,6,618,562,2762,323,537,23,459,1543,2885,9,277
851,247,6,523,576,2203,311,400,38,530,986,2265,9,278
192,264,16,669,703,1844,97,455,73,808,505,1938,9,279
99,146,1,519,298,1063,92,281,10,427,495,1305,9,280
1181,156,1,514,506,2358,385,345,12,454,1292,2488,9,281
1601,196,10,480,587,2874,419,498,17,445,1599,2978,9,282
1563,164,6,563,594,2890,382,507,17,438,1688,3032,9,283
1354,214,18,577,678,2841,361,508,27,446,1457,2799,9,284
766,283,7,634,644,2334,327,400,50,561,1008,2346,9,285
239,280,2,875,554,1950,152,490,44,567,693,1946,9,286
331,186,3,689,406,1615,124,354,12,799,589,1878,9,287
440,152,3,618,395,1608,224,350,6,453,743,1776,9,288
1633,154,5,547,637,2976,387,558,13,487,1715,3160,9,289
1583,170,10,585,569,2917,376,520,22,452,1740,3110,9,290
1458,191,4,603,700,2956,381,612,19,464,1596,3072,9,291
896,264,11,578,625,2374,294,477,39,459,1163,2432,9,292
171,250,13,705,528,1667,82,484,63,521,576,1726,9,293
107,144,6,636,329,1222,76,346,23,414,500,1359,9,294
1204,167,7,478,539,2395,376,424,23,406,1321,2550,9,295
1615,194,17,539,593,2958,403,491,29,442,1718,3083,9,296
1559,195,10,561,651,2976,378,586,23,478,1667,3132,9,297
1416,177,10,596,640,2839,333,603,22,469,1459,2886,9,298
867,277,15,598,580,2337,271,468,48,527,1137,2451,9,299
219,281,8,744,481,1733,93,391,77,594,564,1719,9,300
645,168,8,816,395,2032,95,332,24,1060,703,2214,9,301
1171,154,10,477,492,2304,330,388,17,421,1304,2460,9,302
1533,199,13,557,1033,3335,368,1046,24,516,1674,3628,9,303
1574,212,6,581,612,2985,363,507,16,475,1752,3113,9,304
1329,241,26,545,563,2704,339,444,38,480,1582,2883,9,305
804,261,6,539,577,2187,264,417,44,440,983,2148,9,306
162,281,19,685,565,1712,101,539,41,492,614,1787,9,307
116,105,2,530,250,1003,91,219,10,449,457,1226,9,308
1201,144,5,445,537,2332,355,358,13,435,1331,2492,9,309
1243,171,8,461,554,2437,362,336,25,482,1374,2579,9,310
1233,192,10,515,597,2547,364,453,24,455,1396,2692,9,311
1359,209,22,491,569,2650,360,412,31,421,1483,2707,9,312
736,216,14,547,585,2098,264,418,71,502,946,2201,9,313
159,237,25,647,448,1516,95,350,53,509,562,1569,9,314
128,138,1,625,300,1192,75,237,16,479,566,1373,9,315
414,128,9,513,393,1457,207,320,9,429,670,1635,9,316
1579,158,8,455,576,2776,389,453,25,470,1698,3035,9,317
1561,189,5,463,656,2874,383,535,19,430,1691,3058,9,318
1457,181,20,528,541,2727,367,489,36,434,1563,2889,9,319
911,182,10,537,585,2225,329,392,42,454,1111,2328,9,320
153,177,28,668,512,1538,87,363,55,515,594,1614,9,321
111,116,15,514,297,1053,63,275,12,492,427,1269,9,322
1196,132,23,476,537,2364,343,388,29,408,1357,2525,9,323
1607,167,11,513,590,2888,360,519,31,428,1726,3064,9,324
1586,164,5,533,632,2920,376,473,14,505,1711,3079,9,325
1476,163,12,509,610,2770,351,538,29,453,1533,2904,9,326
842,180,16,472,556,2066,271,457,47,477,1106,2358,9,327
131,217,10,642,447,1447,89,340,58,463,514,1464,9,328
114,148,4,556,285,1107,65,254,16,420,536,1291,9,329
1014,156,9,539,445,2163,285,296,27,435,1198,2241,9,330
1118,161,6,562,555,2402,284,366,19,492,1235,2396,9,331
643,159,8,634,440,1884,200,262,17,689,707,1875,9,332
98,91,3,423,116,731,262,97,9,222,169,759,9,333
207,109,12,636,245,1209,122,224,23,432,527,1328,9,334
98,149,5,489,291,1032,69,276,37,426,407,1215,9,335
95,131,9,477,293,1005,78,302,26,394,502,1302,9,336
1048,141,10,438,461,2098,306,378,19,395,1255,2353,9,337
1511,163,16,447,591,2728,341,543,24,409,1650,2967,9,338
1469,147,24,480,563,2683,336,567,32,435,1573,2943,9,339
1377,163,11,566,625,2742,351,557,23,438,1481,2850,9,340
879,195,13,469,539,2095,260,413,49,450,1062,2234,9,341
112,272,15,734,593,1726,94,466,49,590,661,1860,9,342
82,126,12,621,361,1202,56,314,18,435,495,1318,9,343
1214,137,5,430,504,2290,306,426,19,370,1327,2448,9,344
1600,180,17,497,575,2869,367,558,31,391,1689,3036,9,345
1634,172,12,548,543,2909,370,561,27,443,1649,3050,9,346
1479,224,14,560,700,2977,369,729,29,489,1513,3129,9,347
888,246,13,566,622,2335,275,506,73,502,1112,2468,9,348
277,261,16,854,602,2010,93,634,73,738,575,2113,9,349
96,107,1,490,308,1002,67,282,8,455,360,1172,9,350
1132,116,4,432,486,2170,286,368,13,354,1226,2247,9,351
1468,190,5,506,606,2775,338,534,25,391,1607,2895,9,352
1414,174,6,555,558,2707,332,440,9,466,1469,2716,9,353
1217,221,14,516,570,2538,312,498,33,454,1344,2641,9,354
746,213,15,519,629,2122,260,414,46,487,870,2077,9,355
139,144,8,604,382,1277,96,292,28,404,405,1225,9,356
78,105,12,462,320,977,56,221,17,290,383,967,9,357
442,113,12,501,375,1443,189,244,15,365,617,1430,9,358
232,86,12,341,189,860,126,120,20,332,279,877,9,359
55,65,7,164,87,378,28,86,14,131,138,397,9,360
279,124,23,448,281,1155,138,269,32,335,489,1263,9,361
313,163,10,487,323,1296,178,319,15,401,563,1476,9,362
105,137,5,408,272,927,88,291,27,339,331,1076,9,363
96,100,4,389,241,830,52,228,19,335,407,1041,9,364
545,124,3,522,426,1620,193,320,14,430,855,1812,9,365
450,361,382,492,397,2082,181,528,224,514,861,2308,9,366
100,77,4,215,135,531,35,130,18,196,220,599,10,1
1223,105,9,467,283,2087,154,308,28,386,1198,2074,10,2
1616,139,18,446,355,2574,195,445,31,380,1530,2581,10,3
1504,103,11,409,278,2305,199,405,31,335,1412,2382,10,4
1189,160,7,484,383,2223,192,433,57,405,1092,2179,10,5
183,81,9,328,216,817,81,230,43,208,277,839,10,6
102,97,3,413,163,778,53,238,19,201,305,816,10,7
1540,110,6,404,321,2381,186,393,28,365,1397,2369,10,8
1695,90,1,399,193,2378,205,300,21,520,1348,2394,10,9
1734,103,7,480,305,2629,207,434,30,361,1580,2612,10,10
1663,122,8,453,341,2587,201,503,45,387,1441,2577,10,11
1170,122,6,394,292,1984,177,346,45,377,990,1935,10,12
216,121,11,594,202,1144,88,296,48,235,450,1117,10,13
126,88,3,337,148,702,56,182,16,211,244,709,10,14
265,103,2,367,173,910,102,218,22,208,381,931,10,15
438,89,4,319,214,1064,120,266,23,218,435,1062,10,16
1394,109,14,527,303,2347,174,380,30,336,1328,2248,10,17
1706,120,14,395,390,2625,193,532,26,349,1492,2592,10,18
590,68,17,413,167,1255,105,257,48,304,759,1473,10,19
252,77,8,452,251,1040,86,296,53,237,322,994,10,20
141,74,1,333,190,739,64,213,13,185,263,738,10,21
1517,111,1,414,261,2304,155,311,24,354,1456,2300,10,22
1953,109,4,513,322,2901,224,440,16,396,1792,2868,10,23
1947,126,13,534,351,2971,221,561,35,419,1756,2992,10,24
1772,119,2,442,335,2670,228,503,23,366,1550,2670,10,25
1250,148,4,515,350,2267,208,396,38,425,1178,2245,10,26
232,99,6,821,346,1504,99,400,35,327,678,1539,10,27
130,75,1,461,142,809,41,191,17,239,326,814,10,28
1616,103,3,411,278,2411,202,365,12,361,1465,2405,10,29
2003,110,6,475,296,2890,234,416,25,411,1775,2861,10,30
1985,120,6,466,363,2940,241,503,33,427,1734,2938,10,31
1790,134,15,483,290,2712,205,428,34,419,1599,2685,10,32
1320,150,15,472,353,2310,202,414,89,407,1177,2289,10,33
232,111,8,462,237,1050,90,268,55,228,391,1032,10,34
120,69,8,359,147,703,59,182,28,215,256,740,10,35
1625,116,6,390,261,2398,208,363,23,341,1417,2352,10,36
1969,100,5,435,349,2858,226,437,16,378,1784,2841,10,37
1928,116,8,461,369,2882,212,478,33,384,1723,2830,10,38
1792,127,1,445,299,2664,231,407,21,405,1584,2648,10,39
1362,145,11,459,307,2284,214,375,66,435,1192,2282,10,40
216,140,10,583,337,1286,94,443,56,277,450,1320,10,41
143,83,8,495,154,883,69,173,25,197,468,932,10,42
1557,105,7,448,272,2389,224,340,20,370,1443,2397,10,43
1811,100,9,424,306,2650,201,428,22,401,1587,2639,10,44
1911,111,10,489,322,2843,229,419,47,455,1680,2830,10,45
1779,129,14,475,311,2708,221,416,34,415,1581,2667,10,46
1153,156,20,487,326,2142,195,373,48,486,1034,2136,10,47
176,111,10,382,206,885,81,255,48,243,305,932,10,48
105,98,12,385,163,763,55,272,38,168,260,793,10,49
396,96,8,410,220,1130,115,229,19,259,457,1079,10,50
1880,110,12,483,340,2825,221,463,21,386,1741,2832,10,51
2003,115,9,476,330,2933,227,455,37,414,1799,2932,10,52
1820,110,13,461,360,2764,246,473,38,428,1609,2794,10,53
1318,126,4,428,303,2179,198,345,41,394,1245,2223,10,54
203,127,13,471,269,1083,76,271,72,280,388,1087,10,55
80,100,16,344,207,747,44,292,25,191,249,801,10,56
1627,110,4,419,322,2482,209,442,14,394,1440,2499,10,57
1975,111,10,430,346,2872,240,491,22,403,1783,2939,10,58
2057,96,9,449,293,2904,254,447,32,431,1709,2873,10,59
1845,98,8,472,291,2714,234,469,27,412,1633,2775,10,60
1352,152,7,449,367,2327,191,507,42,388,1224,2352,10,61
230,125,5,478,230,1068,68,289,56,252,406,1071,10,62
123,72,5,500,156,856,60,206,33,235,368,902,10,63
1592,122,4,461,308,2487,215,396,30,387,1521,2549,10,64
2002,144,11,460,390,3007,253,452,26,380,1896,3007,10,65
2058,144,6,491,374,3073,322,493,23,437,1750,3025,10,66
1787,142,5,487,405,2826,283,476,41,417,1619,2836,10,67
1358,148,13,563,401,2483,201,502,100,425,1284,2512,10,68
265,93,11,541,278,1188,88,398,42,280,417,1225,10,69
143,117,7,383,160,810,68,258,17,193,345,881,10,70
1619,107,4,471,262,2463,191,421,16,377,1478,2483,10,71
2082,140,13,575,334,3144,239,593,23,458,1905,3218,10,72
2151,133,2,524,348,3158,256,556,33,480,1916,3241,10,73
1863,132,11,650,399,3055,240,593,55,469,1751,3108,10,74
1266,172,19,519,395,2371,184,413,72,463,1216,2348,10,75
306,146,15,773,314,1554,102,454,93,378,598,1625,10,76
152,116,5,431,252,956,73,355,20,226,343,1017,10,77
1649,127,5,520,290,2591,205,434,13,385,1545,2582,10,78
2116,136,7,520,348,3127,214,572,24,426,1896,3132,10,79
2118,166,9,651,463,3407,266,674,30,490,1961,3421,10,80
1963,136,13,540,368,3020,254,649,26,437,1675,3041,10,81
1399,164,13,639,431,2646,223,525,60,474,1413,2695,10,82
217,167,7,471,275,1137,71,389,55,260,419,1194,10,83
200,99,5,770,236,1310,61,364,21,307,581,1334,10,84
1708,134,7,600,341,2790,191,488,42,435,1556,2712,10,85
2076,149,7,771,397,3400,227,605,24,510,2056,3422,10,86
1959,124,2,543,343,2971,207,506,10,420,1812,2955,10,87
1700,137,8,591,302,2738,203,518,24,411,1619,2775,10,88
1304,163,9,816,426,2718,194,660,44,556,1363,2817,10,89
229,145,14,1055,379,1822,70,2265,1213,430,764,4742,10,90
160,137,10,521,248,1076,64,370,22,286,492,1234,10,91
1489,156,4,917,360,2926,179,717,34,377,1604,2911,10,92
2013,140,7,559,295,3014,220,494,31,409,1885,3039,10,93
2022,131,15,523,432,3123,229,616,33,456,1811,3145,10,94
1879,143,17,725,454,3218,217,684,45,444,1775,3165,10,95
1366,169,10,671,544,2760,203,597,79,470,1355,2704,10,96
351,126,7,687,360,1531,113,471,64,398,530,1576,10,97
206,112,9,732,301,1360,77,528,14,255,479,1353,10,98
1607,114,22,484,322,2549,205,423,45,412,1498,2583,10,99
2095,150,15,505,343,3108,253,522,39,426,1972,3212,10,100
2123,159,2,581,372,3237,247,546,25,458,1953,3229,10,101
1908,130,2,502,331,2873,290,684,25,400,1733,3132,10,102
1422,144,19,539,385,2509,180,524,82,456,1260,2502,10,103
305,137,24,875,419,1760,103,571,81,416,644,1815,10,104
157,134,8,652,239,1190,68,387,25,304,472,1256,10,105
1597,141,6,461,342,2547,208,480,30,393,1455,2566,10,106
1882,155,19,545,369,2970,235,579,63,425,1673,2975,10,107
2037,139,3,509,343,3031,255,614,19,453,1495,2836,10,108
1876,120,4,547,363,2910,340,550,22,497,1560,2969,10,109
1295,156,7,521,489,2468,274,468,88,457,1235,2522,10,110
254,140,10,999,424,1827,123,775,80,277,622,1877,10,111
167,117,2,574,166,1026,54,307,15,234,477,1087,10,112
1651,121,1,490,289,2552,221,444,16,367,1550,2598,10,113
2136,157,1,507,473,3274,274,655,13,417,1935,3294,10,114
2080,141,0,607,427,3255,247,682,21,498,1936,3384,10,115
2025,140,3,645,378,3191,260,627,24,532,1785,3228,10,116
1369,163,10,553,413,2508,214,526,61,446,1347,2594,10,117
268,133,17,550,332,1300,96,445,69,301,413,1324,10,118
174,116,8,615,256,1169,61,360,34,284,493,1232,10,119
1666,139,6,461,294,2566,251,426,27,368,1547,2619,10,120
2138,132,8,500,352,3130,275,533,20,480,1880,3188,10,121
2137,141,8,489,367,3142,278,527,26,464,1885,3180,10,122
1911,172,4,560,346,2993,281,537,18,466,1732,3034,10,123
1407,177,6,514,466,2570,258,578,41,459,1301,2637,10,124
263,137,9,527,268,1204,94,471,67,220,389,1241,10,125
164,104,5,500,206,979,75,372,22,685,373,1527,10,126
1648,121,17,461,289,2536,222,429,28,399,1539,2617,10,127
2173,141,7,558,538,3417,311,732,14,457,1960,3474,10,128
2178,138,11,517,573,3417,278,465,39,516,1814,3112,10,129
1949,173,8,532,305,2967,254,517,35,468,1691,2965,10,130
1375,146,15,494,358,2388,236,420,52,472,1253,2433,10,131
265,157,12,579,240,1253,110,343,57,306,482,1298,10,132
166,112,3,455,154,890,55,235,28,257,387,962,10,133
1697,146,4,553,282,2682,251,527,15,424,1504,2721,10,134
2080,146,12,551,350,3139,251,545,35,435,1930,3196,10,135
2107,121,28,521,344,3121,263,564,48,447,1836,3158,10,136
1961,164,22,539,369,3055,289,567,48,431,1759,3094,10,137
1431,164,10,540,368,2513,255,461,49,507,1290,2562,10,138
271,142,4,469,285,1171,97,350,56,274,407,1184,10,139
174,124,6,522,177,1003,57,331,26,251,346,1011,10,140
1725,129,15,544,340,2753,231,587,35,376,1637,2866,10,141
2210,153,2,578,455,3398,303,735,35,422,1995,3490,10,142
2175,143,3,684,342,3347,265,585,31,500,2019,3400,10,143
1880,158,7,510,314,2869,259,480,26,459,1694,2918,10,144
1245,193,13,538,479,2468,198,595,71,606,1104,2574,10,145
211,177,14,775,439,1616,98,633,87,325,549,1692,10,146
175,162,6,716,241,1300,61,359,31,282,628,1361,10,147
202,138,14,431,197,982,88,272,42,256,402,1060,10,148
1962,154,9,509,314,2948,234,477,28,441,1815,2995,10,149
2086,120,8,558,334,3106,250,510,30,535,1859,3184,10,150
1938,162,2,523,380,3005,221,546,30,470,1758,3025,10,151
1469,164,16,538,376,2563,228,493,54,463,1324,2562,10,152
306,180,33,543,337,1399,101,421,76,345,521,1464,10,153
153,116,6,568,209,1052,82,322,18,260,438,1120,10,154
1712,126,10,499,431,2778,228,583,41,416,1602,2870,10,155
2140,143,2,560,462,3307,300,661,19,467,1976,3423,10,156
2115,128,3,620,305,3171,266,627,17,427,1896,3233,10,157
1923,152,14,597,601,3287,259,853,42,442,1689,3285,10,158
1420,199,13,536,678,2846,213,822,79,429,1298,2841,10,159
270,286,21,1211,998,2786,99,1294,220,340,564,2517,10,160
171,139,5,909,335,1559,61,510,58,263,677,1569,10,161
1724,157,7,530,287,2705,232,523,19,422,1585,2781,10,162
2115,126,0,564,307,3112,253,493,18,438,1912,3114,10,163
2122,146,3,661,358,3290,236,713,39,513,1913,3414,10,164
1932,146,5,606,335,3024,247,618,33,460,1677,3035,10,165
1398,188,9,619,505,2719,218,653,109,452,1306,2738,10,166
250,151,10,721,323,1455,94,558,89,291,468,1500,10,167
140,98,8,545,147,938,47,217,27,219,482,992,10,168
1670,144,5,528,311,2658,263,446,22,367,1549,2647,10,169
2069,127,7,636,429,3268,262,702,31,574,1722,3291,10,170
497,126,4,569,374,1570,153,440,19,258,662,1532,10,171
1691,119,2,703,350,2865,224,457,38,398,1606,2723,10,172
1268,158,7,483,352,2268,212,429,49,420,1170,2280,10,173
186,122,15,606,314,1243,100,481,72,254,422,1329,10,174
146,106,8,406,221,887,71,199,92,205,329,896,10,175
1595,99,5,438,248,2385,210,399,17,355,1460,2441,10,176
2088,106,1,544,280,3019,236,478,18,461,1866,3059,10,177
2072,100,1,574,333,3080,261,516,9,430,1815,3031,10,178
1865,143,5,597,340,2950,240,527,27,456,1700,2950,10,179
1308,132,11,557,338,2346,209,370,53,480,1215,2327,10,180
248,93,5,538,254,1138,76,354,41,299,452,1222,10,181
146,90,10,368,178,792,74,240,21,188,307,830,10,182
1632,122,1,501,354,2610,221,526,11,403,1525,2686,10,183
1967,159,0,530,450,3106,229,654,25,422,1811,3141,10,184
1722,182,2,519,541,2966,228,784,41,658,1301,3012,10,185
342,797,30,783,668,2620,93,1221,82,549,533,2478,10,186
860,123,6,626,390,2005,148,520,37,417,911,2033,10,187
214,118,6,500,247,1085,97,359,43,239,423,1161,10,188
129,93,6,488,153,869,64,204,17,214,422,921,10,189
1582,119,10,523,299,2533,219,479,13,414,1968,3093,10,190
2279,150,5,467,311,3212,249,478,24,451,2092,3294,10,191
2296,114,2,497,287,3196,243,505,10,444,2027,3229,10,192
2167,108,3,492,338,3108,229,480,15,426,1966,3116,10,193
1284,173,6,458,411,2332,181,573,64,386,1174,2378,10,194
226,122,5,646,976,1975,79,1271,51,269,401,2071,10,195
173,104,7,411,168,863,56,199,17,228,365,865,10,196
1632,106,4,458,256,2456,235,366,16,357,1506,2480,10,197
2018,94,6,557,312,2987,263,497,22,485,1735,3002,10,198
1937,112,8,508,267,2832,220,398,28,406,1788,2840,10,199
1803,142,5,549,311,2810,235,468,20,413,1634,2770,10,200
1204,175,10,520,500,2409,182,631,88,392,1141,2434,10,201
207,122,10,559,530,1428,80,604,57,286,474,1501,10,202
112,113,0,559,167,951,59,231,18,222,439,969,10,203
1559,101,0,464,228,2352,202,391,16,402,1387,2398,10,204
1997,121,54,522,377,3071,212,606,68,422,1814,3122,10,205
1870,119,21,532,444,2986,245,647,33,434,1749,3108,10,206
1814,125,0,603,339,2881,199,522,17,410,1738,2886,10,207
1285,152,2,552,285,2276,196,410,46,457,1193,2302,10,208
226,162,5,1134,386,1913,103,573,113,793,468,2050,10,209
142,96,3,472,278,991,74,369,60,264,266,1033,10,210
1619,111,2,499,397,2628,193,578,28,383,1471,2653,10,211
2013,102,4,474,316,2909,251,512,19,371,1836,2989,10,212
1990,102,2,532,290,2916,240,519,17,442,1723,2941,10,213
1749,108,0,566,304,2727,252,482,8,415,1565,2722,10,214
1349,153,6,599,471,2578,199,663,44,440,1198,2544,10,215
230,101,4,864,287,1486,73,526,45,291,595,1530,10,216
171,94,4,566,193,1028,63,276,26,269,463,1097,10,217
1558,99,0,424,305,2386,192,420,8,329,1464,2413,10,218
1964,130,1,443,403,2941,239,624,11,372,1710,2956,10,219
1865,110,2,477,349,2803,214,552,19,392,1649,2826,10,220
1712,109,0,469,397,2687,207,547,18,377,1504,2653,10,221
1069,137,4,416,361,1987,177,472,91,315,949,2004,10,222
210,133,2,511,302,1158,92,464,30,233,400,1219,10,223
178,96,0,515,171,960,74,260,17,243,387,981,10,224
1424,105,0,453,219,2201,195,383,10,351,1347,2286,10,225
1892,118,5,478,282,2775,239,423,14,434,1713,2823,10,226
1839,137,6,491,313,2786,234,481,21,384,1656,2776,10,227
1697,142,3,488,312,2642,240,501,28,380,1548,2697,10,228
1199,151,6,479,328,2163,194,452,46,390,1111,2193,10,229
202,140,7,485,307,1141,72,378,83,219,436,1188,10,230
153,83,3,409,163,811,73,261,15,211,284,844,10,231
1526,90,1,430,207,2254,208,386,13,340,1372,2319,10,232
1935,145,2,490,414,2986,213,681,23,405,1731,3053,10,233
1890,179,2,529,398,2998,210,636,60,384,1749,3039,10,234
1793,100,0,534,297,2724,187,504,14,392,1612,2709,10,235
1309,171,9,471,449,2409,198,557,58,471,1556,2840,10,236
235,127,3,565,284,1214,85,395,67,306,430,1283,10,237
135,109,9,388,148,789,71,230,31,223,304,859,10,238
1542,99,16,414,414,2485,174,590,29,371,1444,2608,10,239
2049,123,13,486,456,3127,240,735,23,419,1720,3137,10,240
2005,130,12,434,446,3027,202,642,19,413,1794,3070,10,241
1824,128,3,471,312,2738,209,461,19,372,1686,2747,10,242
1214,122,6,519,491,2352,165,573,65,560,1036,2399,10,243
185,136,9,767,334,1431,80,566,61,296,531,1534,10,244
145,92,4,660,175,1076,78,321,17,265,518,1199,10,245
175,104,3,393,184,859,75,245,5,188,387,900,10,246
1955,112,8,490,270,2835,233,507,19,430,1752,2941,10,247
2075,127,11,508,356,3077,234,544,26,433,1896,3133,10,248
1959,119,4,465,313,2860,229,532,27,364,1755,2907,10,249
1422,158,1,465,299,2345,178,429,48,398,1286,2339,10,250
202,130,11,606,343,1292,85,434,64,276,483,1342,10,251
177,100,0,396,184,857,102,281,12,234,304,933,10,252
1765,122,1,418,246,2552,208,436,23,309,1612,2588,10,253
2169,108,0,538,425,3240,274,620,26,421,2002,3343,10,254
2206,140,2,486,428,3262,243,667,19,445,1920,3294,10,255
2084,133,0,510,391,3118,252,684,19,446,1767,3168,10,256
1467,182,11,471,420,2551,199,643,45,430,1319,2636,10,257
205,130,1,689,371,1396,83,584,49,298,473,1487,10,258
157,102,0,558,178,995,73,258,17,247,506,1101,10,259
1741,92,0,474,205,2512,190,415,8,376,1546,2535,10,260
2177,126,9,430,321,3063,250,526,29,409,1941,3155,10,261
2141,109,1,517,287,3055,228,589,22,413,1828,3080,10,262
2017,124,0,505,373,3019,226,646,21,422,1772,3087,10,263
1480,146,1,492,366,2485,210,509,74,434,1322,2549,10,264
261,132,0,687,399,1479,79,639,57,319,468,1562,10,265
152,101,4,433,183,873,54,252,11,211,356,884,10,266
1751,74,2,454,275,2556,195,419,20,391,1644,2669,10,267
2257,107,5,455,401,3225,224,656,25,379,2029,3313,10,268
2245,138,12,539,403,3337,222,681,37,475,1950,3365,10,269
2077,136,9,561,331,3114,222,606,24,388,1932,3172,10,270
1504,127,11,492,464,2598,186,628,71,459,1275,2619,10,271
207,229,8,760,450,1654,77,787,88,325,442,1719,10,272
144,119,0,506,289,1058,78,409,21,207,456,1171,10,273
1824,82,0,408,270,2584,177,434,7,360,1623,2601,10,274
2225,94,1,459,294,3073,200,488,18,402,2041,3149,10,275
2237,135,5,460,285,3122,218,468,26,402,2038,3152,10,276
2061,147,0,499,352,3059,235,567,24,425,1837,3088,10,277
1449,181,6,475,445,2556,186,544,93,432,1336,2591,10,278
210,125,4,505,278,1122,93,388,47,272,418,1218,10,279
134,108,0,419,199,860,71,242,11,233,409,966,10,280
1791,93,0,484,258,2626,225,402,9,415,1608,2659,10,281
2314,108,2,450,329,3203,237,521,18,399,2040,3215,10,282
2283,124,6,542,287,3242,225,536,30,501,1995,3287,10,283
2011,147,0,584,344,3086,261,596,11,439,1741,3048,10,284
1270,143,2,565,331,2311,212,535,50,517,1065,2379,10,285
289,141,1,596,347,1374,91,485,47,291,490,1404,10,286
221,110,4,495,231,1061,56,333,21,277,395,1082,10,287
602,87,0,463,216,1368,108,329,11,285,653,1386,10,288
2199,116,5,519,344,3183,215,626,25,433,1942,3241,10,289
2251,107,6,546,282,3192,206,538,23,470,1991,3228,10,290
2026,113,5,550,362,3056,238,607,16,445,1771,3077,10,291
1447,158,3,547,427,2582,172,561,50,430,1427,2640,10,292
253,180,2,726,346,1507,70,552,68,332,482,1504,10,293
149,116,5,438,258,966,62,384,9,259,343,1057,10,294
1834,120,15,439,251,2659,181,415,45,380,1623,2644,10,295
2269,111,16,497,323,3216,255,524,23,387,2022,3211,10,296
2291,136,3,509,383,3322,270,626,21,404,2048,3369,10,297
2114,136,0,514,421,3185,283,630,11,438,1860,3222,10,298
1420,141,3,559,368,2491,201,526,50,449,1332,2558,10,299
274,161,2,596,272,1305,88,373,52,324,481,1318,10,300
276,120,5,423,199,1023,87,357,26,299,368,1137,10,301
1815,95,2,458,265,2635,209,414,23,399,1603,2648,10,302
2212,110,3,534,564,3423,248,851,22,621,2402,4144,10,303
2290,116,5,497,352,3260,231,590,23,398,1997,3239,10,304
1996,146,0,555,407,3104,242,555,17,479,1797,3090,10,305
1400,124,6,480,318,2328,191,464,37,409,1378,2479,10,306
226,108,15,565,327,1241,66,477,58,308,448,1357,10,307
182,100,1,372,160,815,82,240,14,240,299,875,10,308
1785,82,9,450,366,2692,208,450,13,423,1635,2729,10,309
1742,127,9,480,308,2666,217,404,35,620,1419,2695,10,310
1953,120,3,429,331,2836,217,487,9,410,1753,2876,10,311
2020,107,1,491,294,2913,265,477,8,399,1788,2937,10,312
1325,122,6,461,398,2312,204,481,42,485,1193,2405,10,313
202,102,5,482,279,1070,94,308,50,257,445,1154,10,314
193,91,2,1216,233,1735,74,268,16,276,1118,1752,10,315
579,90,0,439,255,1363,138,287,13,294,595,1327,10,316
2187,81,1,478,267,3014,212,466,16,415,1910,3019,10,317
2313,98,4,508,332,3255,220,543,17,415,2089,3284,10,318
2110,110,0,444,320,2984,233,511,21,426,1806,2997,10,319
1083,130,8,446,311,1978,175,439,56,381,1233,2284,10,320
205,114,12,561,221,1113,76,274,59,266,491,1166,10,321
134,92,6,341,217,790,62,274,16,202,292,846,10,322
1901,83,1,442,239,2666,205,404,18,350,1719,2696,10,323
2309,88,3,460,317,3177,254,459,24,448,2093,3278,10,324
2346,114,2,477,346,3285,254,531,18,452,2037,3292,10,325
2067,129,0,479,387,3062,256,546,16,417,1827,3062,10,326
1442,106,9,421,333,2311,202,472,41,402,1316,2433,10,327
178,117,1,503,339,1138,67,407,40,242,391,1147,10,328
131,99,5,448,165,848,58,223,15,237,365,898,10,329
1606,142,14,475,346,2583,174,407,69,393,1543,2586,10,330
1813,92,3,529,345,2782,179,474,18,426,1650,2747,10,331
1235,112,1,496,302,2146,179,414,17,747,923,2280,10,332
95,155,3,168,134,555,47,132,10,299,306,794,10,333
537,107,1,663,215,1523,92,341,31,314,706,1484,10,334
173,111,3,477,260,1024,69,306,35,227,402,1039,10,335
132,90,0,360,246,828,59,276,8,199,270,812,10,336
1732,70,0,411,243,2456,187,352,7,360,1536,2442,10,337
2186,104,2,494,289,3075,206,530,11,428,1977,3152,10,338
2155,112,4,473,233,2977,191,503,18,390,1951,3053,10,339
1977,119,0,467,324,2887,236,563,21,387,1732,2939,10,340
1438,102,5,422,306,2273,174,436,31,414,1312,2367,10,341
197,127,4,481,389,1198,65,516,55,272,384,1292,10,342
122,92,1,394,253,862,68,339,24,213,310,954,10,343
1761,82,6,431,249,2529,210,444,17,333,1634,2638,10,344
2334,86,7,512,248,3187,239,473,21,426,2015,3174,10,345
2255,123,3,457,271,3109,215,579,19,397,1934,3144,10,346
2084,131,4,538,319,3076,225,559,31,433,1795,3043,10,347
1478,116,3,472,324,2393,188,474,64,392,1283,2401,10,348
225,120,12,481,356,1194,67,419,62,273,442,1263,10,349
125,104,2,354,241,826,58,297,16,222,285,878,10,350
1685,115,6,458,219,2483,208,393,15,373,1579,2568,10,351
2187,90,5,475,354,3111,215,545,24,457,1974,3215,10,352
2076,113,4,481,336,3010,210,602,16,400,1810,3038,10,353
1882,111,4,503,357,2857,202,524,22,477,1739,2964,10,354
1289,129,3,502,427,2350,174,522,49,441,1235,2421,10,355
167,92,0,401,296,956,71,303,46,276,348,1044,10,356
152,94,0,437,239,922,59,303,9,186,326,883,10,357
1074,87,1,606,332,2100,176,404,14,444,1099,2137,10,358
483,63,2,330,182,1060,151,223,24,380,476,1254,10,359
55,75,0,142,116,388,43,93,9,180,200,525,10,360
766,71,6,502,288,1633,123,332,26,308,766,1555,10,361
778,135,4,588,298,1803,115,350,29,401,853,1748,10,362
152,113,9,467,255,996,56,328,45,216,366,1011,10,363
125,105,1,392,184,807,47,253,21,208,335,864,10,364
1045,112,4,572,345,2078,153,433,21,436,1037,2080,10,365
954,181,48,555,240,1978,156,234,97,612,928,2027,10,366
136,116,12,411,333,1008,59,221,15,359,348,1002,11,1
855,219,5,764,940,2783,630,393,12,668,1071,2774,11,2
1201,222,1,859,1241,3524,933,409,11,785,1359,3497,11,3
1255,293,13,817,1344,3722,968,496,22,739,1467,3692,11,4
966,289,33,915,1338,3541,899,439,49,794,1160,3341,11,5
239,534,70,961,688,2492,481,336,34,941,533,2325,11,6
167,585,43,919,850,2564,290,314,25,992,709,2330,11,7
1370,393,8,1000,1584,4355,1081,485,19,936,1692,4213,11,8
1532,213,7,1044,999,3795,1086,322,14,904,1355,3681,11,9
1638,439,7,1135,1546,4765,1143,580,13,1053,1828,4617,11,10
1547,493,6,1047,1678,4771,1134,676,32,920,1848,4610,11,11
1219,424,14,1177,1491,4325,999,471,55,1024,1435,3984,11,12
206,299,28,1343,752,2628,111,500,47,804,1021,2483,11,13
156,205,7,914,523,1805,96,313,12,627,643,1691,11,14
282,209,8,859,465,1823,148,401,23,583,741,1896,11,15
481,295,6,574,907,2263,562,369,14,723,650,2318,11,16
1194,403,0,1151,1530,4278,888,523,18,1076,1660,4165,11,17
1728,1618,7,1517,1968,6838,1209,687,21,1583,2645,6145,11,18
678,466,30,2571,1115,4860,840,560,46,779,2267,4492,11,19
214,333,8,1478,1260,3293,377,512,46,1096,1031,3062,11,20
195,193,4,1012,558,1962,125,359,12,734,634,1864,11,21
1435,411,10,965,1588,4409,1132,540,15,948,1648,4283,11,22
1791,432,2,1054,1677,4956,1208,642,12,966,1975,4803,11,23
1786,495,7,1152,1760,5200,1246,645,17,1118,1991,5017,11,24
1667,513,6,1079,1666,4931,1131,667,32,969,1850,4649,11,25
1107,540,14,1335,1597,4593,971,682,74,1177,1321,4225,11,26
238,323,29,1258,879,2727,144,584,76,893,885,2582,11,27
182,175,3,869,489,1718,94,364,9,674,639,1780,11,28
1453,383,6,1016,1613,4471,1171,462,17,943,1723,4316,11,29
1735,430,2,1047,1675,4889,1245,585,5,989,1915,4739,11,30
1749,483,4,1171,1655,5062,1263,668,7,1010,1930,4878,11,31
1675,549,2,1148,1752,5126,1179,716,21,1048,1892,4856,11,32
1243,502,12,1304,1756,4817,1037,727,73,1132,1494,4463,11,33
248,378,15,1271,786,2698,140,540,49,865,823,2417,11,34
189,234,9,1031,628,2091,138,375,20,679,724,1936,11,35
1449,395,9,1064,1606,4523,1199,464,17,959,1708,4347,11,36
1822,474,1,1110,1702,5109,1283,613,11,1015,1973,4895,11,37
1748,464,1,1158,1736,5107,1285,638,9,1107,1824,4863,11,38
1631,469,11,1192,1638,4941,1167,666,19,1014,1828,4694,11,39
1223,578,24,1343,1630,4798,1003,750,89,1106,1457,4405,11,40
3,7,1,9,14,34,2,8,2,7,14,33,11,41
4,13,4,6,4,31,3,15,9,5,4,36,11,42
1454,387,8,1031,1482,4362,1172,493,7,976,1654,4302,11,43
1584,433,7,1043,1344,4411,1125,650,14,1031,1484,4304,11,44
1662,474,4,1224,1794,5158,1250,666,16,1076,1882,4890,11,45
1635,538,0,1137,1782,5092,1171,690,34,1007,1767,4669,11,46
1034,448,29,1267,1625,4403,970,606,96,993,1234,3899,11,47
242,332,23,1096,810,2503,193,502,71,721,770,2257,11,48
182,216,1,1117,608,2124,103,394,21,804,728,2050,11,49
359,316,2,855,921,2453,427,375,7,790,783,2382,11,50
1490,429,15,1143,1620,4697,1125,626,28,1081,1692,4552,11,51
1737,417,5,1139,1644,4942,1207,648,13,1061,1882,4811,11,52
1602,501,8,1186,1684,4981,1135,705,9,1047,1853,4749,11,53
1273,479,14,1170,1630,4566,1018,638,54,1036,1430,4176,11,54
223,345,11,1268,807,2654,178,576,62,954,804,2574,11,55
174,212,1,886,641,1914,113,386,6,685,711,1901,11,56
1496,413,0,1073,1666,4648,1169,593,4,1022,1691,4479,11,57
1782,413,3,1169,1716,5083,1261,664,15,1080,1901,4921,11,58
1787,446,0,1209,1595,5037,1238,590,11,1089,1858,4786,11,59
1681,517,1,1194,1707,5100,1222,720,14,1107,1861,4924,11,60
1360,555,16,1203,1762,4896,1026,694,89,1146,1591,4546,11,61
242,384,10,1190,742,2568,149,518,65,762,801,2295,11,62
187,231,8,1111,617,2154,114,424,13,820,830,2201,11,63
1455,426,5,1205,1647,4738,1170,567,11,1104,1784,4636,11,64
1752,455,3,1119,1770,5099,1219,699,6,1120,1961,5005,11,65
1715,469,6,1200,1721,5111,1250,736,7,1082,1788,4863,11,66
1686,633,3,1231,1839,5392,1221,819,20,1056,1869,4985,11,67
1364,516,13,1520,1810,5223,1119,718,79,1076,1526,4518,11,68
320,231,6,1018,604,2179,138,396,38,687,653,1912,11,69
184,215,1,917,553,1870,169,337,14,590,683,1793,11,70
1464,299,10,930,1399,4102,1022,627,15,721,1673,4058,11,71
1715,427,5,1192,1530,4869,1085,779,12,977,1952,4805,11,72
1743,349,3,1166,1585,4846,1089,767,14,1021,1808,4699,11,73
1279,391,4,1193,1546,4413,1002,801,37,870,1530,4240,11,74
913,357,20,1185,1434,3909,860,681,84,980,1267,3872,11,75
359,516,9,1326,1427,3637,149,807,86,1136,1480,3658,11,76
197,294,9,1212,793,2505,138,879,25,889,993,2924,11,77
1447,442,18,1153,1732,4792,1246,648,25,1098,1794,4811,11,78
1675,492,7,1178,1741,5093,1172,792,19,1082,1950,5015,11,79
1857,567,33,1610,1711,5778,1340,886,38,1290,1990,5544,11,80
1770,497,4,1329,1628,5228,1277,753,13,1188,1781,5012,11,81
1186,475,18,1297,1714,4690,1009,767,64,1007,1543,4390,11,82
198,453,7,935,729,2322,101,604,30,647,790,2172,11,83
201,235,0,1324,696,2456,147,430,10,939,952,2478,11,84
1390,504,14,1302,1864,5074,1168,792,29,1112,1838,4939,11,85
1779,512,20,1290,1821,5422,1288,824,27,1124,2082,5345,11,86
1610,479,14,1315,1741,5159,1172,654,19,1017,1785,4647,11,87
1537,433,5,1318,1231,4524,860,658,14,916,1785,4233,11,88
1075,437,18,1194,1501,4225,708,675,50,1157,1468,4058,11,89
221,350,14,1175,684,2444,109,602,37,738,875,2361,11,90
172,206,0,1201,585,2164,163,397,6,908,583,2057,11,91
1231,321,1,957,1292,3802,829,843,20,907,1766,4365,11,92
1631,388,25,1145,1617,4806,1180,696,33,1012,1921,4842,11,93
1584,435,17,1072,1525,4633,1117,689,29,1018,1702,4555,11,94
1665,112,7,1295,519,3598,1170,206,18,1140,416,2950,11,95
992,504,23,1164,1724,4407,900,846,89,1075,1351,4261,11,96
305,375,15,1298,777,2770,173,630,53,888,868,2612,11,97
366,254,13,1230,631,2494,140,532,16,918,879,2485,11,98
1379,416,8,1091,1462,4356,1175,517,34,1021,1572,4319,11,99
1717,509,15,1122,1744,5107,1226,721,17,1164,1989,5117,11,100
1674,479,18,1115,1767,5053,1320,741,23,1005,1862,4951,11,101
1696,459,10,1169,1736,5070,1240,668,30,1147,1859,4944,11,102
1220,537,20,1228,1646,4651,1017,781,62,1053,1566,4479,11,103
283,388,9,1312,858,2850,171,625,91,833,932,2652,11,104
224,265,13,1330,666,2498,143,491,14,894,909,2451,11,105
1096,401,4,1071,1313,3885,1013,614,18,959,1298,3902,11,106
1222,504,11,1215,1400,4352,1005,732,20,1033,1356,4146,11,107
1303,391,10,1213,1355,4272,942,710,15,1055,1515,4237,11,108
1270,590,15,1233,1408,4516,966,778,32,1042,1520,4338,11,109
904,530,19,1177,1384,4014,830,710,70,956,1284,3850,11,110
244,489,20,1421,990,3164,181,804,87,834,1058,2964,11,111
185,244,2,1007,543,1981,156,374,6,731,779,2046,11,112
1446,385,7,992,1544,4374,1152,550,12,969,1729,4412,11,113
1723,515,5,1149,1719,5111,1241,728,14,1084,1971,5038,11,114
1678,433,6,1409,1662,5188,1252,733,14,1389,1740,5128,11,115
1603,462,0,1131,1637,4833,1207,779,9,1027,1708,4730,11,116
1191,549,17,1229,1622,4608,1003,757,49,1153,1451,4413,11,117
307,389,7,1045,698,2446,148,547,73,855,711,2334,11,118
207,317,13,1030,581,2148,128,525,20,771,736,2180,11,119
1462,386,6,1013,1473,4340,1125,567,14,954,1637,4297,11,120
1636,375,12,1072,1564,4659,1164,703,16,937,1867,4687,11,121
1644,433,10,1179,1578,4844,1250,715,18,996,1779,4758,11,122
1562,474,10,1208,1566,4820,1178,789,19,1009,1775,4770,11,123
1194,618,17,1262,1655,4746,1083,832,85,1188,1479,4667,11,124
254,313,10,1070,614,2261,133,497,40,757,711,2138,11,125
136,209,10,999,584,1938,135,448,16,626,664,1889,11,126
1330,320,18,992,1423,4083,1087,587,24,853,1565,4116,11,127
1658,476,6,1143,1801,5084,1168,904,25,992,1970,5059,11,128
1764,459,2,1140,1457,4822,1183,852,20,1028,1635,4718,11,129
1383,423,3,1127,1534,4470,1108,744,24,906,1647,4429,11,130
1037,473,12,1083,1524,4129,962,665,41,987,1442,4097,11,131
256,268,20,1548,1035,3127,500,516,50,1110,789,2965,11,132
174,192,3,905,484,1758,97,411,3,675,546,1732,11,133
1405,298,3,1060,1373,4139,1048,598,7,848,1696,4197,11,134
1726,323,2,1102,1365,4518,1076,682,10,926,1885,4579,11,135
1765,317,10,1065,1374,4531,1087,649,15,901,1718,4370,11,136
1693,429,4,1138,1467,4731,1067,739,10,921,1765,4502,11,137
1212,433,14,1246,1318,4223,991,600,52,1071,1374,4088,11,138
8,11,2,12,8,41,10,11,3,10,10,44,11,139
9,7,6,7,5,34,6,7,9,6,5,33,11,140
1665,335,14,969,1463,4446,1081,717,21,958,1718,4495,11,141
1843,435,12,1251,1578,5119,1207,847,16,979,1999,5048,11,142
1870,407,13,1323,1507,5120,1242,799,17,1016,1954,5028,11,143
1816,401,2,1153,1283,4655,1108,737,9,900,1824,4578,11,144
1246,376,14,1281,1262,4179,909,759,59,1063,1318,4108,11,145
237,288,16,1055,563,2159,199,579,62,640,642,2122,11,146
198,327,3,997,496,2021,112,454,13,673,697,1949,11,147
186,190,7,723,363,1469,90,356,18,502,581,1547,11,148
1707,433,23,1034,1423,4620,1132,723,31,992,1938,4816,11,149
1918,314,17,991,1432,4672,1122,678,31,994,1882,4707,11,150
1849,436,8,1160,1514,4967,1130,777,27,931,1899,4764,11,151
1344,467,20,1214,1458,4503,977,737,54,1015,1549,4332,11,152
272,336,27,1070,676,2381,213,683,73,831,674,2474,11,153
176,207,12,908,624,1927,108,476,16,682,690,1972,11,154
1753,343,17,962,1259,4334,981,663,26,885,1749,4304,11,155
1821,384,9,1060,1263,4537,948,801,19,877,1846,4491,11,156
1923,274,3,1070,1224,4494,1001,712,7,883,1872,4475,11,157
1756,388,7,1039,1351,4541,948,811,26,844,1805,4434,11,158
1268,465,14,1257,1351,4355,789,859,80,1017,1427,4172,11,159
285,347,12,1433,818,2895,221,934,87,752,919,2913,11,160
192,228,8,1062,550,2040,139,526,13,648,806,2132,11,161
1501,317,5,926,1284,4033,885,650,14,828,1751,4128,11,162
1866,426,10,1057,1337,4696,960,778,19,895,1983,4635,11,163
1866,356,2,1103,1401,4728,946,847,27,886,1778,4484,11,164
1734,443,5,1126,1244,4552,934,830,18,900,1864,4546,11,165
1267,417,21,1088,1208,4001,761,834,85,891,1337,3908,11,166
271,338,18,1169,747,2543,240,676,45,719,685,2365,11,167
207,236,11,1053,584,2091,163,536,15,822,763,2299,11,168
1339,464,12,1001,1223,4039,835,801,19,929,1556,4140,11,169
1750,436,5,1044,1343,4578,845,802,27,839,1929,4442,11,170
785,280,6,1099,812,2982,411,636,14,777,1127,2965,11,171
1589,367,7,1102,1270,4335,807,904,19,822,1512,4064,11,172
1067,504,4,1254,1161,3990,698,735,145,1023,1360,3961,11,173
237,460,7,1060,1073,2837,184,990,94,797,647,2712,11,174
202,231,4,1033,522,1992,144,461,11,633,724,1973,11,175
1711,268,11,1113,1184,4287,931,642,20,1011,1718,4322,11,176
1812,405,11,1157,1338,4723,955,786,19,977,1631,4368,11,177
1693,350,13,1252,1313,4621,1061,761,21,1010,1633,4486,11,178
1533,454,10,1229,1506,4732,976,874,30,1016,1579,4475,11,179
1099,435,11,1086,1332,3963,818,738,60,873,1326,3815,11,180
272,346,11,1015,704,2348,140,575,40,667,722,2144,11,181
187,182,5,907,500,1781,108,408,19,585,551,1671,11,182
1203,308,10,1109,1341,3971,954,629,13,935,1382,3913,11,183
1466,387,6,1176,1387,4422,1029,705,14,910,1643,4301,11,184
1259,375,4,1153,1457,4248,941,674,15,1044,1326,4000,11,185
298,728,8,831,734,2599,98,991,31,628,581,2329,11,186
551,332,12,1090,808,2793,508,605,34,710,800,2657,11,187
224,213,14,866,554,1871,133,475,58,574,597,1837,11,188
153,196,4,847,413,1613,107,389,5,588,609,1698,11,189
1198,280,3,965,1286,3732,945,626,12,840,1312,3735,11,190
1512,333,2,1118,1322,4287,1057,658,9,1015,1543,4282,11,191
1515,353,7,1127,1320,4322,934,686,12,1034,1576,4242,11,192
1416,434,10,1294,1377,4531,937,840,19,1012,1571,4379,11,193
1051,364,10,1067,1142,3634,787,715,56,803,1117,3478,11,194
259,281,9,1065,652,2266,150,593,67,661,732,2203,11,195
181,204,41,924,409,1759,130,435,49,612,570,1796,11,196
1283,286,3,1008,1222,3802,944,586,15,903,1288,3736,11,197
1466,292,6,986,1211,3961,1011,640,17,916,1439,4023,11,198
1551,354,15,1056,1283,4259,1002,652,22,948,1539,4163,11,199
1404,339,14,1385,1292,4434,947,917,25,933,1460,4282,11,200
951,475,20,1145,1427,4018,756,999,98,836,1197,3886,11,201
219,581,17,1282,861,2960,157,647,71,1121,926,2922,11,202
171,228,8,1121,514,2042,121,473,14,773,687,2068,11,203
1196,308,11,1020,1128,3663,855,638,24,820,1260,3597,11,204
1494,356,12,1258,1299,4419,923,800,22,919,1748,4412,11,205
1451,339,5,1304,1299,4398,913,834,10,974,1565,4296,11,206
1420,409,6,1178,1337,4350,856,854,29,981,1686,4406,11,207
1068,381,23,1093,1175,3740,738,762,87,920,1287,3794,11,208
229,489,11,1167,767,2663,171,556,105,880,890,2602,11,209
184,239,7,899,529,1858,139,427,26,667,634,1893,11,210
1173,278,8,1209,1097,3765,799,527,26,956,1349,3657,11,211
1455,371,16,1009,1232,4083,892,629,21,905,1589,4036,11,212
1473,345,10,1103,1181,4112,815,731,30,983,1489,4048,11,213
1287,397,7,1066,1287,4044,827,740,21,923,1486,3997,11,214
1005,373,12,952,1114,3456,659,666,88,855,1059,3327,11,215
281,214,13,983,628,2119,159,425,101,760,626,2071,11,216
194,227,6,923,437,1787,134,388,16,604,647,1789,11,217
1046,273,19,926,1082,3346,687,566,19,735,1179,3186,11,218
1305,310,3,1005,1085,3708,796,638,8,804,1452,3698,11,219
1260,250,6,896,1064,3476,724,537,17,757,1375,3410,11,220
1148,244,5,856,937,3190,662,510,16,768,1194,3150,11,221
669,290,23,725,833,2540,547,493,48,543,890,2521,11,222
192,268,11,907,513,1891,132,495,42,652,673,1994,11,223
156,188,16,771,432,1563,117,340,19,605,554,1635,11,224
910,251,7,821,1077,3066,761,481,12,720,1106,3080,11,225
1109,347,13,828,1143,3440,825,518,17,705,1416,3481,11,226
1134,331,11,922,1100,3498,846,571,17,765,1291,3490,11,227
1056,364,5,921,1060,3406,682,563,15,780,1282,3322,11,228
774,330,20,995,1066,3185,661,546,54,798,1016,3075,11,229
221,244,22,846,514,1847,152,408,58,602,580,1800,11,230
144,206,11,778,465,1604,125,305,17,561,588,1596,11,231
952,302,4,834,1268,3360,913,445,11,733,1232,3334,11,232
1167,351,9,966,1398,3891,1008,661,9,820,1392,3890,11,233
1177,412,20,1024,1425,4058,1072,635,42,874,1436,4059,11,234
1151,453,11,1065,1351,4031,1015,622,26,910,1444,4017,11,235
859,462,13,1135,1420,3889,874,757,68,941,1090,3730,11,236
256,355,36,1057,744,2448,155,597,74,788,727,2341,11,237
164,284,18,1495,508,2469,120,426,16,887,1045,2494,11,238
1249,405,10,1049,1646,4359,1209,578,20,965,1578,4350,11,239
1572,506,13,1149,1739,4979,1282,749,32,1036,1853,4952,11,240
1539,443,10,1172,1715,4879,1312,746,17,1043,1831,4949,11,241
1436,376,18,1164,1646,4640,1263,560,26,991,1767,4607,11,242
1066,709,27,1323,1616,4741,1022,814,159,1118,1267,4380,11,243
229,324,25,1269,775,2622,126,593,78,794,889,2480,11,244
170,367,6,1159,673,2375,129,558,18,756,794,2255,11,245
176,249,2,937,545,1909,100,469,4,657,780,2010,11,246
1634,460,17,1167,1759,5037,1387,663,7,1120,1922,5099,11,247
1790,493,11,1110,1783,5187,1377,700,16,1135,1929,5157,11,248
1667,570,14,1284,1780,5315,1327,783,16,1096,1990,5212,11,249
1264,518,35,1248,1771,4836,1092,718,69,1188,1490,4557,11,250
356,416,16,1270,811,2869,176,668,89,924,848,2705,11,251
201,245,17,1102,640,2205,125,465,19,846,787,2242,11,252
1559,425,8,1223,1759,4974,1417,657,17,1132,1809,5032,11,253
1815,562,5,1168,1771,5321,1386,769,9,1086,1975,5225,11,254
1771,470,12,1171,1828,5252,1424,776,15,1066,1937,5218,11,255
1752,621,14,1283,1925,5595,1372,844,27,1115,2038,5396,11,256
1348,616,32,1326,1819,5141,1208,891,113,1134,1615,4961,11,257
312,486,17,1348,974,3137,169,754,83,1103,855,2964,11,258
230,217,7,1217,681,2352,136,483,15,966,870,2470,11,259
1536,447,17,1121,1768,4889,1417,679,21,1017,1796,4930,11,260
1850,495,9,1194,1817,5365,1410,704,12,1201,2064,5391,11,261
1781,456,6,1209,1760,5212,1386,726,23,1178,2037,5350,11,262
1725,622,7,1338,2002,5694,1420,975,14,1131,2069,5609,11,263
1366,777,13,1326,1984,5466,1204,880,106,1330,1730,5250,11,264
293,626,30,1379,1093,3421,165,890,128,1098,913,3194,11,265
206,238,7,1092,660,2203,140,531,10,818,752,2251,11,266
1601,391,5,1146,1806,4949,1428,595,14,1073,1896,5006,11,267
1854,439,13,1210,2046,5562,1443,860,19,1162,2082,5566,11,268
1804,461,7,1258,1924,5454,1401,770,16,1142,2044,5373,11,269
1692,577,21,1332,1879,5501,1349,839,28,1201,2020,5437,11,270
1345,577,22,1273,1888,5105,1124,863,118,1307,1516,4928,11,271
292,604,19,1477,1055,3447,274,849,114,1000,999,3236,11,272
239,207,4,1097,638,2185,136,478,10,793,812,2229,11,273
1546,384,8,1136,1744,4818,1350,574,18,1082,1846,4870,11,274
1857,437,9,1134,1814,5251,1430,729,24,1121,2044,5348,11,275
1815,456,3,1226,1842,5342,1441,692,16,1127,2096,5372,11,276
1690,620,3,1350,1933,5596,1588,896,26,1146,2034,5690,11,277
1354,768,28,1412,2069,5631,1267,941,86,1377,1707,5378,11,278
300,556,25,1705,1160,3746,230,888,140,1213,1034,3505,11,279
237,215,12,1283,675,2422,168,504,9,976,861,2518,11,280
1530,440,1,1248,1695,4914,1411,595,8,1113,1827,4954,11,281
1811,520,7,1226,1920,5484,1443,762,17,1225,2201,5648,11,282
1856,488,2,1291,1873,5510,1464,761,16,1285,1994,5520,11,283
1486,538,2,1303,1886,5215,1307,871,15,1092,1866,5151,11,284
1157,607,32,1505,1802,5103,1110,849,118,1366,1360,4803,11,285
326,473,17,1531,911,3258,204,718,71,886,1052,2931,11,286
247,302,8,1136,782,2475,139,618,25,869,770,2421,11,287
601,273,6,1077,900,2857,470,652,14,922,1150,3208,11,288
1874,399,7,1286,1819,5385,1468,786,11,1260,1974,5499,11,289
1822,414,6,1320,1882,5444,1440,703,7,1199,1934,5283,11,290
1733,559,3,1279,2078,5652,1401,931,9,1052,2289,5682,11,291
1302,611,29,1469,2159,5570,1226,902,87,1371,1695,5281,11,292
328,535,23,1535,1036,3457,210,911,118,1060,970,3269,11,293
194,240,7,1177,803,2421,161,694,13,853,872,2593,11,294
1575,442,11,1242,1794,5064,1400,627,16,1142,1886,5071,11,295
1796,485,9,1342,1823,5455,1437,770,8,1173,2095,5483,11,296
1802,484,7,1368,2103,5764,1567,828,12,1244,2045,5696,11,297
1835,521,7,1348,1967,5678,1372,923,16,1220,2057,5588,11,298
1229,491,24,1445,1847,5036,1101,836,63,1136,1675,4811,11,299
306,421,15,1623,977,3342,194,850,72,1019,919,3054,11,300
304,259,7,1158,688,2416,147,524,10,859,863,2403,11,301
1503,417,7,1229,1866,5022,1358,647,8,1102,1964,5079,11,302
1780,493,20,1351,2275,5919,1467,1112,26,1309,2220,6134,11,303
1878,451,4,1419,2018,5770,1423,834,11,1369,2139,5776,11,304
1626,771,7,1358,1966,5728,1380,886,24,1229,2030,5549,11,305
1248,542,27,1395,1928,5140,1154,787,62,1354,1647,5004,11,306
306,444,27,1410,976,3163,191,728,95,946,1034,2994,11,307
229,201,5,1141,706,2282,129,471,5,934,832,2371,11,308
1345,382,4,1116,1768,4615,1331,607,6,1057,1651,4652,11,309
1206,437,8,1219,1612,4482,1128,601,28,1109,1583,4449,11,310
1568,387,20,1231,1996,5202,1478,606,24,1193,1814,5115,11,311
1641,468,3,1285,1897,5294,1416,757,6,1128,1937,5244,11,312
1272,547,23,1358,1922,5122,1206,814,104,1237,1608,4969,11,313
279,382,10,1509,823,3003,192,601,71,1031,1021,2916,11,314
221,181,8,1091,602,2103,113,380,9,807,826,2135,11,315
562,346,6,1116,1114,3144,692,492,7,1024,1035,3250,11,316
1850,414,10,1172,1914,5360,1449,682,15,1166,2100,5412,11,317
1864,411,20,1292,1980,5567,1518,756,28,1312,2052,5666,11,318
1731,433,6,1266,1865,5301,1408,712,16,1149,2028,5313,11,319
1365,544,31,1340,1870,5150,1200,750,75,1297,1688,5010,11,320
19,0,0,3,0,22,12,0,0,4,0,16,11,321
1575,389,5,1162,1849,4980,1445,600,15,1084,1942,5086,11,323
1949,438,34,1198,1931,5550,1422,762,38,1259,2123,5604,11,324
1851,429,6,1336,2031,5653,1445,791,16,1260,2015,5527,11,325
1706,495,5,1258,1956,5420,1330,823,15,1054,2072,5294,11,326
1334,387,18,1171,1689,4599,1155,643,51,1194,1427,4470,11,327
264,328,15,1281,718,2606,140,593,77,810,786,2406,11,328
173,168,5,973,611,1930,121,390,13,750,705,1979,11,329
1231,413,6,1244,1727,4621,1182,615,18,1115,1518,4448,11,330
1226,385,5,1451,1744,4811,1080,574,10,1016,1476,4156,11,331
749,240,4,1121,851,2965,569,395,5,773,850,2592,11,332
111,89,0,395,257,852,71,172,9,282,229,763,11,333
311,162,8,811,556,1848,307,386,37,591,603,1924,11,334
200,154,11,789,546,1700,128,369,37,629,604,1767,11,335
122,158,2,777,504,1563,114,523,13,751,802,2203,11,336
1409,302,4,1019,1699,4433,1292,593,7,1092,1647,4631,11,337
1755,373,9,1129,1864,5130,1324,697,11,1070,2066,5168,11,338
1779,347,14,1232,1722,5094,1346,693,23,1075,1886,5023,11,339
1612,398,8,1211,1782,5011,1255,775,19,1017,1911,4977,11,340
1251,573,32,1213,1738,4807,1120,703,74,1148,1582,4627,11,341
253,512,17,1375,1030,3187,146,897,75,968,905,2991,11,342
169,234,4,1146,831,2384,151,494,14,934,818,2411,11,343
1471,312,16,1034,1646,4479,1109,677,20,960,1809,4575,11,344
1815,346,15,1194,1641,5011,1279,762,23,1045,1972,5081,11,345
1762,371,10,1176,1537,4856,1278,701,18,958,1805,4760,11,346
1735,422,3,1345,1872,5377,1222,869,18,1031,2004,5144,11,347
1282,471,17,1315,1908,4993,1047,789,65,1143,1512,4556,11,348
311,273,9,1389,915,2897,140,594,52,881,776,2443,11,349
184,176,7,880,467,1714,108,328,17,595,571,1619,11,350
1429,267,8,1095,1373,4172,1125,551,12,787,1652,4127,11,351
1706,265,23,1171,1595,4760,1168,707,24,947,1818,4664,11,352
1601,276,25,1079,1542,4523,1157,652,36,863,1709,4417,11,353
1512,292,11,1214,1485,4514,1033,684,14,881,1694,4306,11,354
1077,255,22,999,1164,3517,752,541,43,823,1090,3249,11,355
203,229,8,784,591,1815,110,319,20,543,667,1659,11,356
128,118,5,622,415,1288,87,257,9,441,393,1187,11,357
547,155,15,821,805,2343,431,371,14,598,751,2165,11,358
285,164,8,667,461,1585,304,213,7,483,489,1496,11,359
53,78,7,291,217,646,60,121,9,217,171,578,11,360
311,154,7,645,578,1695,323,334,10,471,604,1742,11,361
352,228,12,835,671,2098,369,388,35,592,686,2070,11,362
134,151,13,574,372,1244,83,310,23,387,392,1195,11,363
106,149,16,699,359,1329,110,282,27,470,471,1360,11,364
526,202,3,844,839,2414,489,471,7,676,889,2532,11,365
486,306,75,896,652,2415,441,319,116,747,771,2394,11,366
84,78,0,240,108,510,22,160,13,124,186,505,12,1
573,83,5,333,251,1245,116,233,10,256,561,1176,12,2
779,97,2,354,261,1493,162,271,8,237,736,1414,12,3
749,97,2,349,254,1451,157,231,3,257,705,1353,12,4
673,95,6,350,247,1371,135,278,21,222,633,1289,12,5
136,97,7,231,102,573,52,177,33,126,149,537,12,6
89,76,2,246,148,561,36,221,10,129,193,589,12,7
761,95,2,330,258,1446,141,280,7,218,719,1365,12,8
829,62,0,307,180,1378,164,190,13,299,651,1317,12,9
858,111,2,391,259,1621,181,296,13,272,772,1534,12,10
826,96,5,373,294,1594,166,283,17,249,766,1481,12,11
715,97,7,351,258,1428,162,251,25,241,627,1306,12,12
128,100,6,274,146,654,49,210,27,131,234,651,12,13
94,68,4,218,111,495,28,145,10,125,183,491,12,14
175,71,9,225,107,587,51,182,17,121,221,592,12,15
316,84,6,235,161,802,66,173,9,155,322,725,12,16
657,89,3,384,246,1379,87,279,7,258,706,1337,12,17
828,88,7,324,264,1511,140,290,11,240,710,1391,12,18
367,80,10,231,152,840,85,170,16,173,321,765,12,19
138,84,9,277,125,633,59,146,17,152,206,580,12,20
99,70,2,203,122,496,34,170,4,96,162,466,12,21
751,78,1,330,259,1419,149,219,32,229,713,1342,12,22
867,75,6,330,269,1547,181,293,9,232,796,1511,12,23
845,104,1,346,286,1582,180,315,10,225,751,1481,12,24
849,104,1,356,297,1607,176,300,12,235,781,1504,12,25
621,131,7,394,277,1430,146,314,35,277,585,1357,12,26
162,116,12,310,191,791,58,218,26,153,262,717,12,27
105,75,3,248,142,573,38,184,5,139,205,571,12,28
796,97,3,338,293,1527,184,294,8,243,710,1439,12,29
923,113,5,352,278,1671,181,293,7,236,801,1518,12,30
877,105,6,363,259,1610,160,342,9,254,788,1553,12,31
880,104,5,349,267,1605,163,321,14,262,774,1534,12,32
727,115,10,370,304,1526,163,300,37,280,669,1449,12,33
148,102,5,310,165,730,48,209,26,153,242,678,12,34
111,83,1,269,129,593,45,201,12,171,201,630,12,35
826,84,3,316,277,1506,160,286,8,224,760,1438,12,36
898,79,3,333,282,1595,169,303,14,260,847,1593,12,37
917,115,3,376,261,1672,159,316,11,235,862,1583,12,38
839,43,8,347,247,1484,158,198,12,242,700,1310,12,39
745,120,7,353,297,1522,161,305,37,229,652,1384,12,40
142,84,13,291,174,704,59,257,39,134,207,696,12,41
97,83,2,229,120,531,35,157,19,136,196,543,12,42
754,86,6,320,274,1440,158,262,23,224,728,1395,12,43
812,83,10,343,288,1536,164,286,23,229,726,1428,12,44
874,113,5,409,310,1711,189,325,22,240,763,1539,12,45
850,84,4,347,278,1563,136,302,13,198,709,1358,12,46
633,112,9,354,283,1391,135,304,17,237,610,1303,12,47
138,107,9,276,154,684,68,237,32,133,221,691,12,48
106,60,4,214,127,511,39,179,10,116,191,535,12,49
256,80,8,265,166,775,68,228,8,189,281,774,12,50
816,100,6,350,263,1535,155,291,14,255,753,1468,12,51
877,96,5,366,246,1590,145,295,12,232,740,1424,12,52
824,79,3,339,256,1501,121,325,15,208,649,1318,12,53
707,91,13,382,266,1459,154,277,17,206,624,1278,12,54
152,84,17,320,216,789,52,209,25,137,276,699,12,55
98,74,8,234,131,545,43,173,7,111,190,524,12,56
789,86,16,335,258,1484,162,300,20,222,714,1418,12,57
833,85,20,362,279,1579,170,288,21,243,789,1511,12,58
850,85,7,393,227,1562,161,252,15,318,818,1564,12,59
885,92,13,395,270,1655,165,297,23,239,760,1484,12,60
773,89,16,400,276,1554,154,282,32,254,671,1393,12,61
38,17,15,21,11,102,19,20,13,23,12,87,12,62
43,70,14,33,13,173,36,48,32,43,21,180,12,63
800,89,6,343,280,1518,140,251,9,244,701,1345,12,64
854,84,5,353,276,1572,148,283,16,239,758,1444,12,65
896,85,6,363,239,1589,147,301,15,241,716,1420,12,66
916,94,9,350,266,1635,164,301,21,223,787,1496,12,67
758,117,16,393,300,1584,151,308,38,241,689,1427,12,68
134,87,7,289,142,659,35,206,23,133,209,606,12,69
107,75,9,229,121,541,37,186,13,97,193,526,12,70
788,85,11,327,284,1495,139,288,28,213,712,1380,12,71
898,90,6,379,300,1673,160,338,23,221,864,1606,12,72
923,126,26,378,280,1733,161,319,34,241,804,1559,12,73
803,129,7,429,304,1672,136,363,24,261,797,1581,12,74
644,127,7,373,267,1418,107,339,33,213,626,1318,12,75
153,119,11,376,220,879,46,299,43,181,278,847,12,76
104,90,2,282,185,663,31,242,11,118,233,635,12,77
810,116,8,373,271,1578,147,301,14,259,721,1442,12,78
938,104,10,405,289,1746,155,324,11,268,864,1622,12,79
989,131,41,402,317,1880,151,387,47,254,855,1694,12,80
921,101,3,381,298,1704,136,311,24,222,798,1491,12,81
748,111,17,395,296,1567,137,297,36,234,686,1390,12,82
133,119,4,298,195,749,39,220,31,120,241,651,12,83
124,92,0,305,126,647,33,210,15,133,225,616,12,84
780,97,9,391,279,1556,131,294,10,229,769,1433,12,85
929,106,2,385,318,1740,145,335,15,231,839,1565,12,86
875,90,2,371,262,1600,143,297,9,260,764,1473,12,87
853,96,4,374,290,1617,145,291,13,244,774,1467,12,88
710,117,9,463,312,1611,127,300,37,236,711,1411,12,89
153,88,10,467,176,894,51,231,32,192,324,830,12,90
114,70,4,282,125,595,29,185,10,148,200,572,12,91
709,84,8,344,266,1411,117,306,11,190,716,1340,12,92
882,100,16,377,296,1671,152,315,18,243,812,1540,12,93
1003,170,14,400,310,1897,167,383,18,229,850,1647,12,94
954,141,24,446,363,1928,159,400,27,261,891,1738,12,95
740,162,16,545,366,1829,134,393,44,282,715,1568,12,96
186,156,7,453,207,1009,59,299,27,220,321,926,12,97
174,95,17,359,192,837,36,262,31,175,266,770,12,98
869,142,28,375,363,1777,140,345,33,289,806,1613,12,99
992,151,7,443,366,1959,186,426,31,279,985,1907,12,100
1028,131,16,463,444,2082,192,408,14,270,1008,1892,12,101
982,118,7,457,335,1899,179,338,17,280,893,1707,12,102
761,117,15,432,271,1596,132,349,33,247,641,1402,12,103
152,107,13,391,211,874,55,291,22,152,291,811,12,104
124,99,8,361,171,763,36,265,17,131,256,705,12,105
659,81,6,352,236,1334,86,311,10,226,661,1294,12,106
729,126,13,373,240,1481,79,341,22,205,679,1326,12,107
791,125,11,396,244,1567,106,358,13,240,698,1415,12,108
757,120,10,405,268,1560,91,361,29,242,695,1418,12,109
647,115,20,403,263,1448,96,338,35,228,627,1324,12,110
113,117,8,324,214,776,70,151,16,124,187,548,12,111
69,72,8,182,95,426,29,84,11,88,87,299,12,112
826,107,2,342,313,1590,142,288,8,232,786,1456,12,113
951,111,10,370,331,1773,158,302,25,242,876,1603,12,114
960,106,4,398,311,1779,178,360,11,261,957,1767,12,115
984,97,2,394,324,1801,155,355,18,254,881,1663,12,116
805,137,10,368,344,1664,146,359,28,225,700,1458,12,117
10,10,2,7,8,37,10,10,3,6,8,37,12,118
110,100,12,290,185,697,44,232,25,134,222,657,12,119
837,93,1,360,254,1545,144,319,4,222,795,1484,12,120
984,108,9,426,243,1770,174,318,16,290,871,1669,12,121
975,109,2,442,262,1790,174,351,14,261,866,1666,12,122
893,99,3,402,313,1710,174,324,15,241,832,1586,12,123
783,133,5,428,326,1675,160,333,28,242,756,1519,12,124
156,86,6,358,161,767,53,202,44,163,230,692,12,125
116,81,5,245,139,586,40,180,21,117,193,551,12,126
833,137,3,383,241,1597,2663,392,10,4257,794,8116,12,127
977,88,1,432,281,1779,165,341,26,266,844,1642,12,128
961,96,4,415,259,1735,162,345,25,269,849,1650,12,129
933,93,7,418,256,1707,159,341,21,261,800,1582,12,130
789,108,38,402,288,1625,138,306,52,245,693,1434,12,131
196,100,25,370,196,887,73,283,55,184,274,869,12,132
136,83,1,259,136,615,46,187,10,143,185,571,12,133
821,126,2,343,289,1581,144,360,12,260,763,1539,12,134
959,103,10,389,262,1723,163,330,18,255,864,1630,12,135
913,102,3,420,262,1700,164,333,37,273,860,1667,12,136
915,108,1,452,300,1776,174,369,20,294,839,1696,12,137
801,141,15,460,302,1719,159,330,40,319,677,1525,12,138
161,109,6,312,148,736,48,232,29,139,227,675,12,139
119,115,2,301,134,671,35,224,24,138,184,605,12,140
815,95,13,360,267,1550,130,321,22,233,817,1523,12,141
927,80,13,363,247,1630,161,329,31,230,854,1605,12,142
917,64,3,355,242,1581,159,292,18,246,810,1525,12,143
856,62,1,280,238,1437,135,263,11,206,749,1364,12,144
667,92,6,315,291,1371,122,308,48,243,597,1318,12,145
163,77,1,309,151,701,42,231,37,171,218,699,12,146
99,73,3,265,116,556,29,212,20,101,194,556,12,147
138,53,2,204,117,514,36,153,6,129,194,518,12,148
852,55,2,364,223,1496,147,282,12,222,802,1465,12,149
858,72,10,326,226,1492,146,244,19,245,816,1470,12,150
852,80,4,359,204,1499,157,310,13,216,783,1479,12,151
717,97,13,369,231,1427,133,288,30,231,678,1360,12,152
166,83,11,291,165,716,34,258,35,136,208,671,12,153
120,47,0,220,97,484,34,188,5,123,163,513,12,154
836,63,2,364,253,1518,149,280,11,234,785,1459,12,155
863,72,6,373,260,1574,140,368,20,207,793,1528,12,156
953,71,5,379,217,1625,136,317,22,241,858,1574,12,157
914,82,5,407,275,1683,152,352,21,261,818,1604,12,158
762,124,21,410,243,1560,158,348,53,279,682,1520,12,159
163,125,11,425,259,983,56,360,61,160,309,946,12,160
107,79,7,246,132,571,42,246,24,108,194,614,12,161
755,71,3,324,233,1386,132,295,13,246,776,1462,12,162
840,97,4,376,236,1553,137,344,29,235,816,1561,12,163
864,93,8,409,222,1596,127,326,35,252,820,1560,12,164
823,91,7,397,204,1522,111,375,26,272,738,1522,12,165
663,107,4,425,213,1412,117,316,68,260,638,1399,12,166
172,110,4,314,132,732,36,250,43,177,219,725,12,167
110,69,3,230,110,522,31,205,15,126,166,543,12,168
700,83,7,330,194,1314,103,297,29,218,657,1304,12,169
784,84,8,324,215,1415,90,320,24,235,715,1384,12,170
306,84,2,337,176,905,78,251,20,174,339,862,12,171
732,91,3,361,193,1380,87,342,24,239,666,1358,12,172
600,98,4,321,211,1234,89,300,43,212,529,1173,12,173
142,93,0,307,120,662,42,243,44,111,209,649,12,174
119,54,6,241,103,523,35,232,26,128,171,592,12,175
689,87,2,342,196,1316,111,271,19,221,586,1208,12,176
811,90,2,416,220,1539,115,314,25,266,749,1469,12,177
763,87,2,385,193,1430,93,300,26,226,749,1394,12,178
798,82,10,369,215,1474,127,329,32,244,737,1469,12,179
634,80,2,372,209,1297,121,267,43,216,571,1218,12,180
148,73,4,293,144,662,37,216,42,105,239,639,12,181
110,59,4,225,108,506,51,182,16,102,178,529,12,182
710,79,5,348,194,1336,105,260,14,240,680,1299,12,183
782,110,3,356,233,1484,126,354,30,240,726,1476,12,184
773,106,7,384,243,1513,115,316,30,357,636,1454,12,185
151,308,15,267,235,976,55,431,34,160,295,975,12,186
429,103,5,346,192,1075,67,257,38,219,431,1012,12,187
125,85,2,297,126,635,36,231,40,128,216,651,12,188
103,58,5,217,98,481,28,189,14,95,171,497,12,189
675,103,4,344,211,1337,120,279,28,231,627,1285,12,190
762,95,6,372,215,1450,106,300,31,244,710,1391,12,191
755,94,5,352,198,1404,118,311,31,242,683,1385,12,192
760,103,10,390,219,1482,117,349,47,234,689,1436,12,193
639,95,4,343,180,1261,112,261,61,206,545,1185,12,194
161,95,6,283,135,680,49,236,36,138,209,668,12,195
107,55,5,227,121,515,26,193,12,104,178,513,12,196
715,85,3,305,153,1261,123,254,28,233,649,1287,12,197
749,70,7,325,183,1334,102,288,31,210,655,1286,12,198
778,82,4,343,182,1389,112,259,29,222,687,1309,12,199
717,90,14,346,174,1341,95,304,33,219,673,1324,12,200
621,81,13,352,203,1270,127,295,51,225,480,1178,12,201
99,73,6,273,127,578,13,217,45,140,214,629,12,202
107,68,3,228,101,507,34,186,15,111,183,529,12,203
676,78,10,214,196,1174,101,253,38,120,625,1137,12,204
786,97,11,307,222,1423,104,323,34,199,697,1357,12,205
767,86,2,360,216,1431,113,294,34,238,723,1402,12,206
724,80,3,351,210,1368,102,314,16,210,653,1295,12,207
571,133,11,360,219,1294,107,344,49,222,524,1246,12,208
151,73,5,276,185,690,46,237,59,153,219,714,12,209
92,72,3,205,107,479,32,174,22,99,158,485,12,210
663,67,4,330,182,1246,104,270,22,209,637,1242,12,211
786,75,6,332,171,1370,110,282,17,223,697,1329,12,212
745,94,5,330,214,1388,100,291,20,200,714,1325,12,213
721,83,1,349,239,1393,101,285,22,220,648,1276,12,214
582,110,11,342,172,1217,98,364,44,195,498,1199,12,215
140,62,5,305,115,627,48,186,34,131,242,641,12,216
102,62,4,219,118,505,36,185,17,118,184,540,12,217
623,86,2,289,178,1178,90,269,18,190,605,1172,12,218
710,69,1,338,196,1314,95,313,15,218,647,1288,12,219
773,64,51,340,196,1424,92,294,58,236,684,1364,12,220
694,62,4,302,179,1241,95,271,9,215,628,1218,12,221
554,77,10,284,190,1115,86,241,53,199,466,1045,12,222
141,103,6,286,140,676,34,208,33,145,197,617,12,223
95,70,2,205,99,471,29,207,13,126,172,547,12,224
641,82,2,297,217,1239,96,297,11,181,610,1195,12,225
740,98,5,277,197,1317,116,313,16,199,673,1317,12,226
759,78,14,328,228,1407,103,306,27,210,734,1380,12,227
715,82,8,357,218,1380,106,311,15,210,666,1308,12,228
578,97,9,344,250,1278,112,289,48,215,551,1215,12,229
155,98,5,286,146,690,33,208,47,148,227,663,12,230
84,89,3,208,110,494,34,218,9,112,157,530,12,231
646,83,6,266,201,1202,115,261,13,174,609,1172,12,232
740,74,3,323,226,1366,123,311,15,200,697,1346,12,233
746,89,2,330,253,1420,110,322,37,207,741,1417,12,234
736,83,7,336,219,1381,134,304,22,186,705,1351,12,235
613,116,5,332,204,1270,110,324,36,199,582,1251,12,236
147,75,8,298,142,670,39,223,40,155,214,671,12,237
109,63,2,226,121,521,28,215,14,132,181,570,12,238
729,75,1,289,233,1327,160,271,14,199,714,1358,12,239
894,80,4,302,244,1524,141,317,15,204,809,1486,12,240
897,72,4,309,221,1503,169,303,22,207,767,1468,12,241
838,54,1,347,243,1483,180,296,14,219,774,1483,12,242
669,85,7,320,232,1313,140,268,35,268,582,1293,12,243
147,76,5,282,130,640,32,201,36,126,228,623,12,244
129,58,1,201,117,506,29,198,15,116,154,512,12,245
121,81,6,204,114,526,36,192,16,108,186,538,12,246
847,84,6,288,236,1461,182,296,13,203,813,1507,12,247
874,90,6,309,239,1518,151,297,17,204,826,1495,12,248
892,71,3,313,251,1530,167,303,19,226,815,1530,12,249
749,92,17,313,225,1396,121,288,41,244,688,1382,12,250
164,62,3,275,135,639,49,204,48,150,228,679,12,251
121,67,2,229,115,534,30,176,14,117,190,527,12,252
840,70,1,279,256,1446,157,276,15,209,778,1435,12,253
942,74,3,319,260,1598,182,304,14,233,868,1601,12,254
943,92,2,343,256,1636,156,345,27,223,868,1619,12,255
903,78,7,327,256,1571,160,346,21,225,788,1540,12,256
765,113,9,344,293,1524,151,363,39,194,747,1494,12,257
154,98,10,311,164,737,42,234,29,161,281,747,12,258
121,68,4,306,125,624,43,200,18,121,238,620,12,259
833,72,1,303,253,1462,155,296,15,223,758,1447,12,260
933,70,6,333,245,1587,178,322,22,199,863,1584,12,261
894,73,6,334,240,1547,182,350,24,254,808,1618,12,262
906,83,14,345,311,1659,192,393,31,254,828,1698,12,263
753,121,11,374,273,1532,147,335,49,249,698,1478,12,264
4,2,1,0,2,9,8,2,2,0,2,14,12,265
9,10,17,4,7,47,7,10,7,2,8,34,12,266
844,77,1,310,223,1455,150,297,16,201,775,1439,12,267
933,84,5,349,258,1629,197,351,20,206,924,1698,12,268
885,77,0,335,268,1565,193,288,15,223,851,1570,12,269
894,72,7,358,309,1640,195,337,28,243,841,1644,12,270
721,99,3,327,233,1383,150,290,35,224,644,1343,12,271
176,101,9,302,184,772,50,266,59,131,251,757,12,272
121,54,5,229,135,544,27,215,18,99,179,538,12,273
814,82,7,305,233,1441,167,270,19,205,751,1412,12,274
982,74,32,331,225,1644,214,283,31,231,829,1588,12,275
968,90,24,341,263,1686,196,341,33,248,832,1650,12,276
902,71,7,325,265,1570,205,322,20,205,849,1601,12,277
749,110,21,346,301,1527,146,333,44,240,736,1499,12,278
146,90,11,296,139,682,43,231,48,136,225,683,12,279
130,83,12,284,126,635,45,182,18,127,226,598,12,280
867,77,6,316,247,1513,179,304,21,248,776,1528,12,281
973,95,5,340,257,1670,199,319,19,226,893,1656,12,282
960,105,2,361,254,1682,164,348,17,245,883,1657,12,283
807,83,5,365,254,1514,150,297,21,217,786,1471,12,284
616,110,12,370,239,1347,145,316,38,247,534,1280,12,285
168,90,14,315,152,739,53,266,46,137,232,734,12,286
130,66,8,298,130,632,54,216,21,124,211,626,12,287
384,86,2,322,199,993,68,260,16,202,382,928,12,288
917,80,8,348,288,1641,179,301,22,250,850,1602,12,289
962,71,11,343,238,1625,187,332,28,215,866,1628,12,290
896,63,8,375,287,1629,175,353,20,207,828,1583,12,291
751,95,9,385,241,1481,144,342,48,237,659,1430,12,292
175,99,5,327,185,791,49,245,52,192,305,843,12,293
126,67,8,287,148,636,39,270,20,132,205,666,12,294
853,77,4,311,262,1507,174,323,19,168,787,1471,12,295
956,90,2,356,280,1684,170,300,19,248,925,1662,12,296
942,93,11,361,286,1693,166,366,22,223,887,1664,12,297
927,89,6,373,305,1700,169,365,15,243,888,1680,12,298
740,100,6,346,264,1456,129,325,38,222,700,1414,12,299
157,73,6,305,173,714,39,214,48,155,258,714,12,300
123,57,3,263,122,568,41,226,13,109,210,599,12,301
832,88,22,266,254,1462,161,310,31,214,736,1452,12,302
914,95,3,339,357,1708,170,390,22,266,890,1738,12,303
935,45,5,340,301,1626,175,173,18,247,807,1420,12,304
861,131,10,333,281,1616,153,356,24,222,810,1565,12,305
725,94,12,338,268,1437,119,274,32,224,660,1309,12,306
148,86,8,345,162,749,48,259,30,184,241,762,12,307
119,56,3,201,154,533,36,181,11,123,201,552,12,308
723,75,6,346,237,1387,122,280,14,234,688,1338,12,309
719,64,4,367,226,1380,100,248,17,289,660,1314,12,310
892,84,4,327,267,1574,168,283,18,236,844,1549,12,311
852,65,2,301,278,1498,141,295,18,229,866,1549,12,312
778,92,4,375,247,1496,142,308,34,247,703,1434,12,313
159,59,4,297,148,667,34,190,48,141,257,670,12,314
107,50,2,275,97,531,28,150,15,140,252,585,12,315
359,74,4,253,156,846,58,242,11,148,401,860,12,316
948,87,30,334,262,1661,171,325,47,220,883,1646,12,317
1003,82,1,277,254,1617,177,327,18,231,840,1593,12,318
887,60,2,307,264,1520,134,298,23,207,821,1483,12,319
800,84,3,320,269,1476,151,276,29,213,708,1377,12,320
138,65,7,318,133,661,43,196,49,152,244,684,12,321
105,55,8,204,107,479,37,153,13,97,184,484,12,322
860,75,16,308,222,1481,177,303,29,196,743,1448,12,323
920,74,22,325,251,1592,157,292,30,242,867,1588,12,324
931,72,1,352,253,1609,167,308,20,224,832,1551,12,325
912,63,12,329,294,1610,168,300,30,234,793,1525,12,326
770,71,9,320,202,1372,140,260,33,227,679,1339,12,327
155,64,4,323,142,688,41,207,32,162,205,647,12,328
129,57,4,260,98,548,43,158,15,118,237,571,12,329
819,80,7,293,203,1402,121,286,32,204,706,1349,12,330
813,78,9,307,258,1465,142,268,14,235,719,1378,12,331
582,74,4,319,200,1179,90,240,19,292,470,1111,12,332
55,52,2,143,71,323,24,71,9,114,137,355,12,333
289,73,7,338,152,859,50,180,24,195,323,772,12,334
134,56,3,268,123,584,35,161,27,152,228,603,12,335
99,53,2,240,132,526,28,148,9,127,206,518,12,336
828,59,4,293,249,1433,154,293,18,215,745,1425,12,337
935,66,4,311,251,1567,155,321,16,231,799,1522,12,338
974,58,8,339,259,1638,148,301,23,233,806,1511,12,339
867,62,2,316,262,1509,149,324,14,189,795,1471,12,340
746,67,10,314,210,1347,132,274,36,199,653,1294,12,341
15,11,1,25,8,60,15,4,1,27,13,60,12,342
19,20,6,12,5,62,8,7,16,14,12,57,12,343
815,57,2,274,257,1405,159,308,20,201,712,1400,12,344
976,64,3,318,298,1659,159,329,15,236,759,1498,12,345
917,63,57,276,238,1551,174,272,65,217,813,1541,12,346
891,86,3,341,257,1578,159,391,17,205,811,1583,12,347
779,93,5,324,242,1443,124,317,53,221,687,1402,12,348
144,79,6,324,147,700,41,238,46,168,273,766,12,349
108,45,1,219,109,482,27,156,8,107,176,474,12,350
823,82,2,319,207,1433,149,285,13,215,741,1403,12,351
875,76,9,374,277,1611,156,317,18,248,833,1572,12,352
889,77,12,309,218,1505,166,318,23,223,789,1519,12,353
863,69,5,339,281,1557,129,333,25,222,751,1460,12,354
580,73,8,337,195,1193,104,254,34,242,468,1102,12,355
112,65,6,287,135,605,34,202,19,119,196,570,12,356
86,40,2,250,113,491,26,149,15,92,202,484,12,357
438,54,3,267,155,917,59,236,30,143,396,864,12,358
251,65,2,246,114,678,49,133,10,169,236,597,12,359
16,35,4,104,67,226,26,65,7,70,77,245,12,360
300,50,3,230,158,741,42,191,18,132,270,653,12,361
298,49,9,260,132,748,55,147,29,104,274,609,12,362
80,44,5,204,93,426,20,125,22,79,143,389,12,363
88,50,2,148,123,411,26,130,60,68,127,411,12,364
383,59,1,251,169,863,73,222,7,147,396,845,12,365
441,78,20,295,152,986,66,179,45,248,371,909,12,366
14,44,4,220,162,444,32,71,5,234,192,534,13,1
435,157,14,585,1766,2957,1424,140,11,911,659,3145,13,2
604,229,2,642,2082,3559,1770,195,7,960,822,3754,13,3
640,369,0,692,2161,3862,1756,201,2,1011,1061,4031,13,4
377,241,1,801,1790,3210,1557,220,9,1104,579,3469,13,5
48,75,7,442,376,948,111,113,18,597,201,1040,13,6
50,57,2,427,257,793,41,166,4,379,298,888,13,7
610,282,2,540,2232,3666,2031,243,2,762,770,3808,13,8
772,372,5,767,2476,4392,2396,165,7,976,702,4246,13,9
804,431,11,883,2885,5014,2538,308,15,1229,973,5063,13,10
851,529,1,879,2562,4822,2248,278,5,1215,1150,4896,13,11
378,283,17,723,1979,3380,1649,179,17,928,596,3369,13,12
56,117,8,669,609,1459,154,157,10,925,468,1714,13,13
38,69,2,397,253,759,35,79,3,346,259,722,13,14
104,94,2,449,322,971,129,137,4,435,330,1035,13,15
266,248,3,472,1066,2055,749,154,11,765,378,2057,13,16
668,504,4,811,2840,4827,2613,284,9,1242,1000,5148,13,17
806,782,0,967,3260,5815,2664,301,5,1413,1260,5643,13,18
279,281,11,1404,3085,5060,856,212,14,1207,543,2832,13,19
124,182,5,689,626,1626,188,242,15,843,413,1701,13,20
50,87,3,395,247,782,51,143,3,356,251,804,13,21
584,294,6,683,2705,4272,2122,201,10,1224,828,4385,13,22
879,322,7,789,2936,4933,2521,257,9,1338,1019,5144,13,23
826,375,1,838,2931,4971,2563,310,5,1298,969,5145,13,24
732,513,3,860,2785,4893,2240,331,7,1150,1042,4770,13,25
436,392,10,1010,2046,3894,1845,283,28,1270,725,4151,13,26
69,162,16,639,674,1560,121,202,17,1006,454,1800,13,27
47,86,1,371,224,729,36,97,3,374,314,824,13,28
591,488,4,591,2606,4280,2383,211,3,963,825,4385,13,29
891,484,3,810,3028,5216,2906,281,4,1072,1056,5319,13,30
878,671,3,860,3015,5427,2977,362,9,1411,1148,5907,13,31
769,711,6,852,2916,5254,2736,327,7,1146,1235,5451,13,32
481,316,6,906,2209,3918,1915,238,22,1096,667,3938,13,33
67,140,2,760,669,1638,145,209,27,974,463,1818,13,34
43,68,7,470,316,904,52,112,8,397,364,933,13,35
633,512,4,813,2744,4706,2480,217,2,1120,836,4655,13,36
922,753,0,911,3133,5719,3090,305,1,1245,1106,5747,13,37
914,571,4,1067,3312,5868,3128,297,6,1371,1089,5891,13,38
933,772,0,1141,2903,5749,2630,309,0,1299,1358,5596,13,39
460,357,3,859,2182,3861,1888,259,25,1295,667,4134,13,40
71,179,11,694,599,1554,151,241,12,752,402,1558,13,41
32,100,11,324,222,689,52,107,11,320,266,756,13,42
625,482,5,749,2796,4657,2177,262,10,1285,796,4530,13,43
765,550,32,784,2883,5014,2620,309,35,1220,1028,5212,13,44
833,448,5,1527,3335,6148,2562,267,6,2062,1072,5969,13,45
734,550,0,542,2641,4467,2762,321,2,1063,1025,5173,13,46
350,449,8,1087,2308,4202,1897,286,8,1472,667,4330,13,47
50,132,7,735,858,1782,105,191,16,1305,420,2037,13,48
40,79,1,484,318,922,58,153,2,385,353,951,13,49
154,119,2,564,409,1248,193,184,3,748,387,1515,13,50
780,283,3,915,2663,4644,2277,265,4,1289,975,4810,13,51
842,347,1,885,2808,4883,2423,316,3,1452,1014,5208,13,52
805,459,0,892,2602,4758,2229,294,3,1238,1167,4931,13,53
415,350,3,890,2215,3873,1831,248,13,1286,617,3995,13,54
73,153,26,679,554,1485,147,184,34,863,431,1659,13,55
38,110,1,485,275,909,60,129,1,482,367,1039,13,56
600,330,5,689,2556,4180,2226,245,4,985,859,4319,13,57
870,482,2,967,3218,5539,2763,282,1,1455,1118,5619,13,58
816,674,9,1118,3169,5786,3074,281,11,1391,1161,5918,13,59
787,771,3,1043,3330,5934,2907,379,3,1489,1304,6082,13,60
480,445,5,1072,2527,4529,1983,337,20,1378,765,4483,13,61
49,174,8,737,870,1838,221,239,28,1151,464,2103,13,62
44,140,3,603,415,1205,58,130,5,533,386,1112,13,63
684,364,2,862,3049,4961,2465,224,6,1352,853,4900,13,64
903,737,2,1404,3593,6639,3350,333,3,2018,1188,6892,13,65
834,1017,4,1469,3838,7162,3817,346,3,1737,1376,7279,13,66
848,1050,12,1283,3308,6501,3003,414,21,1579,1222,6239,13,67
467,490,5,1296,3003,5261,2442,344,13,1622,802,5223,13,68
119,210,16,988,1054,2387,295,231,14,1363,447,2350,13,69
105,143,8,573,495,1324,50,177,14,533,507,1281,13,70
665,789,3,987,3082,5526,2584,253,6,1857,1032,5732,13,71
918,828,11,1732,3941,7430,3297,419,11,2435,1368,7530,13,72
923,672,5,2087,3998,7685,3569,395,6,2597,1410,7977,13,73
857,757,14,1567,3382,6577,2769,435,23,2256,1476,6959,13,74
467,381,5,1563,2915,5331,2050,334,32,2112,810,5338,13,75
262,407,8,1474,1317,3468,528,393,19,2042,751,3733,13,76
73,226,1,661,498,1459,51,277,4,627,521,1480,13,77
697,433,1,1257,3252,5640,2587,275,1,1740,1008,5611,13,78
963,949,7,1343,3809,7071,3225,404,7,2284,1361,7281,13,79
866,907,6,1711,4479,7969,4150,465,5,2200,1484,8304,13,80
858,1037,0,1348,3760,7003,3075,450,4,2050,1621,7200,13,81
456,473,22,1640,3344,5935,2533,392,34,2242,989,6190,13,82
68,222,11,959,1289,2549,314,271,20,1608,703,2916,13,83
77,212,0,791,692,1772,89,245,3,915,713,1965,13,84
665,490,1,1546,3087,5789,2575,362,6,2275,1188,6406,13,85
863,375,5,1951,3919,7113,2952,407,8,2854,1396,7617,13,86
761,399,0,2035,3715,6910,2953,359,2,3235,1208,7757,13,87
696,585,4,1553,3564,6402,2367,370,5,2947,1484,7173,13,88
388,399,9,1645,2471,4912,1643,344,30,2708,1005,5730,13,89
112,319,6,1405,1385,3227,416,331,13,2117,817,3694,13,90
68,124,1,641,434,1268,121,191,0,716,497,1525,13,91
499,519,2,1308,2369,4697,2017,251,2,1708,934,4912,13,92
825,503,5,1753,3445,6531,2682,394,13,2694,1294,7077,13,93
763,347,5,1680,3586,6381,2743,342,6,2581,1220,6892,13,94
755,733,3,1509,3745,6745,2474,446,5,2703,1596,7224,13,95
445,557,10,1742,3000,5754,2075,441,38,2731,1037,6322,13,96
183,389,8,1225,1193,2998,414,309,13,2259,785,3780,13,97
324,140,5,669,497,1635,80,211,8,838,452,1589,13,98
582,432,3,890,2620,4527,2343,252,25,1501,860,4981,13,99
803,874,11,1224,3526,6438,3072,338,9,2291,1340,7050,13,100
801,714,5,1477,3523,6520,3346,367,7,2111,1455,7286,13,101
814,897,0,1263,3527,6501,2907,439,3,2160,1428,6937,13,102
496,385,2,1405,2943,5231,2566,283,23,1990,776,5638,13,103
125,301,19,1053,1182,2680,305,249,18,1787,664,3023,13,104
78,211,1,627,444,1361,76,248,3,709,444,1480,13,105
577,565,8,1056,2937,5143,2597,307,6,1691,856,5457,13,106
814,780,1,1487,3702,6784,3253,409,2,2215,1300,7179,13,107
779,736,1,1454,3882,6852,3419,443,1,2169,1408,7440,13,108
728,877,5,1430,3242,6282,3006,420,6,1994,1376,6802,13,109
391,456,17,1400,2859,5123,2221,323,14,1974,803,5335,13,110
84,465,14,940,1166,2669,310,282,33,1675,740,3040,13,111
42,154,2,441,393,1032,65,144,2,466,392,1069,13,112
534,265,2,1088,2473,4362,2040,256,1,1439,816,4552,13,113
812,484,6,1206,2987,5495,2492,340,8,1857,1206,5903,13,114
796,384,0,1328,2927,5435,2583,347,3,2042,1113,6088,13,115
746,768,8,1188,2666,5376,2363,384,11,1698,1321,5777,13,116
424,486,19,1202,2390,4521,1813,339,20,1826,883,4881,13,117
68,262,12,1239,967,2548,301,396,35,1577,524,2833,13,118
58,152,1,561,461,1233,74,325,18,603,463,1483,13,119
586,557,1,805,2365,4314,2289,244,0,1068,886,4487,13,120
838,874,12,1193,3185,6102,3027,357,12,1856,1227,6479,13,121
820,763,8,1184,3279,6054,3005,354,11,1853,1223,6446,13,122
737,601,9,1132,2982,5461,2527,456,18,1645,1317,5963,13,123
421,502,18,1081,2330,4352,1856,350,24,1846,823,4899,13,124
72,204,8,852,785,1921,211,213,22,1345,484,2275,13,125
66,205,4,449,353,1077,84,166,8,461,385,1104,13,126
534,501,35,887,2619,4576,2294,245,36,1541,913,5029,13,127
804,805,9,1260,3389,6267,2756,331,8,2143,1347,6585,13,128
747,887,16,1306,3252,6208,3240,420,23,1760,1308,6751,13,129
766,752,10,1263,2822,5613,2502,412,10,1678,1285,5887,13,130
412,438,8,1229,2375,4462,1763,279,7,1771,870,4690,13,131
90,180,0,893,900,2063,265,206,8,1430,585,2494,13,132
67,142,2,508,330,1049,55,193,4,503,425,1180,13,133
562,368,11,1011,2532,4484,2151,340,9,1552,904,4956,13,134
830,785,1,1222,3351,6189,2853,322,2,1917,1148,6242,13,135
762,754,5,1215,3625,6361,3197,387,3,2143,1270,7000,13,136
768,962,3,1509,3330,6572,2964,425,9,1934,1581,6913,13,137
404,467,7,1470,2660,5008,2289,345,12,1935,835,5416,13,138
93,327,11,987,1003,2421,307,262,20,1586,584,2759,13,139
85,186,8,668,475,1422,113,214,6,743,524,1600,13,140
674,419,5,1107,2861,5066,2437,294,4,1744,1017,5496,13,141
836,881,5,1443,3579,6744,3235,446,2,2033,1358,7074,13,142
709,1051,1,1321,3726,6808,3482,459,1,2046,1303,7291,13,143
737,718,1,1287,3349,6092,2986,328,6,1711,1325,6356,13,144
378,435,24,1500,2181,4518,1908,271,18,1781,753,4731,13,145
95,505,4,1056,1248,2908,327,324,15,1815,629,3110,13,146
62,544,1,658,519,1784,79,509,4,857,783,2232,13,147
75,179,4,845,663,1766,273,157,6,1137,460,2033,13,148
743,358,9,1299,3314,5723,2736,307,15,2048,994,6100,13,149
913,454,9,1542,3511,6429,3050,302,15,2199,1132,6698,13,150
709,664,2,1192,3414,5981,2756,403,11,1808,1335,6313,13,151
393,424,16,1114,2612,4559,2138,337,20,1839,738,5072,13,152
64,301,8,877,890,2140,290,303,25,1336,515,2469,13,153
53,197,0,473,393,1116,77,187,4,591,448,1307,13,154
592,741,6,1018,3470,5827,3202,317,8,1737,1084,6348,13,155
821,816,3,1398,4490,7528,3868,412,3,2302,1350,7935,13,156
801,605,0,1374,4549,7329,3912,334,3,2153,1149,7551,13,157
743,944,7,1558,3865,7117,3594,433,8,2121,1554,7710,13,158
493,701,20,1498,2982,5694,2431,362,29,2224,1037,6083,13,159
105,570,22,1330,1370,3397,262,629,34,1902,882,3709,13,160
89,246,1,574,619,1529,69,197,1,916,668,1851,13,161
596,469,2,1152,3644,5863,3135,326,5,1904,995,6365,13,162
885,1091,8,1218,4354,7556,3837,427,9,2016,1483,7772,13,163
817,972,13,1679,4526,8007,4300,524,18,2917,1678,9437,13,164
751,1070,6,1808,4615,8250,4313,465,9,2483,1550,8820,13,165
420,524,14,1862,3541,6361,3196,377,26,2343,870,6812,13,166
94,345,13,1029,1236,2717,304,338,14,1851,582,3089,13,167
67,168,3,502,449,1189,82,202,9,616,453,1362,13,168
594,391,2,1056,3328,5371,2947,292,4,1610,897,5750,13,169
793,673,7,1504,3957,6934,3410,329,22,2205,1209,7175,13,170
239,347,0,981,931,2498,394,297,4,1642,623,2960,13,171
646,917,8,1855,4007,7433,3487,519,16,2424,1400,7846,13,172
415,529,25,1557,3302,5828,2684,394,35,2238,822,6173,13,173
70,429,12,1147,1182,2840,350,438,30,1810,619,3247,13,174
50,175,0,534,380,1139,100,203,4,592,433,1332,13,175
555,374,2,1025,3583,5539,2906,304,9,1887,816,5922,13,176
770,876,3,1396,4213,7258,3699,377,5,2304,1296,7681,13,177
885,704,0,1528,4522,7639,3994,411,4,2482,1199,8090,13,178
710,1020,2,1994,4355,8081,4242,508,6,2324,1604,8684,13,179
435,501,28,1731,3623,6318,3077,353,29,2306,842,6607,13,180
92,320,12,1139,1336,2899,346,346,23,2090,568,3373,13,181
55,134,0,515,343,1047,73,194,2,603,354,1226,13,182
524,447,0,1181,3231,5383,2952,308,2,1903,914,6079,13,183
695,473,2,1460,3924,6554,3153,356,5,2440,1106,7060,13,184
496,954,3,2014,3185,6652,2755,514,12,2623,1182,7086,13,185
105,2180,14,1511,1602,5412,443,1957,17,2450,1807,6674,13,186
210,329,7,1649,2237,4432,1050,255,17,2924,776,5022,13,187
105,283,9,1248,1231,2876,438,313,8,2170,594,3523,13,188
77,146,15,510,377,1125,66,185,15,598,346,1210,13,189
524,806,2,1169,3747,6248,3275,326,7,1811,1008,6427,13,190
754,776,0,1732,4903,8165,4181,433,3,2597,1272,8486,13,191
683,767,1,1570,4496,7517,4031,423,6,2334,1109,7903,13,192
714,1095,15,2089,4376,8289,4293,541,13,2590,1621,9058,13,193
429,451,14,1403,3159,5456,2523,325,26,2174,788,5836,13,194
106,655,17,1194,1233,3205,387,357,19,2159,728,3650,13,195
58,146,0,440,342,986,59,187,3,579,350,1178,13,196
526,311,2,1119,3246,5204,2727,297,4,1773,798,5599,13,197
720,425,2,1424,3869,6440,3124,343,6,2243,1027,6743,13,198
741,409,2,1435,3903,6490,3146,317,8,2202,1040,6713,13,199
696,837,3,1488,3686,6710,3250,500,3,2281,1418,7452,13,200
396,704,60,1441,2954,5555,2465,344,23,2384,899,6115,13,201
99,650,13,1247,1308,3317,380,305,18,2021,664,3388,13,202
54,171,5,552,578,1360,95,228,10,727,475,1535,13,203
561,770,1,1206,3478,6016,3456,277,2,1824,1063,6622,13,204
779,1044,3,1677,4654,8157,4140,383,8,2665,1503,8699,13,205
775,823,3,1608,3160,6369,2553,428,7,2127,1630,6745,13,206
655,830,1,1812,4455,7753,3856,456,12,2898,1490,8712,13,207
374,481,14,1710,3545,6124,2678,400,50,2735,963,6826,13,208
80,318,24,1074,1302,2798,396,427,28,2197,753,3801,13,209
48,182,2,559,352,1143,109,238,5,548,471,1371,13,210
556,729,0,1209,3389,5883,2969,245,4,2047,903,6168,13,211
762,585,0,1513,4021,6881,3301,367,2,2503,1299,7472,13,212
692,607,0,1510,3858,6667,3156,369,1,2349,983,6858,13,213
632,804,9,1458,3552,6455,2952,393,11,2210,1378,6944,13,214
338,456,18,1313,2820,4945,2204,315,36,2060,740,5355,13,215
77,157,8,1132,1237,2611,229,162,17,1966,543,2917,13,216
66,153,0,475,442,1136,87,163,9,569,388,1216,13,217
469,328,0,937,2536,4270,2045,221,2,1525,779,4572,13,218
741,436,1,1230,3086,5494,2463,290,6,2069,1053,5881,13,219
652,367,4,1188,2947,5158,2403,316,12,1890,996,5617,13,220
584,512,10,985,2888,4979,1994,266,10,1677,1142,5089,13,221
270,306,17,1014,1789,3396,1338,214,14,1503,613,3682,13,222
58,292,13,954,983,2300,344,238,17,1687,506,2792,13,223
41,115,16,416,423,1011,65,181,17,600,309,1172,13,224
465,323,18,868,2145,3819,1796,286,19,1485,710,4296,13,225
637,293,2,1048,2618,4598,2134,315,4,1589,942,4984,13,226
638,297,5,1073,2513,4526,2090,342,5,1663,801,4901,13,227
604,608,5,958,2379,4554,1930,325,6,1548,1220,5029,13,228
356,317,2,1040,1934,3649,1425,270,10,1602,639,3946,13,229
77,195,6,873,921,2072,293,233,28,1575,497,2626,13,230
37,134,9,446,308,934,89,113,12,490,314,1018,13,231
489,247,8,752,1921,3417,1628,240,15,1156,756,3795,13,232
676,418,11,946,2398,4449,1968,323,12,1564,1050,4917,13,233
635,444,1,979,2355,4414,2022,330,5,1471,937,4765,13,234
566,524,8,874,2284,4256,1746,343,12,1407,1099,4607,13,235
317,381,3,883,1960,3544,1420,322,11,1514,800,4067,13,236
133,260,15,1025,970,2403,274,238,16,1632,648,2808,13,237
51,85,1,481,410,1028,95,197,30,559,373,1254,13,238
434,432,1,715,1994,3576,1751,290,1,1039,795,3876,13,239
760,545,1,1000,2482,4788,2163,333,7,1427,1033,4963,13,240
708,432,2,876,2630,4648,2091,311,3,1364,950,4719,13,241
641,462,11,956,2369,4439,1831,236,8,1386,1060,4521,13,242
336,387,17,1122,1746,3608,1465,216,15,1692,691,4079,13,243
87,318,5,1052,1068,2530,357,207,19,1949,555,3087,13,244
57,384,3,497,560,1501,89,844,7,754,687,2381,13,245
69,134,7,571,475,1256,212,141,7,798,371,1529,13,246
750,307,1,887,2559,4504,2213,286,5,1420,1002,4926,13,247
774,375,2,937,2665,4753,2261,370,3,1385,1036,5055,13,248
728,552,3,903,2640,4826,2171,349,5,1399,1293,5217,13,249
419,351,9,921,2183,3883,1782,282,24,1430,674,4192,13,250
83,749,18,813,853,2516,268,263,11,1307,602,2451,13,251
80,109,4,504,346,1043,90,158,6,514,413,1181,13,252
610,558,3,834,2897,4902,2712,286,6,1382,974,5360,13,253
872,831,7,1046,3596,6352,3198,441,11,1753,1361,6764,13,254
829,769,2,1296,3683,6579,3234,364,5,1831,1284,6718,13,255
786,980,7,1177,3579,6529,2958,420,7,1897,1530,6812,13,256
435,465,10,1107,2590,4607,2091,330,26,1808,865,5120,13,257
100,383,13,878,1159,2533,309,277,23,1523,642,2774,13,258
85,118,4,574,450,1231,81,171,5,636,466,1359,13,259
610,410,9,840,2786,4655,2463,345,9,1324,882,5023,13,260
882,730,7,1255,3752,6626,3167,350,5,1937,1158,6617,13,261
779,849,6,1208,3488,6330,3463,415,8,1759,1261,6906,13,262
773,770,13,1219,3626,6401,3100,456,9,1874,1404,6843,13,263
463,456,48,1361,2935,5263,2568,320,40,1830,846,5604,13,264
82,347,13,854,898,2194,268,197,20,1199,555,2239,13,265
65,165,1,437,323,991,57,181,2,423,314,977,13,266
583,618,3,1009,2920,5133,2667,272,4,1409,1040,5392,13,267
826,713,3,1164,4059,6765,3206,370,13,1741,1274,6604,13,268
821,812,5,1179,3819,6636,3325,406,12,1963,1197,6903,13,269
722,758,7,1141,3327,5955,2849,345,8,1708,1398,6308,13,270
432,378,11,1236,2607,4664,2218,262,19,1685,746,4930,13,271
82,740,14,931,978,2745,231,311,20,1623,665,2850,13,272
67,176,3,464,442,1152,91,157,3,598,364,1213,13,273
600,260,4,981,2514,4359,2252,256,4,1372,847,4731,13,274
882,484,1,1097,3118,5582,2692,359,2,1535,1144,5732,13,275
772,337,2,1037,3069,5217,2548,340,3,1616,1030,5537,13,276
680,515,6,1060,2862,5123,2306,358,8,1655,1187,5514,13,277
430,435,13,1225,2542,4645,1913,268,13,1822,808,4824,13,278
87,248,12,1104,928,2379,331,251,17,1569,612,2780,13,279
58,168,1,661,426,1314,87,200,6,750,535,1578,13,280
604,259,2,919,2568,4352,2234,280,5,1453,863,4835,13,281
828,369,1,1198,3048,5444,2499,368,6,1873,1118,5864,13,282
770,422,2,1214,3067,5475,2429,352,5,1884,1122,5792,13,283
719,630,2,1273,3006,5630,2293,417,6,1933,1332,5981,13,284
390,420,23,1409,2588,4830,1740,358,20,2459,820,5397,13,285
117,338,10,1078,1251,2794,317,318,29,1979,635,3278,13,286
108,163,1,711,480,1463,78,251,3,772,474,1578,13,287
284,159,2,1008,923,2376,528,218,4,1217,678,2645,13,288
806,348,3,1310,3075,5542,2514,365,8,2070,1122,6079,13,289
797,437,8,1242,3235,5719,2532,349,9,1869,1166,5925,13,290
785,721,49,1178,2927,5660,2342,443,52,1822,1407,6066,13,291
413,560,32,1283,2498,4786,1884,449,51,1835,889,5108,13,292
85,319,19,1107,1200,2730,311,314,35,1920,703,3283,13,293
60,158,17,580,435,1250,91,267,15,625,445,1443,13,294
593,269,8,848,2585,4303,1665,282,10,1499,898,4354,13,295
848,396,6,1146,3220,5616,2618,368,8,1860,1116,5970,13,296
817,411,14,1217,3085,5544,2524,384,16,1854,1145,5923,13,297
796,582,16,1199,2853,5446,2200,438,14,1690,1302,5644,13,298
427,449,10,1143,2656,4685,1870,360,25,1812,868,4935,13,299
91,245,25,995,1025,2381,294,289,20,1535,546,2684,13,300
203,145,1,767,485,1601,103,347,1,815,551,1817,13,301
578,282,1,1100,2603,4564,2148,315,4,1445,843,4755,13,302
812,351,5,1366,3563,6097,2670,796,5,2096,1113,6680,13,303
818,473,2,1077,2946,5316,2567,404,5,1774,1169,5919,13,304
690,577,10,1042,2510,4829,2324,419,14,1355,1296,5408,13,305
517,362,9,968,2095,3951,1893,325,27,1757,780,4782,13,306
102,265,5,887,908,2167,250,315,18,1306,606,2495,13,307
65,251,0,484,365,1165,110,177,3,619,552,1461,13,308
605,266,3,778,2263,3915,2151,254,3,1221,866,4495,13,309
652,386,11,1098,2023,4170,2131,319,10,1360,1068,4888,13,310
623,288,1,981,2057,3950,1957,293,3,1238,994,4485,13,311
723,561,15,996,2600,4895,2190,408,15,1460,1325,5398,13,312
423,421,22,1065,2167,4098,1789,375,23,1612,851,4650,13,313
95,243,7,835,982,2162,194,246,29,1485,728,2682,13,314
81,124,4,563,406,1178,87,140,12,586,487,1312,13,315
307,122,4,646,522,1601,265,227,7,787,663,1949,13,316
832,647,11,869,3039,5398,2926,340,14,1334,1142,5756,13,317
848,619,9,1016,3649,6141,3375,387,11,1720,1185,6678,13,318
813,472,9,980,3359,5633,2803,291,12,1450,950,5506,13,319
433,459,20,1199,2772,4883,2411,344,22,1512,869,5158,13,320
78,331,10,769,945,2133,196,308,39,1385,606,2534,13,321
71,96,3,493,344,1007,96,180,6,525,388,1195,13,322
693,540,5,776,2809,4823,2512,270,6,1239,973,5000,13,323
861,687,3,1092,3484,6127,3029,377,2,1731,1298,6437,13,324
834,733,4,1064,3344,5979,3174,323,7,1551,1234,6289,13,325
770,618,4,1133,3187,5712,2666,366,5,1374,1224,5635,13,326
443,334,10,1110,2396,4293,1940,250,28,1370,712,4300,13,327
72,167,12,725,833,1809,215,184,22,1114,470,2005,13,328
71,84,2,527,320,1004,68,155,6,537,425,1191,13,329
473,220,2,1047,2059,3801,1802,177,2,1360,697,4038,13,330
517,216,3,1062,2254,4052,1810,190,3,1653,729,4385,13,331
247,122,3,1210,1281,2863,1135,128,4,1274,413,2954,13,332
57,42,23,222,129,473,49,60,23,179,150,461,13,333
56,109,7,889,952,2013,457,126,13,1309,368,2273,13,334
38,125,3,723,697,1586,174,117,15,1125,375,1806,13,335
32,62,5,397,277,773,55,202,6,395,317,975,13,336
618,279,6,727,2445,4075,2070,256,4,1057,735,4122,13,337
813,600,1,976,2992,5382,2692,333,3,1290,1215,5533,13,338
779,716,9,1172,3318,5994,3089,336,11,1654,1274,6364,13,339
712,723,4,1034,3323,5796,2694,356,9,1484,1347,5890,13,340
408,496,15,1087,2675,4681,2153,344,25,1651,811,4984,13,341
80,258,26,739,892,1995,191,316,34,969,598,2108,13,342
36,156,2,519,429,1142,44,221,3,497,397,1162,13,343
611,421,1,912,2678,4623,2271,314,4,1261,948,4798,13,344
871,642,10,1128,3394,6045,2828,419,13,1839,1264,6363,13,345
772,688,5,1194,3422,6081,2968,387,6,1593,1238,6192,13,346
736,845,2,1069,3166,5818,2232,429,2,1395,1464,5522,13,347
447,465,20,1162,2406,4500,1781,345,23,1545,897,4591,13,348
165,271,31,967,828,2262,209,428,30,1303,683,2653,13,349
45,111,6,494,396,1052,67,146,9,584,322,1128,13,350
563,601,3,923,2373,4463,2082,299,5,1408,889,4683,13,351
774,559,5,1032,2908,5278,2550,355,8,1546,1129,5588,13,352
673,652,2,977,2785,5089,2457,309,5,1482,1047,5300,13,353
564,883,7,874,2404,4732,2213,354,12,1350,1176,5105,13,354
244,302,5,731,1468,2750,1215,118,10,772,359,2474,13,355
38,90,6,428,406,968,82,94,9,534,232,951,13,356
30,63,9,251,168,521,50,69,15,255,190,579,13,357
102,131,12,436,800,1481,696,98,14,510,218,1536,13,358
62,64,1,268,147,542,159,54,1,201,114,529,13,359
17,33,4,78,73,205,12,57,3,87,93,252,13,360
35,133,1,403,797,1369,495,79,2,739,277,1592,13,361
69,120,5,377,535,1106,364,41,7,390,131,933,13,362
20,56,5,188,174,443,72,38,9,229,97,445,13,363
12,81,6,102,265,466,20,48,179,160,102,509,13,364
106,151,2,609,953,1821,727,135,5,834,326,2027,13,365
172,169,68,987,1056,2452,880,162,100,1236,450,2828,13,366
27,15,0,38,24,104,7,25,9,31,46,118,14,1
258,36,10,137,79,520,67,68,13,94,216,458,14,2
297,40,0,139,75,551,77,67,10,107,286,547,14,3
283,39,15,141,72,550,66,72,11,100,270,519,14,4
232,49,3,131,86,501,64,79,8,72,215,438,14,5
28,35,3,60,26,152,13,44,8,38,62,165,14,6
26,34,3,77,40,180,27,38,3,61,55,184,14,7
289,35,10,122,86,542,67,72,10,99,280,528,14,8
303,44,2,93,68,510,66,59,4,89,274,492,14,9
359,49,1,107,92,608,72,77,4,91,308,552,14,10
361,31,0,126,93,611,77,91,11,98,317,594,14,11
245,33,1,134,75,488,67,62,5,97,210,441,14,12
40,38,2,150,37,267,26,47,14,62,118,267,14,13
21,18,0,81,33,153,31,37,3,52,37,160,14,14
87,39,7,103,48,284,46,51,10,85,80,272,14,15
111,19,1,84,72,287,67,53,6,65,122,313,14,16
264,26,1,129,62,482,56,69,3,84,244,456,14,17
313,25,4,102,71,515,65,81,7,81,281,515,14,18
139,17,8,101,74,339,42,53,15,95,112,317,14,19
45,25,2,85,44,201,25,40,13,62,54,194,14,20
15,23,8,49,26,121,23,36,10,45,35,149,14,21
275,23,0,113,70,481,62,62,10,93,251,478,14,22
348,22,0,113,73,556,70,92,4,81,314,561,14,23
358,30,1,147,76,612,78,89,8,103,292,570,14,24
343,34,1,155,90,623,67,106,4,108,293,578,14,25
260,36,3,133,104,536,74,78,18,100,213,483,14,26
41,27,2,96,71,237,15,41,5,54,81,196,14,27
25,21,0,49,48,143,23,36,3,45,40,147,14,28
278,25,0,126,80,509,71,64,2,99,276,512,14,29
345,20,1,142,87,595,58,81,4,133,322,598,14,30
353,30,0,113,76,572,70,89,7,102,311,579,14,31
323,32,0,122,99,576,76,86,4,93,314,573,14,32
241,28,2,107,104,482,72,76,4,75,207,434,14,33
45,28,4,101,54,232,19,42,13,69,83,226,14,34
22,18,5,106,36,187,15,47,12,85,53,212,14,35
281,35,2,116,74,508,67,79,6,78,269,499,14,36
346,35,4,129,117,631,73,125,7,81,326,612,14,37
340,41,0,162,98,641,68,123,7,109,313,620,14,38
322,39,9,128,105,603,70,93,11,80,311,565,14,39
260,35,1,113,111,520,55,86,17,112,213,483,14,40
32,28,2,92,66,220,19,44,15,58,78,214,14,41
24,27,0,88,45,184,22,48,7,62,50,189,14,42
284,28,0,134,76,522,75,66,7,90,270,508,14,43
352,45,5,136,96,634,86,105,9,101,312,613,14,44
357,40,6,157,84,644,106,102,8,104,305,625,14,45
314,37,0,145,109,605,72,92,3,82,271,520,14,46
219,33,9,121,101,483,71,75,13,108,234,501,14,47
42,34,1,91,48,216,32,36,15,60,84,227,14,48
36,23,2,91,51,203,23,62,8,54,47,194,14,49
111,22,1,106,65,305,78,54,4,79,82,297,14,50
350,48,0,145,104,647,78,94,4,84,308,568,14,51
355,48,2,131,82,618,82,102,4,84,320,592,14,52
345,43,1,127,73,589,76,105,6,87,291,565,14,53
253,43,1,119,80,496,60,78,7,83,224,452,14,54
33,26,0,97,55,211,15,56,14,61,86,232,14,55
21,27,6,100,36,190,18,51,10,67,55,201,14,56
283,19,4,156,94,556,77,63,8,81,309,538,14,57
369,42,11,128,87,637,77,101,17,101,328,624,14,58
381,43,15,145,89,673,66,96,12,108,335,617,14,59
343,28,13,132,89,605,79,96,11,79,267,532,14,60
261,36,1,122,121,541,77,67,9,93,242,488,14,61
47,31,0,96,68,242,20,58,21,74,89,262,14,62
28,31,1,120,46,226,19,52,8,80,81,240,14,63
294,34,2,125,80,535,72,77,5,91,287,532,14,64
332,32,5,156,86,611,67,83,10,98,298,556,14,65
358,39,8,147,98,650,69,98,10,106,301,584,14,66
343,41,9,159,104,656,66,95,19,125,319,624,14,67
261,37,2,137,121,558,59,94,15,96,227,491,14,68
55,33,0,118,46,252,18,64,11,81,81,255,14,69
31,35,4,115,41,226,17,59,10,77,63,226,14,70
296,43,2,119,78,538,69,81,11,82,276,519,14,71
399,45,23,163,90,720,70,146,33,113,348,710,14,72
385,44,6,183,88,706,69,127,13,119,360,688,14,73
350,52,0,172,108,682,87,107,6,113,318,631,14,74
246,36,0,133,95,510,70,72,11,82,216,451,14,75
67,39,3,159,60,328,19,80,20,88,132,339,14,76
38,32,4,138,59,271,23,64,10,87,84,268,14,77
318,36,6,127,80,567,71,85,5,97,272,530,14,78
412,37,2,140,82,673,80,101,7,98,330,616,14,79
378,37,4,161,113,693,71,129,11,95,344,650,14,80
381,39,4,140,104,668,76,105,5,96,338,620,14,81
296,39,1,168,119,623,79,93,16,112,283,583,14,82
42,34,1,121,66,264,17,80,8,45,104,254,14,83
27,26,1,180,60,294,21,53,4,109,123,310,14,84
301,29,1,162,75,568,59,87,11,115,271,543,14,85
343,29,3,168,99,642,76,122,16,90,342,646,14,86
332,33,9,162,81,617,60,102,16,118,317,613,14,87
319,30,1,177,81,608,71,85,6,90,313,565,14,88
247,40,2,171,133,593,71,101,9,86,243,510,14,89
64,22,0,245,57,388,23,66,16,123,143,371,14,90
35,18,0,101,36,190,16,50,2,75,79,222,14,91
272,32,14,155,87,560,66,127,23,82,242,540,14,92
379,27,8,168,82,664,56,109,13,105,357,640,14,93
360,45,15,148,91,659,76,114,22,103,327,642,14,94
345,30,6,173,102,656,80,117,6,124,306,633,14,95
286,25,1,169,109,590,77,115,11,108,248,559,14,96
78,17,3,113,67,278,25,56,16,67,94,258,14,97
48,22,13,123,58,264,16,74,15,98,59,262,14,98
311,31,2,163,86,593,60,61,5,119,284,529,14,99
374,34,6,134,105,653,89,106,12,78,340,625,14,100
368,45,8,176,86,683,75,117,12,113,331,648,14,101
357,28,8,172,94,659,71,111,14,107,324,627,14,102
295,47,13,120,121,596,75,107,18,87,241,528,14,103
65,23,11,141,82,322,29,85,13,69,105,301,14,104
29,19,2,125,62,237,24,70,4,67,78,243,14,105
281,29,5,127,102,544,75,78,4,94,278,529,14,106
329,40,7,184,73,633,59,115,6,111,313,604,14,107
363,36,7,135,119,660,76,137,16,90,326,645,14,108
331,41,3,142,107,624,74,112,8,107,291,592,14,109
287,52,2,136,122,599,78,115,12,103,220,528,14,110
37,29,0,147,77,290,29,80,11,69,63,252,14,111
24,8,0,75,25,132,10,31,1,48,44,134,14,112
296,20,1,137,84,538,73,79,2,94,275,523,14,113
361,45,11,128,119,664,79,149,17,77,344,666,14,114
381,32,4,157,125,699,85,114,10,105,346,660,14,115
357,36,0,160,101,654,69,110,6,112,326,623,14,116
291,32,1,136,140,600,84,95,10,94,252,535,14,117
86,401,102,274,443,1306,295,146,9,677,350,1477,14,118
38,29,12,95,33,207,29,51,18,56,49,203,14,119
312,38,1,131,83,565,90,79,7,117,274,567,14,120
380,40,1,158,117,696,77,100,8,125,319,629,14,121
389,35,4,138,103,669,82,114,10,125,314,645,14,122
365,34,6,145,102,652,84,116,8,110,303,621,14,123
269,38,1,130,108,546,71,95,7,86,258,517,14,124
57,31,0,127,51,266,24,72,17,62,72,247,14,125
46,39,6,97,62,250,29,68,8,78,81,264,14,126
324,39,0,139,90,592,92,83,11,94,316,596,14,127
387,42,7,193,144,773,101,146,9,128,369,753,14,128
392,41,0,154,111,698,75,130,6,130,354,695,14,129
378,36,0,148,98,660,80,99,3,107,343,632,14,130
276,31,0,142,99,548,63,86,8,113,247,517,14,131
57,29,0,146,62,294,36,73,11,78,97,295,14,132
31,29,0,85,37,182,17,42,1,56,61,177,14,133
295,40,0,168,89,592,81,101,7,102,253,544,14,134
374,33,6,150,89,652,84,110,8,87,330,619,14,135
419,38,6,151,116,730,82,118,8,123,375,706,14,136
383,41,0,154,120,698,88,122,8,92,315,625,14,137
311,40,0,140,102,593,89,93,12,98,229,521,14,138
53,31,7,98,61,250,26,60,9,72,81,248,14,139
37,29,0,93,50,209,26,64,6,69,88,253,14,140
344,35,7,123,112,621,91,111,10,92,280,584,14,141
396,48,10,131,108,693,91,134,11,86,347,669,14,142
406,41,3,165,101,716,96,132,7,99,351,685,14,143
348,36,1,117,108,610,90,85,7,102,309,593,14,144
253,40,1,158,123,575,88,104,12,102,213,519,14,145
55,32,2,132,74,295,13,87,5,55,95,255,14,146
38,53,0,91,55,237,24,56,7,53,85,225,14,147
35,22,2,90,53,202,36,45,7,59,47,194,14,148
339,35,4,132,101,611,80,91,8,85,311,575,14,149
379,44,1,154,83,661,87,109,9,94,327,626,14,150
382,43,5,177,96,703,82,124,14,133,342,695,14,151
290,47,0,178,115,630,89,88,11,98,267,553,14,152
58,47,4,118,56,283,31,69,12,88,108,308,14,153
45,30,14,124,51,264,24,63,20,82,105,294,14,154
323,37,1,153,103,617,83,111,11,111,314,630,14,155
417,32,6,184,134,773,85,134,13,117,373,722,14,156
425,38,4,160,113,740,90,131,9,108,359,697,14,157
381,38,5,191,103,718,81,133,14,116,339,683,14,158
320,48,7,166,136,677,100,140,16,95,294,645,14,159
66,60,16,163,120,425,33,137,23,75,125,393,14,160
41,34,5,133,56,269,30,98,10,55,103,296,14,161
319,32,9,159,105,624,108,105,16,113,293,635,14,162
402,45,3,125,89,664,89,132,5,88,325,639,14,163
412,58,0,179,124,773,85,133,17,118,368,721,14,164
403,43,3,148,125,722,101,131,12,105,385,734,14,165
298,44,3,153,139,637,84,102,11,113,287,597,14,166
57,30,2,161,68,318,25,99,10,74,103,311,14,167
37,31,11,107,45,231,15,67,11,50,94,237,14,168
302,28,11,137,89,567,85,93,15,75,286,554,14,169
376,42,3,165,111,697,65,153,9,97,321,645,14,170
147,44,1,132,96,420,58,95,12,104,123,392,14,171
336,34,5,171,110,656,80,129,15,90,323,637,14,172
288,55,0,149,117,609,85,120,15,96,224,540,14,173
62,59,4,120,63,308,23,86,21,86,83,299,14,174
29,25,6,95,43,198,20,49,13,82,75,239,14,175
321,40,3,178,95,637,96,101,11,122,318,648,14,176
369,38,6,149,103,665,72,92,9,119,320,612,14,177
355,46,5,151,95,652,75,123,13,102,313,626,14,178
360,33,1,159,101,654,66,125,9,109,325,634,14,179
270,35,6,166,118,595,68,98,20,96,275,557,14,180
69,66,5,141,50,331,33,73,21,82,111,320,14,181
27,52,2,80,63,224,23,65,10,58,82,238,14,182
303,39,7,172,99,620,81,113,8,113,286,601,14,183
372,49,4,181,112,718,83,120,13,125,322,663,14,184
307,44,5,164,116,636,72,121,9,145,252,599,14,185
49,93,3,107,117,369,15,207,8,79,91,400,14,186
171,58,20,157,94,500,66,98,22,103,168,457,14,187
59,25,25,89,69,267,48,61,21,60,88,278,14,188
30,27,15,75,52,199,37,43,23,59,70,232,14,189
268,38,20,141,99,566,72,88,28,90,301,579,14,190
357,52,1,151,101,662,60,100,9,120,317,606,14,191
332,46,7,140,89,614,50,112,9,89,313,573,14,192
377,37,3,145,92,654,66,116,17,108,335,642,14,193
261,49,4,154,123,591,74,107,15,105,270,571,14,194
48,55,4,140,88,335,23,106,15,81,95,320,14,195
37,43,20,82,61,243,24,60,20,63,75,242,14,196
312,60,1,150,114,637,79,107,6,85,287,564,14,197
369,51,4,149,88,661,86,125,12,110,321,654,14,198
360,42,3,158,91,654,83,116,3,103,309,614,14,199
360,50,4,158,120,692,82,134,11,118,310,655,14,200
272,57,6,163,126,624,69,100,19,110,265,563,14,201
52,48,7,143,73,323,24,74,19,83,103,303,14,202
37,37,18,132,49,273,25,57,7,97,67,253,14,203
315,47,15,169,93,639,100,98,15,143,261,617,14,204
384,56,13,198,134,785,79,165,13,136,319,712,14,205
358,48,3,196,115,720,87,118,10,126,332,673,14,206
355,59,5,224,86,729,90,107,11,129,329,666,14,207
284,36,16,175,110,621,77,108,32,105,252,574,14,208
60,42,10,114,111,337,39,82,39,72,98,330,14,209
34,42,3,120,53,252,23,69,15,93,77,277,14,210
311,39,3,159,118,630,86,100,23,122,309,640,14,211
380,44,8,170,103,705,81,115,15,97,373,681,14,212
356,58,6,168,100,688,75,108,13,124,354,674,14,213
365,44,9,145,106,669,74,109,19,108,302,612,14,214
263,61,6,176,146,652,69,170,11,109,250,609,14,215
57,38,7,106,67,275,30,80,18,72,109,309,14,216
30,37,7,101,62,237,17,67,12,69,78,243,14,217
272,45,6,147,90,560,77,85,16,105,267,550,14,218
363,38,10,161,129,701,83,97,17,128,344,669,14,219
339,33,1,143,106,622,79,101,12,110,297,599,14,220
324,25,16,124,103,592,63,90,25,100,288,566,14,221
236,41,4,126,106,513,77,105,12,97,217,508,14,222
64,43,5,123,56,291,21,88,20,72,96,297,14,223
34,27,15,104,36,216,18,51,25,75,73,242,14,224
279,63,7,163,83,595,75,89,9,136,274,583,14,225
336,60,4,148,91,639,75,104,14,99,315,607,14,226
361,41,5,136,100,643,58,94,10,94,346,602,14,227
313,43,3,164,93,616,59,91,18,109,314,591,14,228
256,36,11,174,103,580,75,98,19,88,224,504,14,229
63,17,6,104,54,244,19,60,20,66,71,236,14,230
21,28,6,100,42,197,10,47,13,59,75,204,14,231
259,46,7,129,95,536,68,79,12,109,254,522,14,232
351,40,18,124,81,614,76,105,11,101,317,610,14,233
347,34,6,160,111,658,75,99,10,115,334,633,14,234
327,35,2,139,82,585,64,82,11,84,315,556,14,235
244,36,13,155,92,540,62,99,16,85,234,496,14,236
63,16,18,115,64,276,32,78,15,87,111,323,14,237
30,31,9,107,41,218,26,50,64,62,72,274,14,238
294,40,1,108,101,544,74,82,8,68,273,505,14,239
366,40,3,118,88,615,68,119,10,71,335,603,14,240
367,43,3,107,93,613,64,114,4,85,305,572,14,241
364,19,21,118,90,612,74,98,21,81,332,606,14,242
235,27,3,133,128,526,65,101,18,82,222,488,14,243
60,31,4,109,55,259,11,75,20,73,75,254,14,244
35,29,3,130,45,242,7,48,7,74,119,255,14,245
43,35,2,92,55,227,33,44,7,68,70,222,14,246
388,38,0,123,84,633,83,94,6,102,355,640,14,247
424,36,2,154,96,712,71,105,6,108,354,644,14,248
383,33,9,128,80,633,75,85,12,105,316,593,14,249
281,30,5,126,102,544,63,84,16,96,266,525,14,250
50,36,4,116,68,274,25,55,28,73,95,276,14,251
25,34,16,67,52,194,10,64,24,39,79,216,14,252
327,38,17,116,101,599,68,103,16,80,309,576,14,253
422,37,7,159,87,712,80,109,10,107,366,672,14,254
434,42,5,150,101,732,71,117,11,105,371,675,14,255
386,44,13,159,119,721,79,138,17,103,334,671,14,256
336,27,3,126,121,613,88,102,17,94,263,564,14,257
70,33,2,95,59,259,22,54,18,59,116,269,14,258
30,16,8,119,42,215,8,55,13,77,83,236,14,259
330,38,4,150,85,607,69,86,11,104,316,586,14,260
426,26,10,144,87,693,71,93,14,110,383,671,14,261
442,35,15,163,100,755,81,121,21,112,373,708,14,262
396,17,6,157,134,710,79,116,11,115,332,653,14,263
318,47,41,138,107,651,77,130,27,91,289,614,14,264
58,35,8,42,45,188,64,41,13,41,40,199,14,265
93,186,11,155,355,800,195,98,4,449,154,900,14,266
351,43,2,154,85,635,72,102,7,123,284,588,14,267
438,28,4,151,101,722,83,111,9,112,359,674,14,268
396,41,8,167,107,719,78,118,17,113,344,670,14,269
395,32,8,167,96,698,81,118,15,102,346,662,14,270
285,38,2,126,125,576,75,84,16,86,254,515,14,271
52,39,10,153,72,326,16,95,30,66,112,319,14,272
44,22,12,94,47,219,27,49,11,48,88,223,14,273
314,39,11,137,93,594,68,95,16,114,307,600,14,274
398,37,4,136,89,664,69,94,9,100,390,662,14,275
426,32,23,157,104,742,74,121,31,116,376,718,14,276
394,39,3,134,112,682,81,100,10,109,347,647,14,277
271,40,8,145,107,571,73,94,19,87,286,559,14,278
50,42,4,104,56,256,29,81,14,69,88,281,14,279
40,57,4,110,71,282,36,79,8,95,81,299,14,280
311,41,6,158,88,604,75,98,15,109,319,616,14,281
411,32,1,158,87,689,84,105,3,107,377,676,14,282
411,42,2,172,97,724,82,110,7,116,358,673,14,283
354,30,1,158,98,641,86,109,7,102,335,639,14,284
248,39,15,158,103,563,69,88,17,120,239,533,14,285
64,32,12,131,81,320,36,94,23,61,99,313,14,286
54,38,20,93,37,242,27,57,21,83,75,263,14,287
153,31,3,138,75,400,65,61,14,98,162,400,14,288
389,28,5,162,99,683,74,104,10,95,388,671,14,289
421,36,1,159,119,736,85,120,9,105,416,735,14,290
383,29,8,158,120,698,87,118,13,100,373,691,14,291
289,49,7,178,118,641,64,123,15,102,280,584,14,292
68,43,3,148,59,321,20,52,35,78,88,273,14,293
35,34,2,161,53,285,18,76,6,109,80,289,14,294
328,32,2,156,102,620,73,101,8,92,343,617,14,295
442,41,15,160,113,771,97,127,12,117,411,764,14,296
444,42,15,168,108,777,95,109,16,108,408,736,14,297
380,42,3,163,119,707,84,131,10,89,351,665,14,298
303,30,5,149,108,595,97,80,19,91,275,562,14,299
52,32,2,144,66,296,15,76,15,104,92,302,14,300
56,22,8,103,45,234,20,50,16,68,94,248,14,301
342,34,5,162,109,652,87,87,10,130,335,649,14,302
389,30,4,166,177,766,83,197,10,102,370,762,14,303
418,36,21,156,112,743,83,120,29,114,397,743,14,304
335,47,14,140,118,654,86,103,17,109,363,678,14,305
277,37,46,133,110,603,76,93,52,99,243,563,14,306
42,0,0,0,0,42,25,0,0,0,0,25,14,307
323,33,14,126,90,586,103,90,12,97,279,581,14,309
326,26,2,144,93,591,81,84,6,117,286,574,14,310
385,26,8,113,95,627,107,86,8,89,348,638,14,311
368,27,2,165,124,686,96,125,10,117,341,689,14,312
323,33,2,143,99,600,85,77,14,137,234,547,14,313
47,24,3,111,46,231,21,48,18,75,76,238,14,314
31,25,3,119,55,233,10,41,8,110,77,246,14,315
143,37,10,132,67,389,53,58,24,105,150,390,14,316
418,32,8,154,101,713,83,112,8,107,397,707,14,317
446,38,9,146,96,735,94,107,6,91,377,675,14,318
384,17,3,154,90,648,100,97,7,107,355,666,14,319
295,23,19,153,102,592,63,93,19,99,280,554,14,320
49,24,16,92,57,238,24,47,21,66,90,248,14,321
25,31,7,121,39,223,20,41,6,91,68,226,14,322
357,43,7,148,84,639,71,96,11,117,333,628,14,323
444,28,6,173,94,745,73,104,14,131,386,708,14,324
458,45,5,145,83,736,82,96,12,110,408,708,14,325
372,34,11,124,101,642,84,113,17,99,333,646,14,326
283,36,2,125,118,564,74,82,17,72,235,480,14,327
47,35,6,97,70,255,21,60,19,81,90,271,14,328
30,28,1,88,44,191,11,52,7,61,90,221,14,329
334,43,5,152,102,636,87,73,11,138,292,601,14,330
325,36,0,184,111,656,86,98,9,143,325,661,14,331
223,35,9,141,87,495,74,70,14,141,191,490,14,332
30,19,1,38,30,118,9,17,4,46,61,137,14,333
104,29,3,132,70,338,42,48,18,60,145,313,14,334
51,25,4,106,51,237,16,66,9,39,111,241,14,335
28,26,4,101,45,204,14,52,11,74,71,222,14,336
335,31,10,144,89,609,103,78,14,121,297,613,14,337
352,43,10,161,101,667,71,118,13,90,339,631,14,338
397,27,3,156,105,688,86,102,9,113,375,685,14,339
350,25,5,126,101,607,76,110,12,90,324,612,14,340
273,28,5,131,119,556,71,90,22,93,263,539,14,341
89,330,54,213,346,1032,239,117,16,563,329,1264,14,342
70,230,35,154,274,763,161,93,18,366,177,815,14,343
305,30,8,139,78,560,79,70,13,107,271,540,14,344
386,40,3,141,110,680,76,132,5,91,350,654,14,345
413,35,4,162,94,708,88,131,13,116,319,667,14,346
378,39,4,125,104,650,96,126,11,100,309,642,14,347
263,44,8,139,94,548,65,100,28,91,245,529,14,348
57,32,2,129,69,289,29,58,15,92,111,305,14,349
37,21,2,114,31,205,20,62,3,72,52,209,14,350
286,36,15,136,77,550,73,91,18,127,265,574,14,351
362,48,3,148,98,659,75,94,10,132,340,651,14,352
370,43,2,132,99,646,84,87,6,89,333,599,14,353
314,46,0,117,108,585,80,113,4,99,271,567,14,354
209,30,3,111,100,453,66,78,17,83,171,415,14,355
38,19,0,115,58,230,30,67,9,76,70,252,14,356
19,29,5,100,43,196,13,57,9,67,63,209,14,357
153,36,6,93,81,369,67,67,9,69,156,368,14,358
84,24,0,100,31,239,58,28,2,101,73,262,14,359
8,15,0,26,15,64,6,11,2,25,30,74,14,360
117,14,1,85,63,280,53,56,2,43,127,281,14,361
108,22,3,104,72,309,61,39,7,62,117,286,14,362
26,19,0,65,37,147,17,36,8,31,44,136,14,363
30,18,1,90,29,168,26,25,9,63,47,170,14,364
128,29,0,159,70,386,64,61,1,117,156,399,14,365
161,58,10,131,77,437,67,57,25,119,133,401,14,366
55,154,10,409,290,918,40,215,7,389,408,1059,15,1
833,241,3,501,598,2176,264,356,9,499,1280,2408,15,2
1000,331,2,483,716,2532,300,477,4,482,1526,2789,15,3
1000,314,2,500,684,2500,321,387,4,469,1491,2672,15,4
585,560,94,482,810,2531,239,793,67,525,1180,2804,15,5
97,356,82,651,514,1700,91,467,59,627,514,1758,15,6
79,236,6,908,557,1786,81,325,5,747,751,1909,15,7
843,265,13,475,642,2238,289,416,17,530,1230,2482,15,8
1147,262,1,472,470,2352,318,325,4,498,1288,2433,15,9
1240,428,15,597,799,3079,351,573,16,564,1783,3287,15,10
1192,439,26,605,850,3112,356,655,23,540,1664,3238,15,11
756,747,90,1110,1694,4397,3672,1259,57,2479,2356,9823,15,12
203,994,127,1112,1912,4348,521,1089,59,4524,1688,7881,15,13
156,461,22,902,917,2458,358,784,16,1775,1311,4244,15,14
288,459,26,792,778,2343,581,868,19,1744,1365,4577,15,15
432,296,3,406,550,1687,199,345,8,418,736,1706,15,16
1138,400,57,573,706,2874,338,527,35,474,1641,3015,15,17
1228,457,38,589,817,3129,377,717,25,551,1721,3391,15,18
383,586,51,710,666,2396,206,770,56,492,1097,2621,15,19
132,521,81,970,807,2511,114,661,102,871,1089,2837,15,20
99,248,3,823,601,1774,108,396,5,811,650,1970,15,21
917,339,4,505,642,2407,316,422,7,488,1344,2577,15,22
1356,395,1,614,755,3121,384,546,11,523,1854,3318,15,23
1309,407,4,607,780,3107,391,650,9,585,1756,3391,15,24
1162,450,4,617,794,3027,387,652,15,527,1578,3159,15,25
658,670,143,607,803,2881,224,883,131,639,1306,3183,15,26
122,654,102,1019,908,2805,109,739,85,944,1036,2913,15,27
77,289,1,788,566,1721,85,266,7,860,638,1856,15,28
916,328,4,495,646,2389,301,425,5,512,1331,2574,15,29
1418,399,2,571,789,3179,373,579,4,509,1895,3360,15,30
1335,474,6,636,817,3268,386,647,10,581,1824,3448,15,31
1300,449,5,666,777,3197,385,646,11,601,1718,3361,15,32
652,645,135,577,854,2863,271,901,58,660,1222,3112,15,33
118,557,108,1020,786,2589,104,665,75,932,1035,2811,15,34
73,250,5,815,576,1719,93,273,5,854,696,1921,15,35
932,300,5,439,602,2278,310,393,7,428,1280,2418,15,36
1404,371,9,570,775,3129,369,598,15,536,1754,3272,15,37
1329,508,2,588,828,3255,419,654,12,575,1780,3440,15,38
1264,506,3,598,810,3181,374,690,8,562,1732,3366,15,39
619,717,93,563,759,2751,241,854,63,634,1171,2963,15,40
106,510,78,1008,788,2490,109,771,61,840,997,2778,15,41
80,439,20,726,516,1781,86,328,34,644,823,1915,15,42
828,316,1,509,658,2312,297,437,2,501,1286,2523,15,43
1266,517,1,545,818,3147,343,660,11,545,1795,3354,15,44
1313,551,16,665,824,3369,618,699,20,615,2027,3979,15,45
1206,425,5,659,773,3068,377,607,13,689,2275,3961,15,46
609,626,70,538,835,2678,266,816,80,600,1159,2921,15,47
96,512,103,989,733,2433,96,686,91,888,924,2685,15,48
74,312,9,903,602,1900,84,380,9,837,858,2168,15,49
262,293,9,749,606,1919,155,345,10,749,761,2020,15,50
1334,424,14,581,815,3168,361,626,19,562,1809,3377,15,51
1377,464,12,618,729,3200,356,597,11,548,1847,3359,15,52
1277,452,20,611,814,3174,387,681,23,563,1716,3370,15,53
661,595,111,597,756,2720,244,890,47,662,1159,3002,15,54
145,650,124,1060,814,2793,115,776,95,934,1062,2982,15,55
90,282,5,817,609,1803,74,289,4,896,712,1975,15,56
904,339,5,477,732,2457,298,532,10,469,1321,2630,15,57
1400,449,17,534,781,3181,399,606,23,546,1856,3430,15,58
1289,402,4,638,723,3056,365,566,8,535,1668,3142,15,59
1281,477,8,650,813,3229,352,709,13,622,1708,3404,15,60
692,604,116,627,849,2888,237,990,59,612,1220,3118,15,61
108,586,122,917,817,2550,94,810,76,830,910,2720,15,62
94,352,3,975,634,2058,84,328,13,896,891,2212,15,63
868,315,9,540,607,2339,304,437,10,501,1319,2571,15,64
1339,426,4,610,749,3128,383,604,10,510,1807,3314,15,65
1314,449,9,566,831,3169,413,662,15,555,1727,3372,15,66
1270,510,3,666,776,3225,397,670,33,608,1806,3514,15,67
646,669,121,643,873,2952,264,909,88,660,1254,3175,15,68
123,566,133,1034,700,2556,113,906,58,836,753,2666,15,69
94,318,21,896,567,1896,89,326,20,824,765,2024,15,70
831,397,14,528,628,2398,293,508,12,479,1322,2614,15,71
1342,545,9,632,786,3314,391,691,17,544,1922,3565,15,72
1301,545,2,736,872,3456,379,807,19,631,1963,3799,15,73
1218,618,18,721,995,3570,341,841,79,670,1795,3726,15,74
616,718,79,730,941,3084,247,865,134,664,1382,3292,15,75
409,1070,188,1391,1118,4176,129,1408,125,1509,1579,4750,15,76
116,422,3,1007,693,2241,82,546,18,949,906,2501,15,77
919,412,7,563,782,2683,342,588,7,536,1420,2893,15,78
1406,465,6,666,887,3430,402,730,10,634,1869,3645,15,79
1348,556,5,750,1050,3709,394,935,15,616,1937,3897,15,80
1270,599,7,754,938,3568,413,898,14,618,1754,3697,15,81
662,841,152,812,1071,3538,294,1140,85,768,1466,3753,15,82
100,753,103,969,865,2790,100,955,99,823,1033,3010,15,83
134,445,13,1373,780,2745,100,508,15,1154,1321,3098,15,84
854,414,13,627,875,2783,332,659,72,570,1424,3057,15,85
1312,461,5,674,896,3348,385,766,11,582,1846,3590,15,86
1227,556,9,604,811,3207,397,607,12,543,1797,3356,15,87
1091,531,11,701,804,3138,351,726,15,594,1674,3360,15,88
552,794,76,806,899,3127,266,919,93,646,1435,3359,15,89
148,541,75,1513,991,3268,92,927,63,1160,1309,3551,15,90
120,238,4,940,542,1844,118,362,10,959,839,2288,15,91
760,373,4,675,679,2491,282,628,6,506,1274,2696,15,92
1303,444,6,648,717,3118,315,600,11,620,1804,3350,15,93
1290,513,7,597,837,3244,382,699,11,541,1768,3401,15,94
1247,547,7,729,938,3468,420,872,14,590,1773,3669,15,95
672,741,130,759,1010,3312,292,1086,139,706,1358,3581,15,96
236,645,123,1231,943,3178,114,1033,83,1098,1146,3474,15,97
400,306,20,1099,654,2479,102,510,16,1232,896,2756,15,98
828,376,7,645,624,2480,341,542,11,540,1287,2721,15,99
1339,449,25,579,777,3169,340,733,35,583,1728,3419,15,100
1314,501,14,744,853,3426,375,711,17,660,1924,3687,15,101
1240,524,14,659,801,3238,416,755,16,601,1660,3448,15,102
665,738,107,634,880,3024,308,923,57,669,1336,3293,15,103
206,710,82,1288,1015,3301,128,972,103,1010,1224,3437,15,104
140,403,4,995,661,2203,109,470,6,963,900,2448,15,105
932,391,16,611,757,2707,355,663,16,564,1368,2966,15,106
1439,513,9,662,834,3457,387,788,15,608,1936,3734,15,107
1356,493,3,718,795,3365,399,786,9,624,1790,3608,15,108
1281,574,3,722,808,3388,401,877,9,651,1834,3772,15,109
738,693,108,657,1041,3237,271,977,116,690,1356,3410,15,110
152,701,113,1515,1097,3578,87,1548,105,878,1308,3926,15,111
102,260,4,812,545,1723,82,336,7,802,725,1952,15,112
851,376,3,581,699,2510,363,494,7,562,1362,2788,15,113
1378,485,4,606,911,3384,400,727,13,610,1887,3637,15,114
1340,503,13,650,924,3430,423,837,17,601,1782,3660,15,115
1302,585,26,691,901,3505,429,888,26,681,1711,3735,15,116
668,751,107,663,1008,3197,289,1088,81,674,1336,3468,15,117
156,614,96,1162,858,2886,132,870,220,1009,909,3140,15,118
101,321,6,1109,895,2432,96,530,93,1094,967,2780,15,119
884,359,3,558,744,2548,338,502,2,540,1306,2688,15,120
1360,482,4,632,774,3252,396,644,7,587,1880,3514,15,121
1318,532,13,690,919,3472,422,758,10,620,1894,3704,15,122
1246,648,12,681,804,3391,390,840,26,652,1711,3619,15,123
677,696,107,684,1049,3213,284,1054,102,714,1295,3449,15,124
152,609,86,980,705,2532,116,740,65,817,1056,2794,15,125
107,323,9,828,592,1859,80,397,19,794,792,2082,15,126
864,363,9,547,670,2453,349,491,11,552,1329,2732,15,127
1365,451,5,615,882,3318,391,789,6,583,1835,3604,15,128
1291,532,16,677,1003,3519,414,889,21,649,1743,3716,15,129
1178,598,12,669,866,3323,425,759,14,580,1676,3454,15,130
644,615,73,638,806,2776,276,795,63,635,1240,3009,15,131
187,498,122,1063,808,2678,122,710,58,895,1078,2863,15,132
114,282,6,818,499,1719,119,353,7,773,768,2020,15,133
892,390,6,590,679,2557,357,531,15,542,1365,2810,15,134
1344,466,21,630,813,3274,441,624,21,596,1864,3546,15,135
1304,515,4,627,863,3313,406,656,15,598,1787,3462,15,136
1235,623,7,733,929,3527,449,862,19,633,1740,3703,15,137
644,674,92,736,770,2916,268,926,85,730,1314,3323,15,138
126,553,114,1132,697,2622,102,846,68,1653,839,3508,15,139
139,374,4,951,604,2072,93,409,10,910,852,2274,15,140
900,413,9,584,727,2633,357,518,11,542,1388,2816,15,141
1330,425,7,633,938,3333,459,717,9,641,1768,3594,15,142
1264,450,5,743,847,3309,419,653,7,643,1807,3529,15,143
1135,429,18,671,747,3000,399,667,16,613,1506,3201,15,144
554,647,147,656,885,2889,220,989,119,736,1116,3180,15,145
150,548,112,1029,732,2571,129,1038,88,840,782,2877,15,146
95,415,17,908,604,2039,89,510,31,754,797,2181,15,147
79,270,7,641,440,1437,86,291,9,622,683,1691,15,148
1246,416,12,615,718,3007,386,577,16,621,1663,3263,15,149
1296,433,4,615,707,3055,416,583,13,553,1680,3245,15,150
1235,528,6,659,855,3283,399,790,23,566,1730,3508,15,151
647,638,204,672,783,2944,287,1095,86,649,1176,3293,15,152
119,685,127,988,773,2692,112,991,92,902,925,3022,15,153
84,316,8,1049,627,2084,150,307,10,999,801,2267,15,154
962,397,22,508,793,2682,436,521,25,541,1450,2973,15,155
1492,506,5,614,910,3527,509,719,4,584,1882,3698,15,156
1368,452,9,657,813,3299,568,711,8,637,1647,3571,15,157
1262,567,16,631,1031,3507,463,933,24,608,1776,3804,15,158
745,669,148,738,1306,3606,296,1602,191,731,1224,4044,15,159
175,688,118,1456,1329,3766,127,1590,150,1078,1165,4110,15,160
109,330,20,1029,659,2147,86,478,18,869,893,2344,15,161
987,392,4,557,723,2663,369,472,8,576,1407,2832,15,162
1455,615,6,661,841,3578,463,725,10,584,1971,3753,15,163
1413,559,11,708,1099,3790,463,929,34,627,1890,3943,15,164
1294,607,16,657,954,3528,403,876,14,619,1684,3596,15,165
657,673,208,702,1110,3350,294,1355,120,738,1233,3740,15,166
145,606,128,1109,905,2893,106,1085,118,929,903,3141,15,167
113,289,5,926,541,1874,104,350,14,798,853,2119,15,168
904,413,5,535,651,2508,360,473,9,533,1309,2684,15,169
1380,545,11,661,1011,3608,420,882,14,624,1877,3817,15,170
407,478,10,841,814,2550,248,676,10,811,985,2730,15,171
1244,564,8,693,917,3426,453,759,21,648,1671,3552,15,172
696,673,140,645,824,2978,277,1135,84,676,1227,3399,15,173
188,759,142,963,796,2848,147,1125,119,864,787,3042,15,174
95,296,5,805,576,1777,106,403,29,840,707,2085,15,175
894,392,9,566,686,2547,340,488,12,557,1403,2800,15,176
1433,498,4,656,859,3450,455,712,7,614,1882,3670,15,177
1358,487,6,633,854,3338,477,691,15,590,1794,3567,15,178
1208,604,14,714,931,3471,459,786,21,654,1688,3608,15,179
646,584,127,697,879,2933,288,952,84,667,1217,3208,15,180
172,695,141,1065,669,2742,104,974,113,917,934,3042,15,181
101,271,12,824,546,1754,98,341,16,794,672,1921,15,182
871,360,4,575,847,2657,383,559,14,562,1295,2813,15,183
1141,459,3,665,835,3103,407,608,12,636,1663,3326,15,184
876,494,16,718,1015,3119,358,866,34,777,1406,3441,15,185
147,1415,16,979,923,3480,77,1999,39,852,821,3788,15,186
287,578,85,755,773,2478,182,853,73,728,834,2670,15,187
136,554,96,890,675,2351,110,851,89,817,801,2668,15,188
99,305,6,689,480,1579,104,366,11,755,650,1886,15,189
847,317,7,574,705,2450,365,569,10,553,1232,2729,15,190
1365,463,17,665,841,3351,430,713,19,634,1841,3637,15,191
1309,485,17,725,840,3376,461,669,22,635,1798,3585,15,192
1228,599,7,720,910,3464,434,801,23,692,1676,3626,15,193
579,654,113,669,825,2840,306,882,85,634,1176,3083,15,194
120,647,143,984,869,2763,115,1043,111,963,880,3112,15,195
108,310,16,853,581,1868,77,385,17,895,683,2057,15,196
903,360,7,524,641,2435,405,406,10,524,1246,2591,15,197
1354,453,3,649,837,3296,465,618,9,563,1797,3452,15,198
1335,367,6,652,798,3158,463,529,13,631,1725,3361,15,199
1247,577,14,664,918,3420,458,808,19,609,1724,3618,15,200
618,682,159,659,1097,3215,332,1197,218,649,1147,3543,15,201
122,584,160,1052,974,2892,121,1314,141,934,840,3350,15,202
94,340,5,919,648,2006,82,371,11,912,819,2195,15,203
899,396,6,596,732,2629,375,479,14,579,1297,2744,15,204
1376,570,7,645,918,3516,468,765,14,625,1832,3704,15,205
1252,563,13,729,994,3551,482,784,12,581,1788,3647,15,206
1185,582,8,689,882,3346,419,716,22,607,1690,3454,15,207
610,765,142,711,853,3081,294,1052,182,693,1166,3387,15,208
117,698,123,1023,879,2840,115,1023,200,924,956,3218,15,209
118,315,9,759,656,1857,96,417,14,813,746,2086,15,210
878,332,4,591,739,2544,377,469,44,548,1326,2764,15,211
1284,439,6,627,757,3113,427,608,11,571,1774,3391,15,212
1272,421,8,650,798,3149,434,628,9,572,1621,3264,15,213
1156,542,9,628,823,3158,381,678,23,604,1653,3339,15,214
589,633,169,674,957,3022,265,1135,105,835,1101,3441,15,215
123,578,103,1030,731,2565,252,787,82,843,939,2903,15,216
91,306,8,944,572,1921,104,313,13,804,822,2056,15,217
858,381,9,579,721,2548,347,497,13,603,1308,2768,15,218
1318,462,10,634,859,3283,422,681,10,614,1712,3439,15,219
1294,551,5,634,810,3294,446,582,12,679,1766,3485,15,220
1052,472,25,673,710,2932,378,507,39,611,1486,3021,15,221
480,650,159,576,790,2655,240,976,162,744,941,3063,15,222
169,638,151,984,789,2731,110,1021,132,901,943,3107,15,223
104,321,18,849,567,1859,86,364,20,804,809,2083,15,224
804,416,9,540,685,2454,355,496,9,531,1281,2672,15,225
1258,457,7,653,887,3262,427,590,7,642,1812,3478,15,226
1179,514,8,727,846,3274,416,637,18,631,1701,3403,15,227
1114,532,16,645,959,3266,389,752,21,672,1700,3534,15,228
563,651,154,662,909,2939,250,958,97,685,1165,3155,15,229
116,668,156,953,764,2657,105,903,93,993,836,2930,15,230
84,375,10,822,591,1882,89,377,14,811,833,2124,15,231
801,342,13,487,682,2325,369,400,17,510,1207,2503,15,232
1331,471,5,599,852,3258,438,649,9,606,1843,3545,15,233
1217,555,4,644,810,3230,424,674,12,588,1784,3482,15,234
1120,575,8,667,797,3167,364,750,17,626,1659,3416,15,235
573,654,147,637,854,2865,255,938,96,643,1158,3090,15,236
160,643,111,999,844,2757,129,964,118,912,1021,3144,15,237
92,310,5,800,579,1786,89,362,15,833,777,2076,15,238
862,372,8,509,791,2542,336,593,11,563,1323,2826,15,239
1382,452,13,588,900,3335,441,776,20,572,1800,3609,15,240
1319,481,40,641,935,3416,439,743,47,623,1774,3626,15,241
1157,525,53,667,786,3188,376,646,57,589,1578,3246,15,242
513,550,71,659,884,2677,231,838,97,765,938,2869,15,243
106,579,85,949,721,2440,105,855,70,852,851,2733,15,244
101,475,14,937,637,2164,70,590,12,752,934,2358,15,245
89,334,17,732,509,1681,87,356,17,728,748,1936,15,246
1327,407,8,626,701,3069,393,556,12,611,1861,3433,15,247
1423,454,19,642,821,3359,412,648,23,641,1881,3605,15,248
1237,521,22,637,835,3252,392,711,23,602,1712,3440,15,249
654,769,120,579,798,2920,265,896,91,652,1289,3193,15,250
138,682,126,1072,836,2854,107,1071,128,1002,1066,3374,15,251
117,342,4,927,642,2032,90,373,8,921,828,2220,15,252
1010,436,13,527,719,2705,364,554,14,519,1444,2895,15,253
1545,494,14,639,856,3548,430,731,22,594,1956,3733,15,254
1394,507,7,692,936,3536,462,759,18,576,1923,3738,15,255
1355,551,7,693,951,3557,394,887,13,612,1796,3702,15,256
629,731,103,686,1038,3187,327,1112,107,675,1312,3533,15,257
136,783,147,1146,965,3177,125,1213,90,958,1057,3443,15,258
138,314,8,1046,622,2128,87,343,18,1048,964,2460,15,259
970,372,5,618,690,2655,344,548,13,550,1474,2929,15,260
1484,442,7,651,887,3471,454,669,12,586,1982,3703,15,261
1452,500,7,686,873,3518,414,710,18,615,2007,3764,15,262
1379,549,8,698,985,3619,374,927,15,672,1762,3750,15,263
720,790,95,698,851,3154,294,923,121,698,1329,3365,15,264
158,649,128,1048,892,2875,122,923,107,872,1020,3044,15,265
100,308,21,889,650,1968,99,382,18,845,815,2159,15,266
952,380,5,530,749,2616,344,473,9,525,1430,2781,15,267
1440,415,11,638,857,3361,417,672,18,548,1903,3558,15,268
1418,479,13,692,941,3543,388,809,14,602,1979,3792,15,269
1203,578,12,707,877,3377,384,806,16,605,1832,3643,15,270
664,627,109,656,951,3007,271,977,125,719,1226,3318,15,271
163,779,124,1538,1581,4185,147,1153,106,1832,1244,4482,15,272
83,304,16,934,593,1930,82,361,15,916,968,2342,15,273
923,375,13,629,715,2655,346,495,14,600,1399,2854,15,274
1457,434,15,596,811,3313,416,613,20,538,1918,3505,15,275
1378,467,21,729,892,3487,411,710,21,706,1991,3839,15,276
1337,544,22,734,896,3533,379,840,25,641,1834,3719,15,277
735,650,119,693,788,2985,269,879,80,693,1286,3207,15,278
145,610,117,1173,925,2970,81,936,99,930,1081,3127,15,279
111,332,7,952,630,2032,103,373,10,818,942,2246,15,280
992,388,1,559,660,2600,344,516,3,511,1404,2778,15,281
1602,551,5,663,847,3668,437,718,8,677,2070,3910,15,282
1462,560,8,710,894,3634,464,763,13,677,1962,3879,15,283
1275,492,8,692,955,3422,412,823,14,644,1739,3632,15,284
631,675,92,812,902,3112,265,887,110,721,1375,3358,15,285
201,633,132,1148,930,3044,113,931,96,903,1091,3134,15,286
221,402,5,1033,714,2375,94,550,16,1174,837,2671,15,287
501,385,14,803,704,2407,239,472,15,685,1140,2551,15,288
1532,453,10,708,849,3552,433,742,12,628,1968,3783,15,289
1535,497,13,750,861,3656,448,781,13,641,2029,3912,15,290
1370,536,9,737,1012,3664,420,965,22,646,1823,3876,15,291
673,805,132,668,936,3214,258,1002,119,701,1403,3483,15,292
178,621,122,1110,889,2920,107,974,154,998,1042,3275,15,293
104,367,4,1013,621,2109,100,496,10,951,904,2461,15,294
996,398,3,567,728,2692,324,554,9,568,1476,2931,15,295
1496,465,7,655,813,3436,414,693,7,590,2044,3748,15,296
1457,551,8,695,994,3705,439,859,15,620,2051,3984,15,297
1414,509,5,701,988,3617,391,903,16,664,1834,3808,15,298
728,696,101,770,832,3127,296,986,100,805,1319,3506,15,299
166,780,147,1058,871,3022,94,1148,131,975,1087,3435,15,300
593,378,5,1358,862,3196,164,446,10,1510,995,3125,15,301
983,348,3,606,769,2709,338,550,15,541,1519,2963,15,302
1476,497,3,695,1217,3888,451,1088,2,677,1925,4143,15,303
1480,509,2,701,1027,3719,448,767,11,616,2037,3879,15,304
1295,645,11,699,865,3515,386,941,52,673,1865,3917,15,305
643,802,228,665,795,3133,239,1143,113,666,1295,3456,15,306
113,887,187,1076,1074,3337,98,1190,132,955,1351,3726,15,307
119,334,2,904,627,1986,121,298,3,890,847,2159,15,308
997,370,14,561,775,2717,366,526,16,572,1516,2996,15,309
1133,387,8,559,803,2890,367,433,27,566,1605,2998,15,310
1211,418,11,604,827,3071,405,606,18,586,1666,3281,15,311
1320,509,10,652,892,3383,435,713,14,632,1834,3628,15,312
651,657,96,686,982,3072,342,917,93,726,1233,3311,15,313
139,658,117,1162,819,2895,101,841,80,1011,1154,3187,15,314
90,332,6,928,658,2014,86,272,9,878,998,2243,15,315
508,356,13,743,665,2285,225,412,15,762,1120,2534,15,316
1488,444,8,607,854,3401,437,636,10,618,2056,3757,15,317
1534,489,2,642,973,3640,478,823,11,568,2027,3907,15,318
1419,565,9,669,899,3561,450,749,14,671,1873,3757,15,319
688,678,97,709,895,3067,306,852,87,662,1365,3272,15,320
143,759,131,1177,905,3115,111,891,106,962,1286,3356,15,321
87,315,3,918,668,1991,88,347,5,913,812,2165,15,322
955,380,4,595,754,2688,378,534,8,573,1425,2918,15,323
1557,512,3,651,869,3592,461,667,7,616,2073,3824,15,324
1459,465,6,656,871,3457,435,662,7,562,1984,3650,15,325
1339,524,7,726,990,3586,432,759,20,698,1890,3799,15,326
662,591,96,594,832,2775,303,807,79,583,1204,2976,15,327
134,576,142,1050,973,2875,87,849,131,994,950,3011,15,328
81,264,2,891,570,1808,83,280,5,773,777,1918,15,329
808,320,15,605,575,2323,305,420,17,513,1079,2334,15,330
800,371,4,624,859,2658,296,480,8,631,1312,2727,15,331
485,395,26,690,680,2276,194,592,10,796,892,2484,15,332
84,118,5,270,166,643,49,133,8,223,243,656,15,333
138,292,48,719,432,1629,121,409,37,612,752,1931,15,334
68,362,62,687,562,1741,91,520,48,685,703,2047,15,335
71,273,7,634,518,1503,84,324,8,666,737,1819,15,336
910,309,5,525,719,2468,351,448,4,548,1443,2794,15,337
1420,417,4,651,920,3412,443,709,11,617,1951,3731,15,338
1422,464,13,678,901,3478,467,645,23,617,1908,3660,15,339
1302,579,11,653,1029,3574,395,761,20,607,1894,3677,15,340
696,720,101,658,892,3067,373,909,86,732,1413,3513,15,341
111,752,122,1159,1071,3215,98,1077,104,1074,1144,3497,15,342
100,292,7,998,821,2218,84,410,15,895,912,2316,15,343
933,443,8,531,752,2667,352,513,17,495,1537,2914,15,344
1473,475,12,683,894,3537,412,789,20,639,2017,3877,15,345
1392,500,6,628,840,3366,433,732,11,621,1823,3620,15,346
1305,597,19,739,1044,3704,532,896,41,663,1871,4003,15,347
632,808,111,710,1017,3278,287,986,122,729,1390,3514,15,348
197,635,103,1291,1106,3332,103,1054,99,1185,1209,3650,15,349
100,266,4,884,638,1892,103,349,7,843,809,2111,15,350
851,344,1,542,716,2454,355,473,2,540,1392,2762,15,351
1334,473,7,716,938,3468,443,689,12,627,1964,3735,15,352
1178,518,9,675,902,3282,413,649,9,612,1795,3478,15,353
1043,584,11,671,940,3249,353,756,15,649,1601,3374,15,354
490,465,116,620,725,2416,340,635,79,683,964,2701,15,355
106,446,82,793,620,2047,103,531,46,751,662,2093,15,356
88,244,12,657,456,1457,112,231,17,658,515,1533,15,357
269,272,12,484,527,1564,199,243,15,570,626,1653,15,358
167,124,3,413,317,1024,166,121,9,414,347,1057,15,359
54,82,2,149,109,396,35,104,4,160,144,447,15,360
195,208,10,385,412,1210,172,210,7,508,526,1423,15,361
184,336,67,502,455,1544,176,366,43,515,595,1695,15,362
93,319,82,431,396,1321,98,390,63,529,442,1522,15,363
74,249,11,498,492,1324,81,231,28,616,550,1506,15,364
286,264,9,548,542,1649,188,344,6,558,801,1897,15,365
297,661,843,682,509,2992,148,1053,489,685,920,3295,15,366
44,108,0,332,241,725,54,141,2,336,284,817,16,1
637,182,10,505,381,1715,131,268,15,406,930,1750,16,2
838,172,7,532,446,1995,170,359,12,402,1115,2058,16,3
861,165,4,517,453,2000,168,382,10,394,1044,1998,16,4
501,297,16,503,591,1908,157,467,17,423,857,1921,16,5
92,224,23,584,339,1262,56,302,22,447,367,1194,16,6
80,157,6,625,375,1243,47,217,9,549,512,1334,16,7
727,172,8,481,574,1962,179,389,10,397,989,1964,16,8
1009,187,7,434,318,1955,201,280,21,394,1046,1942,16,9
1063,303,2,619,542,2529,205,515,9,412,1302,2443,16,10
939,219,11,542,598,2309,192,507,16,410,1185,2310,16,11
538,276,19,571,642,2046,190,342,19,453,919,1923,16,12
115,312,30,898,529,1884,78,399,44,651,797,1969,16,13
71,207,3,642,463,1386,43,297,11,613,476,1440,16,14
130,203,4,561,328,1226,55,270,7,497,491,1320,16,15
354,184,4,401,379,1322,112,314,7,324,546,1303,16,16
940,226,5,695,480,2346,142,480,10,414,1225,2271,16,17
1047,234,7,553,585,2426,201,616,15,414,1184,2430,16,18
346,364,9,483,498,1700,118,442,29,393,627,1609,16,19
122,269,12,827,509,1739,59,387,31,647,579,1703,16,20
86,163,13,648,389,1299,58,271,16,495,470,1310,16,21
792,197,4,566,470,2029,180,400,4,398,1070,2052,16,22
1169,238,15,645,542,2609,215,554,12,430,1416,2627,16,23
1169,251,3,586,540,2549,211,556,11,415,1360,2553,16,24
1033,204,4,549,546,2336,191,606,10,380,1166,2353,16,25
572,401,20,685,722,2400,185,607,44,554,918,2308,16,26
119,366,26,960,586,2057,80,471,40,857,698,2146,16,27
84,182,10,763,368,1407,60,241,12,586,549,1448,16,28
817,183,5,553,495,2053,189,406,8,418,1062,2083,16,29
1173,199,4,599,539,2514,201,524,7,399,1387,2518,16,30
1120,216,12,618,577,2543,195,542,14,417,1339,2507,16,31
1021,263,2,604,543,2433,213,556,10,450,1136,2365,16,32
599,368,27,619,652,2265,237,531,59,434,915,2176,16,33
13,3,3,1,13,33,18,5,4,3,9,39,16,34
3,3,4,4,6,20,5,9,8,3,3,28,16,35
816,169,1,546,483,2015,196,408,6,399,1010,2019,16,36
1178,216,8,612,530,2544,205,549,9,424,1392,2579,16,37
1141,256,12,636,572,2617,225,608,20,436,1403,2692,16,38
1025,244,9,602,574,2454,210,540,8,437,1233,2428,16,39
640,372,18,628,660,2318,232,486,45,546,943,2252,16,40
120,334,25,1002,707,2188,105,454,66,876,656,2157,16,41
89,175,8,662,458,1392,59,283,14,508,580,1444,16,42
765,176,14,506,502,1963,206,433,17,361,1021,2038,16,43
1079,238,0,600,587,2504,190,612,4,382,1294,2482,16,44
1092,307,1,636,619,2655,217,551,4,483,1434,2689,16,45
1036,253,2,617,598,2506,203,571,8,444,1226,2452,16,46
560,369,14,628,653,2224,177,533,38,490,832,2070,16,47
121,281,16,766,503,1687,52,337,41,672,581,1683,16,48
83,174,7,683,504,1451,46,275,9,655,515,1500,16,49
190,170,4,659,434,1457,85,339,5,568,581,1578,16,50
1044,210,0,549,540,2343,232,506,2,416,1307,2463,16,51
1172,231,4,613,596,2616,214,568,4,476,1244,2506,16,52
999,227,2,590,613,2431,219,595,7,445,1161,2427,16,53
574,392,14,589,654,2223,207,557,39,465,881,2149,16,54
107,313,20,890,589,1919,77,411,48,669,722,1927,16,55
85,160,11,696,486,1438,62,331,11,635,489,1528,16,56
822,214,2,547,511,2096,209,495,1,414,985,2104,16,57
1184,252,8,646,516,2606,204,588,12,436,1376,2616,16,58
1109,219,1,594,520,2443,197,542,5,427,1296,2467,16,59
1008,255,2,660,609,2534,212,577,7,450,1218,2464,16,60
599,431,12,566,700,2308,200,645,37,505,933,2320,16,61
112,326,30,754,670,1892,62,423,57,598,674,1814,16,62
93,160,11,782,553,1599,88,270,14,773,565,1710,16,63
824,223,0,535,538,2120,205,469,4,456,1063,2197,16,64
1164,260,6,593,598,2621,209,620,3,423,1407,2662,16,65
1100,280,6,649,589,2624,207,647,10,414,1352,2630,16,66
985,263,12,638,656,2554,225,615,33,510,1238,2621,16,67
611,405,20,710,814,2560,229,600,48,648,1009,2534,16,68
136,257,12,875,539,1819,152,406,35,636,611,1840,16,69
93,168,6,676,496,1439,57,282,12,629,557,1537,16,70
786,206,2,527,530,2051,203,449,3,447,1001,2103,16,71
1112,325,1,664,593,2695,235,615,6,583,1362,2801,16,72
1083,301,1,784,676,2845,278,626,9,655,1370,2938,16,73
961,278,12,796,721,2768,244,627,32,667,1260,2830,16,74
560,382,20,717,785,2464,247,571,58,675,958,2509,16,75
233,465,12,1111,833,2654,149,603,39,1244,775,2810,16,76
99,214,10,776,569,1668,67,356,13,770,622,1828,16,77
816,243,3,607,571,2240,207,473,3,528,1132,2343,16,78
1150,291,0,702,609,2752,204,664,2,593,1348,2811,16,79
1110,312,7,769,728,2926,211,718,12,510,1387,2838,16,80
1093,307,6,672,633,2711,213,684,7,591,1247,2742,16,81
661,451,18,767,762,2659,226,606,52,708,998,2590,16,82
100,555,43,765,644,2107,85,697,52,524,672,2030,16,83
118,287,4,1099,637,2145,99,369,7,955,734,2164,16,84
800,249,0,689,693,2431,182,524,5,866,1076,2653,16,85
1095,281,14,719,778,2887,202,610,11,909,1415,3147,16,86
1033,251,2,633,528,2447,168,599,4,468,1246,2485,16,87
921,331,3,690,604,2549,170,601,8,622,1222,2623,16,88
491,452,6,951,1045,2945,238,588,38,1419,1009,3292,16,89
130,476,16,1260,865,2747,130,592,44,1342,890,2998,16,90
94,201,9,857,626,1787,145,277,13,1034,616,2085,16,91
744,222,5,708,632,2311,202,547,16,594,985,2344,16,92
1134,239,3,686,570,2632,212,602,6,541,1367,2728,16,93
1080,268,6,605,614,2573,219,620,10,472,1261,2582,16,94
1096,341,1,748,877,3063,281,731,7,893,1332,3244,16,95
641,467,10,930,936,2984,260,636,34,1043,1010,2983,16,96
183,350,12,1071,774,2390,127,462,51,1210,774,2624,16,97
253,191,7,914,579,1944,92,365,10,877,623,1967,16,98
791,245,6,667,535,2244,198,474,13,513,1061,2259,16,99
1136,341,27,666,633,2803,258,657,33,609,1423,2980,16,100
1106,231,4,826,652,2819,234,616,8,671,1340,2869,16,101
1061,236,3,679,641,2620,220,624,7,491,1236,2578,16,102
637,424,27,676,804,2568,240,578,50,605,1086,2559,16,103
183,401,23,977,901,2485,126,558,45,1115,750,2594,16,104
102,229,4,972,791,2098,135,361,9,1166,681,2352,16,105
797,213,3,653,608,2274,265,550,3,553,1019,2390,16,106
1049,291,4,725,714,2783,234,667,7,591,1292,2791,16,107
1093,269,6,708,654,2730,241,645,9,588,1285,2768,16,108
996,345,0,677,673,2691,261,697,5,556,1155,2674,16,109
574,317,16,759,839,2505,217,550,39,702,934,2442,16,110
152,379,19,1135,885,2570,165,641,60,1035,780,2681,16,111
113,176,6,748,506,1549,86,339,8,736,544,1713,16,112
755,262,0,551,584,2152,284,437,7,519,1012,2259,16,113
1079,246,16,655,647,2643,215,632,16,521,1303,2687,16,114
1084,255,9,721,679,2748,295,703,14,560,1302,2874,16,115
999,269,3,668,698,2637,216,684,3,536,1215,2654,16,116
610,388,16,649,930,2593,212,702,42,634,974,2564,16,117
136,325,13,839,578,1891,140,467,52,820,546,2025,16,118
105,200,0,804,655,1764,101,376,17,924,609,2027,16,119
813,252,4,580,610,2259,224,481,6,520,1067,2298,16,120
1105,244,3,631,578,2561,242,556,9,538,1319,2664,16,121
1093,261,0,701,660,2715,243,633,5,585,1336,2802,16,122
1030,308,17,767,663,2785,328,712,26,598,1277,2941,16,123
581,446,16,746,877,2666,284,654,34,700,981,2653,16,124
159,263,29,882,626,1959,116,457,54,781,658,2066,16,125
103,177,4,780,374,1438,59,286,5,642,486,1478,16,126
833,213,6,560,532,2144,252,493,8,457,1056,2266,16,127
1151,277,6,662,692,2788,236,679,9,573,1344,2841,16,128
1115,311,3,710,719,2858,254,705,9,583,1356,2907,16,129
934,296,4,664,695,2593,208,622,6,521,1203,2560,16,130
561,433,14,646,689,2343,375,523,29,605,981,2513,16,131
151,321,10,1026,825,2333,103,389,54,1135,698,2379,16,132
102,175,4,704,508,1493,69,343,8,730,479,1629,16,133
795,246,2,590,621,2254,211,503,11,558,1140,2423,16,134
1095,274,9,675,575,2628,253,547,12,585,1407,2804,16,135
1086,289,3,685,625,2688,225,625,8,482,1291,2631,16,136
989,343,6,695,678,2711,213,689,6,537,1239,2684,16,137
592,401,21,719,823,2556,245,542,44,677,1011,2519,16,138
133,322,44,792,537,1828,79,478,35,637,644,1873,16,139
117,251,4,927,532,1831,105,327,6,885,673,1996,16,140
803,232,2,680,621,2338,233,508,4,609,1037,2391,16,141
1091,358,0,672,669,2790,234,650,3,534,1425,2846,16,142
1110,275,0,676,663,2724,254,593,6,546,1325,2724,16,143
944,289,6,622,639,2500,235,532,3,505,1161,2436,16,144
554,352,9,799,783,2497,259,558,40,878,863,2598,16,145
134,332,9,931,796,2202,153,556,25,1019,648,2401,16,146
114,262,2,893,551,1822,150,350,16,943,576,2035,16,147
92,172,1,512,340,1117,92,251,11,503,434,1291,16,148
1022,277,6,620,573,2498,239,522,16,528,1255,2560,16,149
1036,249,4,638,585,2512,271,533,7,517,1260,2588,16,150
989,327,2,700,705,2723,255,598,12,648,1215,2728,16,151
592,382,18,669,783,2444,234,565,27,668,918,2412,16,152
125,389,17,903,782,2216,188,541,49,1063,622,2463,16,153
95,205,3,801,700,1804,92,326,2,1014,563,1997,16,154
869,246,3,577,622,2317,210,531,7,649,1122,2519,16,155
1138,270,3,713,591,2715,260,652,5,623,1344,2884,16,156
1146,277,4,735,564,2726,276,565,8,573,1299,2721,16,157
1021,315,0,738,697,2771,358,685,10,577,1243,2873,16,158
635,485,13,874,922,2929,241,770,61,839,979,2890,16,159
131,428,9,1394,903,2865,180,865,55,1101,821,3022,16,160
114,229,5,905,637,1890,125,421,11,959,677,2193,16,161
854,254,2,683,533,2326,257,457,3,580,1161,2458,16,162
1130,345,2,735,616,2828,254,737,8,644,1414,3057,16,163
1134,317,3,913,669,3036,225,716,21,770,1346,3078,16,164
1014,336,0,751,604,2705,244,623,13,666,1190,2736,16,165
632,415,13,677,763,2500,227,712,53,686,885,2563,16,166
138,388,8,1066,821,2421,184,574,34,974,703,2469,16,167
117,206,6,780,569,1678,104,334,13,828,553,1832,16,168
865,251,6,605,504,2231,232,501,13,615,1064,2425,16,169
1085,304,29,679,666,2763,229,654,35,631,1306,2855,16,170
295,285,7,786,672,2045,214,493,12,792,765,2276,16,171
954,310,7,697,577,2545,237,620,16,558,1197,2628,16,172
553,378,16,661,626,2234,217,565,41,631,794,2248,16,173
142,418,26,823,505,1914,164,550,81,640,544,1979,16,174
115,161,12,650,499,1437,141,292,9,614,497,1553,16,175
822,252,6,527,518,2125,216,465,18,519,991,2209,16,176
1119,338,7,649,550,2663,240,631,10,547,1316,2744,16,177
1100,284,9,705,627,2725,235,589,14,574,1309,2721,16,178
974,393,32,667,639,2705,288,632,23,598,1300,2841,16,179
687,436,22,773,706,2624,332,688,40,842,939,2841,16,180
129,386,34,874,725,2148,138,477,52,890,643,2200,16,181
113,199,16,659,415,1402,141,283,27,622,570,1643,16,182
751,266,17,668,646,2348,289,484,20,697,1081,2571,16,183
935,274,8,697,633,2547,238,573,12,668,1268,2759,16,184
737,284,4,721,777,2523,212,552,13,702,1055,2534,16,185
130,311,11,790,488,1730,105,615,24,793,374,1911,16,186
306,335,11,682,635,1969,170,479,21,694,737,2101,16,187
118,273,15,820,521,1747,139,402,47,824,568,1980,16,188
103,174,9,661,381,1328,109,304,10,592,471,1486,16,189
774,236,9,577,507,2103,250,513,14,495,991,2263,16,190
1047,290,8,661,516,2522,247,604,13,537,1272,2673,16,191
997,287,6,626,577,2493,236,540,14,512,1311,2613,16,192
949,302,11,715,630,2607,240,616,18,596,1185,2655,16,193
600,416,24,627,602,2269,216,588,45,600,883,2332,16,194
153,397,25,875,680,2130,122,533,47,888,650,2240,16,195
111,194,12,773,449,1539,111,340,14,753,521,1739,16,196
802,248,6,520,418,1994,202,435,7,458,1004,2106,16,197
977,308,10,590,536,2421,218,612,17,464,1218,2529,16,198
1044,244,13,585,516,2402,218,527,17,464,1216,2442,16,199
953,265,6,669,569,2462,227,589,11,601,1133,2561,16,200
579,438,17,700,780,2514,220,652,123,682,920,2597,16,201
123,313,20,845,778,2079,146,523,52,1001,578,2300,16,202
134,207,14,846,552,1753,122,303,15,879,570,1889,16,203
761,248,13,582,446,2050,202,456,12,516,965,2151,16,204
1080,293,14,742,634,2763,240,675,30,642,1354,2941,16,205
1028,283,29,700,593,2633,213,641,28,627,1213,2722,16,206
944,312,16,690,670,2632,229,606,30,545,1187,2597,16,207
600,411,27,715,777,2530,236,569,53,709,983,2550,16,208
135,330,25,921,801,2212,126,536,73,1019,681,2435,16,209
125,208,34,728,526,1621,94,353,54,820,498,1819,16,210
800,238,55,604,562,2259,240,455,78,610,1036,2419,16,211
1049,271,46,666,545,2577,203,561,42,576,1304,2686,16,212
995,266,28,742,543,2574,790,535,29,874,1159,3387,16,213
890,248,16,649,567,2370,229,588,16,548,1113,2494,16,214
578,415,21,601,611,2226,221,512,39,613,842,2227,16,215
147,295,6,909,602,1959,135,398,43,838,616,2030,16,216
136,196,20,679,435,1466,117,292,15,771,477,1672,16,217
697,277,16,563,474,2027,214,476,23,537,937,2187,16,218
990,276,37,616,572,2491,223,604,36,528,1189,2580,16,219
1115,329,52,691,563,2750,206,525,50,521,1160,2462,16,220
922,259,17,619,546,2363,166,440,15,432,1046,2099,16,221
453,344,20,558,595,1970,150,456,69,392,649,1716,16,222
159,371,21,991,714,2256,118,462,47,793,628,2048,16,223
135,189,13,769,581,1687,116,315,19,766,548,1764,16,224
849,315,12,664,511,2351,187,457,13,531,971,2159,16,225
1070,294,12,717,626,2719,212,537,10,547,1215,2521,16,226
1054,316,10,696,625,2701,177,538,9,522,1161,2407,16,227
963,315,16,703,638,2635,224,581,25,548,1023,2401,16,228
603,439,22,762,721,2547,224,569,49,609,812,2263,16,229
155,407,25,905,664,2156,118,426,41,834,615,2034,16,230
111,200,7,738,458,1514,81,265,10,688,526,1570,16,231
849,230,10,677,548,2314,212,395,14,522,972,2115,16,232
1066,288,10,658,677,2699,202,586,16,669,1137,2610,16,233
1075,257,21,744,715,2812,207,533,29,639,1188,2596,16,234
926,281,7,786,639,2639,210,500,8,572,1155,2445,16,235
595,352,11,786,606,2350,190,538,40,632,843,2243,16,236
157,315,18,958,739,2187,121,519,53,948,723,2364,16,237
102,192,11,796,484,1585,80,298,16,846,564,1804,16,238
745,205,8,561,533,2052,189,491,10,458,983,2131,16,239
1030,272,7,663,627,2599,268,610,5,487,1332,2702,16,240
997,243,6,624,610,2480,244,613,7,459,1205,2528,16,241
900,223,5,627,583,2338,246,465,10,465,1102,2288,16,242
546,325,22,625,673,2191,213,499,55,575,818,2160,16,243
122,332,13,831,613,1911,128,445,38,872,564,2047,16,244
116,238,7,841,564,1766,93,383,12,909,608,2005,16,245
83,180,7,671,510,1451,110,306,12,841,516,1785,16,246
1061,514,8,631,517,2731,219,748,12,517,1358,2854,16,247
1097,271,12,683,562,2625,258,593,12,514,1330,2707,16,248
1045,258,10,619,665,2597,240,654,11,447,1253,2605,16,249
670,365,25,618,660,2338,250,531,50,565,924,2320,16,250
166,321,16,1068,707,2278,129,530,64,892,689,2304,16,251
120,195,7,832,597,1751,108,302,3,989,578,1980,16,252
910,237,7,545,529,2228,252,515,9,435,1106,2317,16,253
1206,296,2,653,548,2705,256,623,4,488,1473,2844,16,254
1147,288,0,704,677,2816,252,722,8,541,1384,2907,16,255
1145,286,3,709,682,2825,240,701,10,572,1257,2780,16,256
645,432,17,650,896,2640,224,653,59,604,992,2532,16,257
152,392,18,1058,812,2432,112,579,66,976,766,2499,16,258
143,187,5,858,586,1779,108,302,12,871,671,1964,16,259
902,211,4,574,604,2295,238,553,8,455,1098,2352,16,260
1209,273,5,645,572,2704,243,587,7,472,1517,2826,16,261
1112,249,17,700,603,2681,226,663,19,434,1313,2655,16,262
1151,274,4,684,726,2839,259,774,14,518,1257,2822,16,263
637,405,19,712,688,2461,248,594,44,577,932,2395,16,264
183,337,16,1136,722,2394,160,514,41,979,679,2373,16,265
120,145,3,793,512,1573,86,293,4,769,574,1726,16,266
895,231,2,589,526,2243,210,477,3,493,1156,2339,16,267
1183,274,9,648,552,2666,228,650,11,418,1398,2705,16,268
1144,249,0,623,662,2678,223,704,8,406,1348,2689,16,269
1021,249,8,709,696,2683,250,687,30,487,1230,2684,16,270
646,535,48,657,716,2602,229,743,44,527,1064,2607,16,271
175,439,25,1038,835,2512,116,788,51,920,745,2620,16,272
126,193,11,846,489,1665,84,286,17,720,644,1751,16,273
868,244,5,552,594,2263,232,545,10,416,1166,2369,16,274
1211,219,3,622,529,2584,262,644,4,401,1348,2659,16,275
1144,431,2,738,595,2910,249,643,4,520,1507,2923,16,276
958,252,12,1203,695,3120,388,630,13,856,1259,3146,16,277
567,361,19,825,785,2557,307,580,51,706,919,2563,16,278
137,329,17,986,708,2177,106,567,35,944,677,2329,16,279
135,195,5,715,541,1591,74,307,4,839,593,1817,16,280
892,197,2,639,631,2361,239,500,1,524,1160,2424,16,281
1246,249,1,680,619,2795,240,643,3,574,1412,2872,16,282
1181,258,3,730,663,2835,245,633,7,547,1432,2864,16,283
969,268,1,713,715,2666,216,696,11,559,1166,2648,16,284
611,854,16,742,788,3011,207,722,31,678,1265,2903,16,285
153,420,12,1277,963,2825,214,559,43,1476,792,3084,16,286
148,219,1,854,655,1877,93,418,6,1106,562,2185,16,287
322,202,3,768,614,1909,177,395,7,797,789,2165,16,288
1147,214,5,663,616,2645,236,714,7,467,1466,2890,16,289
1149,260,2,736,630,2777,225,627,9,531,1441,2833,16,290
1038,304,8,763,707,2820,207,704,9,554,1308,2782,16,291
666,465,28,840,802,2801,246,683,53,769,1187,2938,16,292
163,502,17,1025,837,2544,145,566,71,1104,953,2839,16,293
122,261,18,846,602,1849,61,419,11,914,737,2142,16,294
864,211,5,617,579,2276,246,490,3,474,1222,2435,16,295
1176,270,19,696,647,2808,233,615,15,525,1491,2879,16,296
1200,252,3,729,729,2913,244,676,9,547,1394,2870,16,297
1105,358,9,722,679,2873,229,737,10,552,1433,2961,16,298
678,518,33,758,796,2783,243,769,47,669,1151,2879,16,299
185,374,20,976,741,2296,121,512,73,1015,704,2425,16,300
215,224,13,796,600,1848,82,353,19,929,672,2055,16,301
868,247,3,673,585,2376,223,541,3,481,1190,2438,16,302
1154,257,2,696,983,3092,234,1026,2,505,1404,3171,16,303
1216,311,6,719,704,2956,257,736,4,480,1475,2952,16,304
1035,279,9,689,653,2665,208,557,9,523,1388,2685,16,305
628,478,29,693,784,2612,201,657,50,633,1035,2576,16,306
174,373,23,911,858,2339,126,604,52,1032,766,2580,16,307
140,144,0,848,601,1733,126,259,2,965,584,1936,16,308
883,226,6,623,619,2357,262,475,7,575,1192,2511,16,309
959,273,8,703,647,2590,287,398,32,656,1254,2627,16,310
921,275,3,653,584,2436,251,517,6,486,1229,2489,16,311
1061,254,8,675,657,2655,268,596,13,515,1283,2675,16,312
684,446,35,724,853,2742,272,606,34,674,1086,2672,16,313
176,352,11,1195,1056,2790,138,443,41,1386,834,2842,16,314
121,166,2,931,544,1764,84,285,2,847,749,1967,16,315
391,179,2,744,594,1910,184,402,6,834,756,2182,16,316
1205,234,20,666,604,2729,252,613,19,476,1493,2853,16,317
1257,276,13,716,681,2943,253,717,13,479,1496,2958,16,318
1107,287,7,707,642,2750,274,657,9,479,1328,2747,16,319
694,404,16,695,763,2572,248,585,56,592,1050,2531,16,320
161,350,12,1127,738,2388,155,488,39,957,838,2477,16,321
123,194,2,868,554,1741,104,353,6,783,659,1905,16,322
895,190,5,615,602,2307,231,485,3,469,1178,2366,16,323
1264,257,5,632,637,2795,233,619,7,507,1543,2909,16,324
1225,273,2,719,656,2875,244,631,4,489,1506,2874,16,325
1138,297,37,711,709,2892,245,731,30,516,1394,2916,16,326
677,396,15,634,718,2440,245,594,32,500,992,2363,16,327
171,440,12,905,727,2255,98,497,34,767,840,2236,16,328
103,206,4,783,554,1650,76,295,5,808,609,1793,16,329
789,204,0,610,595,2198,227,410,5,556,1033,2231,16,330
829,245,2,672,663,2411,223,457,1,528,1104,2313,16,331
474,173,6,657,574,1884,150,346,7,635,639,1777,16,332
100,114,2,355,186,757,55,165,3,295,218,736,16,333
166,256,8,623,428,1481,87,313,10,619,811,1840,16,334
103,247,16,707,470,1543,67,355,22,630,730,1804,16,335
96,201,2,628,351,1278,55,299,2,562,603,1521,16,336
852,155,3,640,560,2210,201,459,3,446,1093,2202,16,337
1224,256,5,822,668,2975,240,650,6,553,1486,2935,16,338
1236,276,4,814,654,2984,253,623,11,539,1419,2845,16,339
1065,237,5,837,677,2821,236,714,15,562,1387,2914,16,340
714,538,18,749,766,2785,231,600,50,557,1178,2616,16,341
138,614,23,1085,804,2664,79,652,51,838,1026,2646,16,342
140,327,2,879,604,1952,69,403,5,706,902,2085,16,343
916,259,4,654,610,2443,242,552,5,454,1149,2402,16,344
1249,287,16,798,681,3031,239,719,22,519,1538,3037,16,345
1254,242,7,705,624,2832,246,667,7,457,1345,2722,16,346
1142,335,5,777,781,3040,239,750,11,550,1476,3026,16,347
667,581,15,795,819,2877,262,683,59,591,1292,2887,16,348
157,572,27,1122,849,2727,79,662,71,870,1158,2840,16,349
121,228,2,793,530,1674,53,364,5,600,728,1750,16,350
872,217,2,642,586,2319,228,493,4,490,1097,2312,16,351
1175,305,3,690,672,2845,233,694,8,482,1439,2856,16,352
1084,277,9,681,704,2755,251,588,9,486,1285,2619,16,353
893,373,5,690,716,2677,222,618,7,495,1346,2688,16,354
536,390,12,631,745,2314,197,535,31,512,955,2230,16,355
139,344,16,792,522,1813,77,356,25,599,745,1802,16,356
74,242,7,518,359,1200,39,269,13,431,542,1294,16,357
355,287,2,608,446,1698,134,268,2,480,766,1650,16,358
183,118,0,453,232,986,93,147,0,385,301,926,16,359
38,75,1,178,136,428,10,78,0,157,188,433,16,360
178,222,0,474,322,1196,87,258,2,437,599,1383,16,361
191,293,8,523,388,1403,114,296,9,540,699,1658,16,362
74,274,9,550,327,1234,42,307,25,449,481,1304,16,363
73,177,9,501,372,1132,62,220,13,533,488,1316,16,364
343,321,1,638,544,1847,141,366,4,741,926,2178,16,365
286,308,110,636,396,1736,150,292,182,620,629,1873,16,366
42,37,3,196,109,387,34,140,3,146,176,499,17,1
463,217,6,282,338,1306,207,189,20,219,660,1295,17,2
600,79,7,352,505,1543,260,323,11,246,634,1474,17,3
582,111,7,352,389,1441,256,241,7,271,582,1357,17,4
429,112,16,363,514,1434,203,345,34,234,497,1313,17,5
100,103,8,263,186,660,45,184,36,187,186,638,17,6
67,52,3,416,156,694,31,182,16,140,351,720,17,7
571,95,2,351,472,1491,280,294,9,232,592,1407,17,8
695,51,0,321,286,1353,284,163,3,271,619,1340,17,9
761,87,1,350,468,1667,286,291,6,296,764,1643,17,10
730,192,2,379,479,1782,305,339,14,295,802,1755,17,11
487,137,6,340,435,1405,254,216,43,235,526,1274,17,12
142,107,4,712,282,1247,48,310,36,198,559,1151,17,13
89,59,4,339,180,671,34,177,15,210,274,710,17,14
148,91,18,269,170,696,98,203,15,165,275,756,17,15
228,58,4,230,227,747,124,205,14,183,277,803,17,16
603,94,3,335,428,1463,284,254,6,264,627,1435,17,17
707,137,7,394,609,1854,322,447,9,294,684,1756,17,18
260,107,11,285,229,892,135,182,44,166,326,853,17,19
109,103,16,373,299,900,42,298,44,212,301,897,17,20
73,82,3,350,280,788,45,257,16,302,300,920,17,21
627,101,3,392,467,1590,270,312,12,344,823,1761,17,22
799,138,10,470,579,1996,339,460,9,418,1057,2283,17,23
853,190,3,406,731,2183,389,433,15,445,849,2131,17,24
732,194,4,391,692,2013,391,422,22,386,703,1924,17,25
589,550,15,594,888,2636,297,582,169,425,717,2190,17,26
162,254,15,1058,654,2143,66,700,112,411,783,2072,17,27
99,115,12,533,262,1021,36,331,23,281,431,1102,17,28
665,124,11,404,570,1774,400,232,7,393,709,1741,17,29
844,169,8,396,650,2067,403,298,12,403,825,1941,17,30
846,196,2,402,778,2224,398,475,12,413,861,2159,17,31
775,226,3,407,637,2048,372,354,11,410,775,1922,17,32
598,406,8,513,948,2473,316,607,123,358,688,2092,17,33
173,390,11,1047,480,2101,57,603,126,374,870,2030,17,34
89,104,6,608,300,1107,33,347,17,269,517,1183,17,35
700,155,0,356,579,1790,383,236,10,421,752,1802,17,36
869,244,3,390,692,2198,403,426,14,436,923,2202,17,37
895,179,2,411,685,2172,413,408,10,398,856,2085,17,38
785,219,16,411,712,2143,420,360,19,405,821,2025,17,39
602,444,9,545,847,2447,316,544,136,419,730,2145,17,40
166,281,13,1014,613,2087,62,708,107,295,744,1916,17,41
94,91,2,591,265,1043,28,298,28,241,558,1153,17,42
679,165,3,386,584,1817,357,291,14,429,743,1834,17,43
832,206,4,398,740,2180,373,462,23,401,799,2058,17,44
866,314,6,455,875,2516,435,647,40,385,986,2493,17,45
801,228,5,461,686,2181,407,382,18,422,777,2006,17,46
530,312,9,613,895,2359,315,549,91,429,683,2067,17,47
158,353,10,865,510,1896,64,543,87,395,715,1804,17,48
132,122,5,706,287,1252,46,376,19,299,616,1356,17,49
220,175,4,433,491,1323,260,225,21,416,384,1306,17,50
800,193,8,421,787,2209,414,492,30,425,829,2190,17,51
866,202,23,396,632,2119,427,325,33,391,891,2067,17,52
773,209,15,451,713,2161,375,420,38,419,787,2039,17,53
662,349,7,600,856,2474,289,602,99,419,807,2216,17,54
194,324,13,981,623,2135,79,697,126,335,747,1984,17,55
122,99,4,654,292,1171,36,362,14,269,559,1240,17,56
717,179,4,414,701,2015,400,415,17,412,724,1968,17,57
923,171,3,396,705,2198,416,419,12,439,883,2169,17,58
904,244,6,404,627,2185,446,300,12,419,969,2146,17,59
800,248,3,448,668,2167,429,391,14,438,859,2131,17,60
638,349,9,564,1037,2597,343,683,120,406,753,2305,17,61
161,376,8,884,530,1959,53,578,116,267,679,1693,17,62
138,134,2,822,400,1496,46,351,15,463,619,1494,17,63
695,185,2,407,643,1932,390,321,8,378,777,1874,17,64
843,191,5,380,639,2058,414,370,14,369,889,2056,17,65
882,177,6,450,642,2157,426,405,33,448,835,2147,17,66
826,344,7,502,740,2419,408,558,47,513,828,2354,17,67
608,481,19,609,930,2647,342,646,118,438,777,2321,17,68
178,316,11,927,539,1971,92,659,111,359,655,1876,17,69
152,203,2,806,313,1476,60,446,6,349,704,1565,17,70
737,175,6,461,586,1965,377,350,12,414,779,1932,17,71
948,231,2,487,685,2353,400,459,13,433,979,2284,17,72
957,225,2,570,824,2578,431,552,18,460,1041,2502,17,73
871,356,6,690,960,2883,399,675,50,543,1012,2679,17,74
708,339,15,945,973,2980,306,460,104,404,778,2052,17,75
376,273,7,1164,566,2386,64,737,97,399,705,2002,17,76
135,145,5,576,352,1213,35,422,22,232,447,1158,17,77
727,110,9,496,427,1769,225,403,14,265,811,1718,17,78
944,94,7,594,452,2091,248,465,19,322,956,2010,17,79
887,139,2,688,635,2351,301,612,21,335,1071,2340,17,80
824,157,3,560,547,2091,295,637,30,303,844,2109,17,81
619,163,8,656,663,2109,259,664,42,345,812,2122,17,82
149,240,9,527,429,1354,41,591,98,197,465,1392,17,83
176,141,2,1131,427,1877,43,1008,8,506,1073,2638,17,84
770,207,4,809,906,2696,437,553,203,585,1075,2853,17,85
948,194,1,756,830,2729,419,633,11,472,1182,2717,17,86
947,190,11,529,670,2347,412,463,20,453,1010,2358,17,87
798,268,9,598,682,2355,373,462,16,446,1009,2306,17,88
663,431,11,1088,1139,3332,317,923,153,531,1117,3041,17,89
306,265,9,1898,883,3361,72,1111,120,487,1401,3191,17,90
160,132,5,999,368,1664,36,556,21,329,755,1697,17,91
698,222,4,708,590,2222,336,515,23,438,942,2254,17,92
917,206,5,620,686,2434,389,465,11,458,1099,2422,17,93
918,183,2,552,684,2339,378,485,11,425,1055,2354,17,94
919,281,4,790,793,2787,415,600,25,507,1147,2694,17,95
654,473,8,848,1101,3084,320,905,148,430,938,2741,17,96
284,357,7,1480,966,3094,87,1109,141,461,1050,2848,17,97
270,112,3,1158,437,1980,54,700,14,433,862,2063,17,98
764,186,3,529,581,2063,368,359,39,439,844,2049,17,99
892,262,3,501,763,2421,399,444,43,502,991,2379,17,100
909,210,5,566,708,2398,424,489,21,521,1012,2467,17,101
910,211,2,595,723,2441,405,517,29,442,979,2372,17,102
709,421,11,707,897,2745,351,697,144,435,863,2490,17,103
285,534,16,1349,703,2887,71,942,242,359,1066,2680,17,104
186,157,5,1014,378,1740,42,576,19,400,857,1894,17,105
750,185,3,527,736,2201,426,494,14,432,859,2225,17,106
899,219,3,537,681,2339,433,490,13,473,929,2338,17,107
966,189,5,578,761,2499,446,511,21,465,946,2389,17,108
878,309,4,584,777,2552,407,514,42,494,928,2385,17,109
668,489,10,632,981,2780,313,771,161,423,806,2474,17,110
257,370,12,1993,1152,3784,71,1561,181,372,1357,3542,17,111
133,129,5,848,319,1434,47,408,15,366,675,1511,17,112
797,200,3,482,617,2099,392,359,30,451,908,2140,17,113
947,214,2,514,808,2485,420,544,21,436,1009,2430,17,114
938,226,2,542,895,2603,414,649,19,483,1047,2612,17,115
879,298,3,636,794,2610,382,567,68,493,1035,2545,17,116
672,397,17,761,1045,2892,327,809,154,438,854,2582,17,117
232,330,13,889,937,2401,101,811,165,578,582,2237,17,118
175,152,5,960,525,1817,46,682,73,376,741,1918,17,119
770,193,8,463,603,2037,414,383,18,478,846,2139,17,120
951,193,8,491,638,2281,441,394,13,436,1013,2297,17,121
988,243,3,507,791,2532,455,476,46,471,1038,2486,17,122
911,295,3,582,913,2704,455,601,42,492,1025,2615,17,123
746,416,16,712,844,2734,353,695,100,531,922,2601,17,124
241,234,17,972,534,1998,49,756,77,289,704,1875,17,125
161,141,5,832,317,1456,40,503,18,364,570,1495,17,126
745,185,4,459,572,1965,424,357,19,428,819,2047,17,127
901,247,2,507,1275,2932,441,941,26,437,976,2821,17,128
932,267,5,610,1127,2941,442,866,48,479,1050,2885,17,129
847,261,6,587,737,2438,409,483,23,464,980,2359,17,130
671,252,8,569,613,2113,334,437,79,416,798,2064,17,131
270,256,11,790,407,1734,79,432,70,372,676,1629,17,132
151,113,7,551,255,1077,45,289,15,271,444,1064,17,133
770,173,9,555,594,2101,352,422,31,388,931,2124,17,134
878,205,10,514,613,2220,362,391,27,471,959,2210,17,135
948,221,14,657,714,2554,391,527,25,487,1024,2454,17,136
928,222,3,690,784,2627,332,569,29,420,1099,2449,17,137
639,291,18,733,760,2441,282,591,85,402,880,2240,17,138
202,234,16,700,387,1539,52,496,95,241,460,1344,17,139
184,138,3,713,346,1384,37,526,21,329,534,1447,17,140
775,287,3,574,576,2215,369,412,9,482,1017,2289,17,141
1011,270,4,667,783,2735,377,671,17,445,1130,2640,17,142
968,276,11,664,573,2492,376,482,28,445,1123,2454,17,143
866,194,8,538,601,2207,330,488,26,379,900,2123,17,144
643,225,12,612,638,2130,239,512,65,403,749,1968,17,145
222,240,8,800,430,1700,46,629,58,298,581,1612,17,146
126,167,2,618,291,1204,35,422,31,237,479,1204,17,147
151,94,2,461,205,913,42,280,12,212,381,927,17,148
900,152,6,502,604,2164,311,452,43,376,1014,2196,17,149
958,142,10,536,589,2235,367,415,15,418,989,2204,17,150
901,218,2,578,632,2331,350,584,17,421,1118,2490,17,151
706,285,8,621,640,2260,308,573,107,391,847,2226,17,152
188,245,12,816,443,1704,64,527,83,334,614,1622,17,153
212,115,1,600,272,1200,59,386,11,260,444,1160,17,154
941,163,4,522,592,2222,356,453,17,325,1048,2199,17,155
1152,157,2,560,662,2533,360,590,17,366,1188,2521,17,156
1253,153,7,594,576,2583,383,496,28,375,1192,2474,17,157
1135,194,6,566,690,2591,367,651,46,362,1072,2498,17,158
780,361,8,601,935,2685,280,790,122,357,920,2469,17,159
240,278,17,1497,940,2972,61,1391,153,395,1047,3047,17,160
178,311,3,1657,447,2596,72,603,24,622,1664,2985,17,161
1236,174,21,1532,670,3633,545,719,31,461,1939,3695,17,162
1600,204,15,1558,957,4334,471,1097,38,622,2050,4278,17,163
2165,243,4,1575,786,4773,412,1110,35,494,2542,4593,17,164
1292,184,2,1511,754,3743,618,592,34,449,1346,3039,17,165
910,254,9,628,714,2515,303,665,84,336,929,2317,17,166
246,224,11,872,546,1899,52,670,93,326,673,1814,17,167
164,135,28,579,228,1134,45,349,42,265,492,1193,17,168
1001,164,15,549,534,2263,337,458,31,394,1045,2265,17,169
1253,187,7,576,740,2763,325,647,24,422,1242,2660,17,170
500,133,8,844,544,2029,138,651,17,317,806,1929,17,171
1171,191,5,662,613,2642,319,632,33,374,1094,2452,17,172
769,277,3,504,565,2118,275,517,99,319,768,1978,17,173
230,368,3,712,629,1942,70,852,180,322,473,1897,17,174
162,112,2,623,256,1155,46,352,42,281,477,1198,17,175
983,133,1,552,487,2156,331,450,13,379,1022,2195,17,176
1390,177,3,565,599,2734,372,563,22,438,1288,2683,17,177
1323,157,11,546,571,2608,332,566,22,427,1243,2590,17,178
1217,220,19,542,634,2632,357,608,57,398,1232,2652,17,179
879,370,5,589,635,2478,290,551,130,335,942,2248,17,180
287,287,11,811,342,1738,60,518,125,353,638,1694,17,181
211,102,3,641,217,1174,46,353,23,295,523,1240,17,182
930,163,3,619,574,2289,303,540,31,334,1052,2260,17,183
1193,166,3,596,686,2644,327,588,30,400,1180,2525,17,184
910,212,2,582,696,2402,294,640,33,417,927,2311,17,185
231,946,8,1014,1120,3319,42,2134,133,328,409,3046,17,186
425,216,5,604,479,1729,174,526,67,290,552,1609,17,187
193,213,6,708,309,1429,58,424,63,256,541,1342,17,188
141,118,2,490,168,919,38,277,12,243,410,980,17,189
856,138,5,501,507,2007,340,439,23,368,896,2066,17,190
1079,130,7,523,562,2301,348,455,20,369,1114,2306,17,191
1033,128,9,531,561,2262,360,413,25,354,1080,2232,17,192
1035,191,5,537,569,2337,338,488,22,342,997,2187,17,193
738,278,6,603,581,2206,261,480,75,393,819,2028,17,194
212,243,9,866,500,1830,70,684,86,295,543,1678,17,195
202,88,1,555,252,1098,50,334,10,275,430,1099,17,196
892,116,3,456,458,1925,320,334,18,336,912,1920,17,197
1220,145,5,524,543,2437,328,502,26,392,1154,2402,17,198
1162,96,8,494,495,2255,363,388,21,326,1134,2232,17,199
1098,145,6,532,596,2377,324,531,13,348,1076,2292,17,200
658,352,5,558,797,2370,307,660,235,376,769,2347,17,201
220,295,7,902,671,2095,59,897,84,364,566,1970,17,202
169,131,4,627,271,1202,59,332,24,282,567,1264,17,203
886,114,3,588,543,2134,279,467,15,330,1005,2096,17,204
1178,146,3,599,623,2549,328,572,16,346,1180,2442,17,205
1077,168,4,649,638,2536,336,584,19,419,1108,2466,17,206
1139,139,1,680,591,2550,317,506,19,364,1187,2393,17,207
731,282,6,562,588,2169,259,478,93,366,810,2006,17,208
245,275,12,784,416,1732,56,612,174,268,542,1652,17,209
154,91,8,593,251,1097,45,369,55,233,437,1139,17,210
885,128,7,457,603,2080,289,432,62,345,869,1997,17,211
1080,171,4,453,533,2241,348,451,20,334,1085,2238,17,212
1007,138,5,567,519,2236,358,383,15,383,976,2115,17,213
979,146,3,526,513,2167,307,451,34,306,954,2052,17,214
705,209,20,591,606,2131,273,592,115,388,667,2035,17,215
236,157,15,851,294,1553,59,518,107,227,556,1467,17,216
145,104,1,525,196,971,41,279,12,236,455,1023,17,217
734,110,10,409,478,1741,284,320,13,287,815,1719,17,218
994,136,4,489,580,2203,333,523,17,297,970,2140,17,219
969,162,9,491,546,2177,323,434,29,293,1059,2138,17,220
812,119,7,490,453,1881,303,400,26,263,901,1893,17,221
541,197,10,422,518,1688,182,467,88,283,554,1574,17,222
181,196,5,606,372,1360,56,451,86,260,433,1286,17,223
139,91,3,521,231,985,51,307,23,205,462,1048,17,224
699,107,7,426,466,1705,329,274,19,321,763,1706,17,225
902,145,12,507,588,2154,370,402,26,377,967,2142,17,226
878,165,7,479,603,2132,360,429,36,342,955,2122,17,227
817,157,3,470,578,2025,345,394,45,303,865,1952,17,228
591,233,5,470,515,1814,275,430,76,277,596,1654,17,229
156,185,5,643,295,1284,50,393,73,260,500,1276,17,230
106,101,3,515,228,953,37,318,11,212,413,991,17,231
664,122,2,422,504,1714,298,319,19,333,743,1712,17,232
858,145,7,521,603,2134,331,463,17,400,936,2147,17,233
808,163,5,532,610,2118,381,422,27,372,979,2181,17,234
836,174,2,558,530,2100,357,399,15,404,985,2160,17,235
574,282,11,523,682,2072,269,506,75,393,778,2021,17,236
209,287,11,866,519,1892,65,664,148,368,706,1951,17,237
146,140,2,682,281,1251,58,420,13,332,521,1344,17,238
684,176,5,408,742,2015,420,446,17,396,735,2014,17,239
895,230,2,451,856,2434,452,534,25,447,917,2375,17,240
969,198,2,401,824,2394,477,546,15,404,900,2342,17,241
798,392,10,472,824,2496,397,546,57,433,834,2267,17,242
566,336,7,665,844,2418,313,677,109,431,680,2210,17,243
158,293,4,927,768,2150,118,653,81,605,584,2041,17,244
140,243,2,999,456,1840,50,681,43,331,710,1815,17,245
144,182,1,693,324,1344,56,437,9,328,578,1408,17,246
842,202,6,464,640,2154,452,328,13,491,861,2145,17,247
931,235,7,460,679,2312,493,391,18,433,956,2291,17,248
868,268,2,581,669,2388,433,412,37,482,908,2272,17,249
645,338,18,585,890,2476,369,548,117,451,776,2261,17,250
211,904,6,943,627,2691,58,697,157,1089,673,2674,17,251
169,146,1,845,355,1516,48,467,7,385,713,1620,17,252
764,249,4,477,862,2356,445,544,59,426,818,2292,17,253
968,211,4,482,787,2452,462,468,20,557,977,2484,17,254
928,226,3,534,756,2447,481,501,18,471,985,2456,17,255
970,309,5,535,806,2625,463,549,29,476,941,2458,17,256
729,463,21,805,1076,3094,369,805,167,479,888,2708,17,257
231,414,12,1311,816,2784,73,1073,161,420,899,2626,17,258
171,130,1,932,335,1569,57,466,33,447,806,1809,17,259
751,210,6,544,639,2150,451,387,16,464,877,2195,17,260
990,226,5,527,718,2466,526,420,27,438,1054,2465,17,261
995,221,13,539,692,2460,417,479,17,486,940,2339,17,262
935,267,2,541,810,2555,439,566,27,493,974,2499,17,263
739,416,21,780,931,2887,403,615,149,515,920,2602,17,264
232,496,19,1240,1151,3138,154,889,325,751,728,2847,17,265
149,146,5,843,374,1517,67,467,27,398,657,1616,17,266
775,215,19,452,685,2146,447,340,40,501,862,2190,17,267
973,223,13,537,826,2572,476,505,32,531,1046,2590,17,268
993,207,3,516,823,2542,472,574,15,459,990,2510,17,269
927,234,2,551,799,2513,441,498,27,524,1006,2496,17,270
669,399,14,710,1082,2874,389,750,133,429,843,2544,17,271
185,378,46,1427,845,2881,112,1140,158,418,923,2751,17,272
183,116,7,781,364,1451,78,480,20,316,681,1575,17,273
760,213,7,454,589,2023,436,341,14,452,844,2087,17,274
950,233,5,471,705,2364,441,439,16,432,1029,2357,17,275
927,199,5,475,834,2440,481,494,41,457,932,2405,17,276
863,255,10,489,738,2355,427,462,26,401,944,2260,17,277
689,425,6,732,980,2832,375,699,94,499,836,2503,17,278
246,308,9,1309,786,2658,76,909,90,513,920,2508,17,279
163,155,2,703,301,1324,54,461,24,354,609,1502,17,280
761,231,5,470,644,2111,481,401,15,436,872,2205,17,281
987,253,6,554,801,2601,498,506,36,500,1051,2591,17,282
976,274,3,576,763,2592,467,447,60,510,1062,2546,17,283
849,349,3,569,866,2636,447,553,56,477,1010,2543,17,284
621,844,95,832,836,3228,380,766,86,550,1362,3144,17,285
278,372,7,1402,791,2850,65,970,159,397,989,2580,17,286
216,238,3,967,425,1849,62,585,16,470,868,2001,17,287
384,197,15,551,619,1766,400,364,37,472,554,1827,17,288
964,256,1,633,911,2765,481,656,15,537,1132,2821,17,289
949,261,1,599,722,2532,474,457,24,548,1064,2567,17,290
892,347,2,552,939,2732,401,614,36,505,1034,2590,17,291
655,569,31,952,1251,3458,350,927,179,561,1149,3166,17,292
286,2070,29,991,1053,4429,61,730,261,1923,1278,4253,17,293
190,156,1,984,417,1748,58,558,23,458,717,1814,17,294
755,239,18,526,832,2370,460,520,72,499,855,2406,17,295
932,212,10,521,786,2461,486,455,20,479,1055,2495,17,296
966,259,3,548,939,2715,483,605,36,536,1026,2686,17,297
868,297,4,528,950,2647,439,647,41,485,923,2535,17,298
658,415,15,714,969,2771,360,641,140,471,855,2467,17,299
264,343,13,1360,805,2785,94,1011,186,436,852,2579,17,300
257,204,3,851,481,1796,63,663,29,428,705,1888,17,301
735,191,6,448,692,2072,433,339,11,509,838,2130,17,302
941,228,3,528,1085,2785,476,757,21,505,951,2710,17,303
965,219,3,552,875,2614,488,556,18,488,1008,2558,17,304
846,940,0,486,929,3201,427,693,76,482,893,2571,17,305
615,540,26,681,893,2755,362,565,200,458,831,2416,17,306
205,428,22,1167,805,2627,75,987,221,330,805,2418,17,307
148,115,1,776,353,1393,57,352,13,388,662,1472,17,308
752,256,6,452,731,2197,484,402,14,460,897,2257,17,309
754,227,7,461,799,2248,432,362,67,517,786,2164,17,310
788,238,12,483,924,2445,438,552,40,474,913,2417,17,311
861,252,2,492,812,2419,458,433,22,465,943,2321,17,312
674,382,10,760,1048,2874,353,618,139,508,883,2501,17,313
245,304,6,1333,626,2514,70,737,100,371,1075,2353,17,314
144,137,1,819,345,1446,76,382,21,392,651,1522,17,315
365,201,5,448,597,1616,332,303,29,501,540,1705,17,316
953,188,7,486,761,2395,500,403,21,486,1030,2440,17,317
915,195,2,472,846,2430,467,513,22,418,968,2388,17,318
861,213,2,473,736,2285,451,381,15,484,922,2253,17,319
670,475,11,701,855,2712,344,644,103,511,1027,2629,17,320
213,697,23,1222,554,2709,55,608,111,640,1355,2769,17,321
146,174,3,836,468,1627,87,576,32,366,686,1747,17,322
822,201,9,421,692,2145,438,405,23,473,845,2184,17,323
992,259,4,473,765,2493,504,420,32,497,1047,2500,17,324
990,207,1,481,750,2429,505,398,9,508,1034,2454,17,325
859,293,16,493,891,2552,429,538,25,470,971,2433,17,326
647,350,10,612,942,2561,341,608,87,420,743,2199,17,327
227,350,13,1281,1341,3212,200,923,129,790,818,2860,17,328
142,156,18,900,372,1588,53,476,28,366,649,1572,17,329
721,156,2,639,729,2247,365,397,31,404,795,1992,17,330
815,163,2,732,805,2517,303,455,12,450,829,2049,17,331
556,139,2,624,394,1715,176,373,10,376,568,1503,17,332
64,54,1,245,98,462,33,118,5,139,152,447,17,333
239,74,3,607,254,1177,92,310,26,225,469,1122,17,334
141,142,3,458,260,1004,46,324,34,212,465,1081,17,335
80,96,3,403,274,856,91,408,9,448,545,1501,17,336
669,157,1,386,584,1797,420,326,6,561,768,2081,17,337
885,190,6,411,781,2273,441,408,18,498,953,2318,17,338
924,247,2,427,665,2265,482,352,5,457,1033,2329,17,339
782,240,6,465,815,2308,412,500,23,452,890,2277,17,340
596,293,12,508,944,2353,326,599,94,395,730,2144,17,341
194,239,21,1110,909,2473,54,1013,114,332,838,2351,17,342
119,139,3,729,516,1506,69,570,32,342,561,1574,17,343
835,179,7,480,639,2140,393,451,13,455,824,2136,17,344
1093,168,4,642,663,2570,394,525,13,429,1153,2514,17,345
1025,167,16,446,577,2231,355,490,10,348,1003,2206,17,346
975,247,3,660,794,2679,367,678,21,430,1089,2585,17,347
678,246,7,664,768,2363,261,542,74,441,879,2197,17,348
164,335,9,978,818,2304,197,760,110,334,740,2141,17,349
144,116,0,679,384,1323,41,446,16,287,536,1326,17,350
698,182,2,543,568,1993,329,358,17,334,845,1883,17,351
890,197,6,703,830,2626,338,560,37,370,1064,2369,17,352
934,140,2,598,705,2379,312,491,23,330,889,2045,17,353
726,125,1,519,673,2044,318,578,20,317,814,2047,17,354
497,160,4,435,531,1627,217,436,63,264,553,1533,17,355
139,96,4,608,330,1177,51,354,40,246,436,1127,17,356
89,65,4,414,277,849,26,315,12,155,287,795,17,357
404,69,3,465,337,1278,144,335,10,232,489,1210,17,358
246,72,2,340,172,832,92,177,7,209,280,765,17,359
56,26,2,122,125,331,31,94,10,66,78,279,17,360
258,74,1,350,242,925,85,239,12,148,378,862,17,361
293,108,3,448,233,1085,111,230,27,221,486,1075,17,362
99,87,3,365,243,797,39,265,33,175,272,784,17,363
77,79,3,350,206,715,32,232,12,204,318,798,17,364
433,63,5,469,360,1330,158,318,14,255,544,1289,17,365
357,403,105,427,316,1608,144,289,329,264,492,1518,17,366
249,502,6,1249,1140,3146,224,743,19,1133,1287,3406,18,1
1567,774,13,1844,2327,6525,1122,1185,23,1892,2675,6897,18,2
2141,968,12,2041,3022,8184,1959,1290,28,2038,3101,8416,18,3
2064,926,7,1952,2936,7885,1956,1314,23,1878,3011,8182,18,4
1677,1168,74,2072,3287,8278,1696,1549,131,2039,3040,8455,18,5
486,812,62,1913,1354,4627,364,1089,134,1704,1389,4680,18,6
380,675,10,2354,1619,5038,285,996,20,2053,1981,5335,18,7
2045,983,2,1943,3054,8027,1948,1314,32,1865,3201,8360,18,8
2494,546,10,1821,2340,7211,1952,1030,19,1740,2658,7399,18,9
2545,1066,23,2178,3097,8909,1977,1522,47,1990,3560,9096,18,10
2568,1013,7,2108,3377,9073,2006,1749,31,2012,3299,9097,18,11
1841,968,62,2183,3236,8290,1753,1422,121,2067,2859,8222,18,12
516,1098,65,2770,2079,6528,403,1333,201,2183,2716,6836,18,13
368,729,12,2120,1577,4806,277,1019,24,1794,1677,4791,18,14
673,733,5,1980,1437,4828,417,1041,39,1759,1819,5075,18,15
1144,741,13,1545,1895,5338,793,1227,30,1509,1787,5346,18,16
2221,966,6,2057,2911,8161,1138,1539,30,2320,3299,8326,18,17
2599,1068,8,2098,3223,8996,1948,1738,32,1927,3324,8969,18,18
1227,1017,70,1694,2151,6159,756,1550,194,1443,2037,5980,18,19
557,989,73,2621,1988,6228,359,1356,214,2127,2163,6219,18,20
385,653,10,2124,1553,4725,253,1091,40,1820,1825,5029,18,21
2224,899,7,1875,3090,8095,1905,1298,18,1875,3149,8245,18,22
2680,966,8,2097,3249,9000,2064,1660,21,1860,3500,9105,18,23
2756,1175,8,2153,3293,9385,2036,1777,28,1996,3614,9451,18,24
2533,1143,20,2085,3186,8967,2054,1775,38,1794,3386,9047,18,25
1725,1356,94,2261,2979,8415,1513,1864,183,2072,2955,8587,18,26
558,1085,69,2662,2179,6553,405,1559,138,2238,2269,6609,18,27
310,731,9,2004,1482,4536,189,1065,26,1765,1734,4779,18,28
2230,904,12,1952,2947,8045,2048,1330,25,1800,3114,8317,18,29
2730,1008,11,1971,3066,8786,2002,1611,24,1836,3513,8986,18,30
2753,1107,29,2174,3244,9307,2080,1709,65,2049,3626,9529,18,31
2637,1211,14,2312,3254,9428,2228,1750,48,2027,3523,9576,18,32
1894,1254,83,2265,3382,8878,1977,1637,196,2073,3257,9140,18,33
541,1156,73,2604,2037,6411,428,1442,163,2283,2114,6430,18,34
398,704,8,2252,1706,5068,323,1008,41,2048,1876,5296,18,35
2224,979,8,1991,3095,8297,2017,1380,20,1962,3233,8612,18,36
2740,1108,41,2157,3230,9276,2132,1808,46,1886,3535,9407,18,37
2729,1195,22,2223,3305,9474,2275,1825,35,2044,3400,9579,18,38
2482,1035,19,2118,3372,9026,2120,1687,49,1874,3239,8969,18,39
1896,1159,85,2023,3354,8517,1990,1608,161,1967,3073,8799,18,40
570,1097,101,2609,2094,6471,382,1534,206,2193,2203,6518,18,41
383,783,12,2118,1530,4826,287,1028,51,1690,2019,5075,18,42
2089,798,8,1793,2880,7568,2025,1208,36,1709,2959,7937,18,43
2582,1105,20,2044,3257,9008,2091,1659,37,1837,3514,9138,18,44
2652,1156,12,2313,3383,9516,2131,1563,69,2041,3609,9413,18,45
2486,971,42,1928,3120,8547,2038,1548,65,1734,3220,8605,18,46
1643,1124,64,2053,2921,7805,1349,1533,205,1982,2778,7847,18,47
477,1050,60,2467,1792,5846,378,1317,173,1781,2286,5935,18,48
353,692,8,1984,1542,4579,264,1008,39,1720,1779,4810,18,49
781,609,7,1937,1815,5149,585,1023,24,1693,2111,5436,18,50
2423,877,3,1899,3010,8212,2054,1547,31,1780,3278,8690,18,51
2540,955,4,1944,3158,8601,2077,1488,19,1818,3537,8939,18,52
2367,885,11,1867,3115,8245,1953,1627,49,1715,3171,8515,18,53
1780,1182,43,1857,3144,8006,1841,1539,166,1827,2935,8308,18,54
531,1030,80,2511,2142,6294,395,1561,193,2200,2116,6465,18,55
387,632,7,2023,1554,4603,295,950,18,1843,1615,4721,18,56
2136,907,4,1796,3009,7852,2113,1417,15,1703,3029,8277,18,57
2642,979,9,1913,3126,8669,2213,1616,34,1697,3404,8964,18,58
2682,901,11,2034,3032,8660,2153,1539,23,1861,3317,8893,18,59
2445,967,4,1864,3188,8468,2006,1822,46,1664,3293,8831,18,60
1826,1162,64,2114,3583,8749,1993,1707,180,2052,3142,9074,18,61
478,1036,58,2331,1885,5788,343,1392,189,1887,2082,5893,18,62
404,657,7,2272,1535,4875,296,1038,27,1986,1899,5246,18,63
2116,865,16,2029,3065,8091,2174,1358,51,1815,3045,8443,18,64
2704,937,7,1917,3090,8655,2090,1693,35,1710,3498,9026,18,65
2723,927,13,2149,3069,8881,2243,1693,34,1801,3518,9289,18,66
2550,1052,8,1909,3286,8805,2176,1766,24,1745,3356,9067,18,67
1958,1246,76,2149,3510,8939,1977,1737,214,2000,3272,9200,18,68
515,922,61,2650,1691,5839,430,1376,147,2131,1932,6016,18,69
360,767,7,2172,1625,4931,311,1281,26,1914,1799,5331,18,70
2178,988,11,1976,3156,8309,2050,1556,31,1812,3194,8643,18,71
2618,1145,9,2071,3256,9099,2174,1875,27,1790,3609,9475,18,72
2622,1156,11,2320,3269,9378,2209,1954,40,2053,3649,9905,18,73
2388,1192,9,2243,2947,8779,1598,2035,127,2067,3285,9112,18,74
1646,1178,65,2223,2891,8003,1354,1671,270,1870,2961,8126,18,75
1315,1369,80,4097,2101,8962,625,1956,222,3142,2737,8682,18,76
446,807,6,2210,1700,5169,317,1295,25,1902,1930,5469,18,77
2110,976,12,2045,3184,8327,2143,1431,29,1801,3217,8621,18,78
2643,1055,18,2087,3260,9063,2248,1807,37,1782,3597,9471,18,79
2773,1190,4,2179,3393,9539,2255,1994,36,2031,3587,9903,18,80
2604,1175,13,2132,3382,9306,2353,1944,57,1940,3343,9637,18,81
1961,1286,70,2196,3490,9003,1942,1849,234,2059,3226,9310,18,82
464,1255,65,2340,2191,6315,353,1936,210,1683,2188,6370,18,83
483,934,12,2642,1818,5889,304,1334,29,2045,2500,6212,18,84
2106,1097,12,2193,3354,8762,2154,1621,27,1894,3349,9045,18,85
2650,1063,12,2195,3388,9308,2186,1834,17,1838,3771,9646,18,86
2512,1109,8,2228,3120,8977,2125,1737,17,1776,3556,9211,18,87
2392,1141,17,2208,3323,9081,2039,1848,69,2020,3379,9355,18,88
1788,1766,61,2477,3495,9587,1859,2016,214,2289,3359,9737,18,89
603,1299,61,3251,2247,7461,417,1892,192,2458,2675,7634,18,90
470,724,6,2504,1431,5135,295,1178,18,2023,1983,5497,18,91
1936,958,14,2220,3220,8348,1862,1611,27,1841,3084,8425,18,92
2602,967,10,2245,3192,9016,2149,1692,22,1860,3542,9265,18,93
2635,1166,7,2078,3180,9066,2051,1838,23,1802,3496,9210,18,94
2557,1223,9,2248,3605,9642,2134,1923,38,1947,3599,9641,18,95
1748,1366,72,2394,3238,8818,1432,2030,221,2078,3183,8944,18,96
636,1345,60,3202,2329,7572,431,1944,180,2603,2440,7598,18,97
763,746,7,2475,1646,5637,336,1284,48,2243,1936,5847,18,98
2061,971,3,2196,2908,8139,1921,1437,18,1858,3130,8364,18,99
2600,1133,20,2145,3272,9170,2254,1848,48,1879,3543,9572,18,100
2653,1152,20,2270,3217,9312,2209,1802,47,2024,3513,9595,18,101
2489,979,8,2113,3235,8824,2183,1707,40,1800,3315,9045,18,102
1941,1274,76,2273,3388,8952,1934,1869,243,2033,3065,9144,18,103
627,1341,79,2980,2384,7411,427,1859,217,2552,2529,7584,18,104
472,824,3,2438,1621,5358,308,1287,24,2152,2046,5817,18,105
1833,939,4,2082,2482,7340,1254,1674,19,1851,2863,7661,18,106
2272,952,5,1946,2429,7604,1141,1850,34,1778,3111,7914,18,107
2440,934,18,2043,2422,7857,1298,1689,37,1852,2485,7361,18,108
2242,1042,7,2125,2647,8063,1340,1859,35,1861,3218,8313,18,109
1708,1180,55,2083,2886,7912,1241,1786,206,1994,2780,8007,18,110
596,1309,81,3077,2396,7459,413,2118,257,2166,2829,7783,18,111
445,701,14,2190,1515,4865,326,1157,25,1753,1820,5081,18,112
1983,1054,12,1918,3007,7974,2168,1455,22,1794,3023,8462,18,113
2502,1085,17,2159,3479,9242,2169,2009,25,1907,3518,9628,18,114
2499,1134,18,2309,3533,9493,2152,1942,25,2070,3582,9771,18,115
2467,1182,2,2280,3483,9414,2130,1958,38,1973,3551,9650,18,116
1871,1403,66,2172,3615,9127,1916,1987,226,2062,3108,9299,18,117
592,1245,55,2721,2047,6660,414,1714,263,2344,2083,6818,18,118
489,855,3,2425,1747,5519,394,1443,51,2129,1932,5949,18,119
2134,988,3,2014,3050,8189,2154,1530,23,1888,3098,8693,18,120
2685,1125,8,2096,3189,9103,2293,1809,27,1868,3522,9519,18,121
2716,1210,8,2310,3232,9476,2278,1843,38,2100,3544,9803,18,122
2528,1188,17,2215,3331,9279,2201,1809,57,2072,3410,9549,18,123
1931,1364,73,2245,3622,9235,1965,1998,187,2179,2980,9309,18,124
629,1136,61,2468,2144,6438,349,1638,182,2339,2085,6593,18,125
442,704,21,2272,1452,4891,300,1242,31,1788,1839,5200,18,126
2053,1027,0,1989,3072,8141,2085,1447,9,1906,3172,8619,18,127
2599,1290,8,2173,3468,9538,2240,2139,23,1942,3432,9776,18,128
2715,1222,15,2393,3523,9868,2345,2045,38,2207,3492,10127,18,129
2433,1195,13,2026,3363,9030,2185,1805,42,1899,3376,9307,18,130
1852,1252,70,2203,3372,8749,1909,1724,186,1966,3056,8841,18,131
729,1190,67,2673,2203,6862,484,1579,187,2546,2415,7211,18,132
465,700,11,2214,1435,4825,301,1159,32,1922,1781,5195,18,133
1983,1005,4,1982,3088,8062,2137,1538,25,1823,3036,8559,18,134
2564,979,7,2093,3079,8722,2177,1766,34,1850,3214,9041,18,135
2579,1075,7,2201,3318,9180,2087,1866,43,2063,3353,9412,18,136
2426,1164,8,2177,3475,9250,2207,1824,53,2086,3472,9642,18,137
1871,1366,91,2240,3211,8779,1993,1671,196,2034,3130,9024,18,138
597,1060,60,2478,2044,6239,384,1625,177,1985,2058,6229,18,139
498,796,3,2292,1601,5190,374,1196,42,2130,1827,5569,18,140
2098,1101,6,2021,3356,8582,2189,1690,15,1926,3231,9051,18,141
2646,1210,5,2190,3493,9544,2212,2109,26,1984,3648,9979,18,142
2723,1211,18,2315,3212,9479,2240,1694,31,2090,3676,9731,18,143
2352,1129,7,2204,3174,8866,2085,1736,35,1891,3323,9070,18,144
1741,1432,51,2428,3788,9440,1836,2218,197,2365,2925,9541,18,145
586,1115,59,2523,2137,6420,463,1898,158,2158,2079,6756,18,146
462,1006,11,2335,1527,5341,336,1388,53,1890,2012,5679,18,147
436,633,2,1847,1392,4310,356,1037,16,1602,1862,4873,18,148
2378,1113,6,2007,3021,8525,2144,1583,30,1858,3381,8996,18,149
2557,1090,6,2078,2998,8729,2244,1620,21,2046,3566,9497,18,150
2428,1197,4,2021,3271,8921,2124,1821,20,1991,3448,9404,18,151
1839,1393,76,2193,3443,8944,1907,1984,180,2132,3021,9224,18,152
640,1226,64,2758,2062,6750,515,1744,177,2382,2079,6897,18,153
464,789,6,2182,1800,5241,367,1113,21,2254,1975,5730,18,154
2170,1023,9,2037,3240,8479,2105,1672,19,1948,3192,8936,18,155
2599,1116,8,2272,2847,8842,1672,1929,25,2035,3500,9161,18,156
2786,1060,13,2279,3116,9254,2234,1696,23,2089,3475,9517,18,157
2592,1208,16,2114,3718,9648,2137,2273,37,1996,3409,9852,18,158
1969,1459,69,2276,4169,9942,1885,2563,237,2186,3195,10066,18,159
723,1541,125,3201,2778,8368,514,2846,232,2791,3114,9497,18,160
500,932,8,2723,1788,5951,312,1725,35,2002,2240,6314,18,161
2099,985,7,2130,3000,8221,2046,1440,21,1993,3025,8525,18,162
2798,1164,7,2196,3278,9443,2209,1821,33,2123,3666,9852,18,163
2787,1252,10,2278,3382,9709,2042,2203,36,2210,3564,10055,18,164
2517,1200,8,2388,3172,9285,2012,1864,21,2155,3384,9436,18,165
1957,1297,79,2465,3387,9185,1804,2141,191,2227,2857,9220,18,166
639,1340,83,2696,2522,7280,498,2149,226,2273,2219,7365,18,167
495,768,9,2291,1522,5085,329,1255,33,1851,1953,5421,18,168
1987,1094,9,2005,2667,7762,1615,1534,18,2005,3054,8226,18,169
2299,1062,12,2190,2782,8345,1508,1866,49,2001,3156,8580,18,170
1019,1072,18,2488,2411,7008,837,1732,51,2017,2358,6995,18,171
2207,1246,12,2161,2690,8316,1403,1768,36,1869,3074,8150,18,172
1705,1312,76,2223,2769,8085,1347,1851,204,2011,2867,8280,18,173
632,1364,64,2487,2036,6583,449,2020,295,1992,1915,6671,18,174
422,826,10,1973,1431,4662,321,1225,41,1739,1742,5068,18,175
1894,916,10,1971,2463,7254,1473,1418,32,1872,2858,7653,18,176
2413,1043,10,2145,2639,8250,1583,1748,36,1933,3259,8559,18,177
2510,1060,11,2274,2662,8517,1651,1795,32,1972,3262,8712,18,178
2342,1293,9,2270,2806,8720,1679,2004,37,1917,3196,8833,18,179
1849,1340,65,2390,2947,8591,1571,1832,186,2210,2900,8699,18,180
633,1226,71,2526,2138,6594,450,1932,183,2182,2108,6855,18,181
426,837,7,2049,1475,4794,290,1096,37,1824,1740,4987,18,182
1828,1030,10,2152,2828,7848,1631,1618,17,1995,2956,8217,18,183
2240,1035,8,2313,2870,8466,1665,1740,26,2202,3079,8712,18,184
1967,1180,6,2342,3200,8695,1600,1965,51,2223,2922,8761,18,185
518,1878,36,2356,1955,6743,379,2670,92,1990,1899,7030,18,186
1076,1166,44,2336,2468,7090,1093,1552,171,2026,2307,7149,18,187
577,1008,58,2235,1687,5565,445,1484,189,1760,1870,5748,18,188
427,709,7,1967,1312,4422,335,1165,13,1661,1797,4971,18,189
1925,896,4,2009,2481,7315,1615,1526,15,1853,2821,7830,18,190
2327,994,3,2259,2592,8175,1795,1802,32,1983,3213,8825,18,191
2468,975,18,2187,2660,8308,1714,1763,35,1996,3331,8839,18,192
2337,1252,13,2359,2838,8799,1709,1901,33,2141,3233,9017,18,193
1777,1349,59,2197,2922,8304,1439,1885,162,2057,2914,8457,18,194
585,1318,52,2660,2165,6780,493,1896,227,2162,2186,6964,18,195
465,766,15,2110,1445,4801,324,1104,36,1869,1687,5020,18,196
1913,892,4,2035,2495,7339,1655,1392,22,1787,2808,7664,18,197
2389,1000,6,2133,2756,8284,1639,1835,20,1927,2964,8385,18,198
2412,960,5,2110,2677,8164,1697,1446,15,1996,3284,8438,18,199
2230,1134,5,2179,2791,8339,1683,1735,25,2063,3074,8580,18,200
1675,1555,81,2232,3514,9057,1426,2254,532,2113,2756,9081,18,201
611,1216,79,2640,2058,6604,468,1896,179,2187,1997,6727,18,202
405,857,4,2206,1481,4953,318,1247,24,1775,1951,5315,18,203
1947,921,5,2019,2399,7291,1541,1392,31,1856,2692,7512,18,204
2460,1028,19,2262,2755,8524,1609,1918,36,2073,3212,8848,18,205
2283,1077,5,2288,2965,8618,1632,1926,27,2033,3363,8981,18,206
2288,1092,15,2239,2716,8350,1624,1671,30,1949,3245,8519,18,207
1640,1365,73,2263,2791,8132,1413,1787,221,2073,2765,8259,18,208
619,1233,81,2456,1954,6343,437,1781,246,2096,2053,6613,18,209
408,790,5,2084,1602,4889,372,1355,54,1739,1797,5317,18,210
1867,945,1,1941,2742,7496,1557,1645,30,1861,2799,7892,18,211
2371,1007,7,2150,2591,8126,1618,1557,31,1961,3095,8262,18,212
2530,1114,5,2209,2620,8478,1669,1576,24,1952,3347,8568,18,213
2183,1231,9,2307,2710,8440,1653,1725,41,2095,3086,8600,18,214
1698,1361,76,2425,2796,8356,1439,1989,196,2202,2733,8559,18,215
632,929,64,2571,1752,5948,427,1345,158,2075,2196,6201,18,216
426,845,1,2126,1430,4828,316,1064,20,1816,1826,5042,18,217
1766,952,3,1958,2537,7216,1383,1491,16,1883,2682,7455,18,218
2106,997,5,1882,2661,7651,1473,1656,53,1784,3048,8014,18,219
2181,1008,5,1919,2529,7642,1419,1577,33,1805,2989,7823,18,220
2024,924,3,1928,2376,7255,1350,1404,20,1745,2754,7273,18,221
1328,1157,69,1889,2490,6933,1073,1677,206,1644,2379,6979,18,222
577,1184,56,2459,1957,6233,403,1668,170,2145,1935,6321,18,223
408,730,9,1926,1395,4468,288,1080,30,1743,1759,4900,18,224
1722,945,19,1873,2407,6966,1358,1415,31,1899,2695,7398,18,225
2156,937,14,1955,2549,7611,1368,1592,32,1900,3032,7924,18,226
2129,1044,7,2018,2642,7840,1496,1643,33,1850,3100,8122,18,227
2041,1206,5,1965,2691,7908,1344,1762,60,1930,3044,8140,18,228
1549,1186,48,2163,2782,7728,1213,1659,160,1992,2687,7711,18,229
567,1068,57,2385,1882,5959,420,1365,226,2109,2021,6141,18,230
379,703,9,2182,1480,4753,324,1063,32,1787,1921,5127,18,231
1707,874,3,1898,2464,6946,1368,1241,17,1683,2899,7208,18,232
2143,1042,8,1942,2711,7846,1407,1717,37,1859,3030,8050,18,233
2173,1103,10,2062,2925,8273,1386,1698,34,1983,3239,8340,18,234
2024,1078,6,1956,2670,7734,1359,1599,25,1890,3169,8042,18,235
1536,1294,55,2214,3096,8195,1307,1874,207,2065,2741,8194,18,236
613,1154,75,2702,2276,6820,451,1834,206,2230,2277,6998,18,237
396,814,7,2486,1694,5397,310,1190,31,2166,2141,5838,18,238
2022,827,10,1793,3186,7838,1914,1507,17,1788,2917,8143,18,239
2524,993,8,1949,3352,8826,2107,1885,31,1764,3459,9246,18,240
2445,1031,22,2041,3300,8839,2102,1816,35,1910,3353,9216,18,241
2249,951,4,2032,3097,8333,2007,1432,19,1889,3264,8611,18,242
1810,1285,70,2311,3559,9035,1889,1734,187,2224,3010,9044,18,243
543,1085,52,2524,2070,6274,442,1539,174,2243,2089,6487,18,244
461,928,15,2383,1724,5511,317,1320,54,1923,2159,5773,18,245
429,758,9,1900,1653,4749,364,1213,10,1825,1973,5385,18,246
2497,1105,8,2120,3137,8867,2311,1597,29,1933,3400,9270,18,247
2649,1129,8,2191,3190,9167,2347,1618,30,1952,3596,9543,18,248
2542,1162,6,2246,3243,9199,2321,1681,32,2006,3561,9601,18,249
1994,1282,62,2193,3537,9068,2100,1739,196,2082,3229,9346,18,250
593,1230,96,2960,2288,7167,487,1944,250,2440,2335,7456,18,251
488,868,6,2286,1789,5437,322,1208,21,2150,1951,5652,18,252
2271,1099,11,1986,3097,8464,2321,1510,34,1620,3358,8843,18,253
2786,1276,6,2174,3356,9598,2383,2060,25,1884,3768,10120,18,254
2774,1259,16,2207,3307,9563,2361,1901,41,1899,3643,9845,18,255
2689,1276,3,2288,3611,9867,2317,2145,17,1926,3637,10042,18,256
2069,1688,70,2387,3832,10046,2245,2275,223,2198,3499,10440,18,257
590,1357,86,2794,2545,7372,465,2268,280,2516,2306,7835,18,258
519,844,6,2658,1864,5891,331,1266,39,2297,2258,6191,18,259
2286,1134,2,2017,3168,8607,2304,1567,11,1871,3297,9050,18,260
2905,1127,7,2213,3263,9515,2421,1769,24,1800,3848,9862,18,261
2874,1235,36,2174,3188,9507,2155,1911,61,1986,3561,9674,18,262
2788,1136,10,2197,3547,9678,2342,2072,33,1895,3629,9971,18,263
2061,1462,65,2317,3573,9478,2065,1903,221,2108,3481,9778,18,264
658,1205,102,3087,2188,7240,454,2069,214,2360,2361,7458,18,265
433,822,9,2268,1647,5179,320,1195,20,2066,1874,5475,18,266
2328,1058,9,2049,3122,8566,2217,1569,32,1820,3169,8807,18,267
2836,1150,14,2193,3381,9574,2334,1886,47,1774,3830,9871,18,268
2771,1217,10,2195,3493,9686,2293,1998,34,1862,3816,10003,18,269
2599,1086,7,2303,3332,9327,2159,1862,29,1930,3645,9625,18,270
2016,1542,83,2340,3498,9479,2025,2015,180,2050,3319,9589,18,271
644,1296,111,3108,2501,7660,460,2301,298,2505,2457,8021,18,272
418,709,6,2543,1701,5377,304,1379,30,1959,2072,5744,18,273
2238,1067,9,2083,3270,8667,2263,1559,14,1841,3395,9072,18,274
2826,1133,7,2153,3221,9340,2250,1804,22,1850,3638,9564,18,275
2725,1200,4,2304,3295,9528,2344,1738,27,2081,3661,9851,18,276
2477,1144,6,2214,3372,9213,2274,1820,29,1975,3538,9636,18,277
1963,1363,74,2205,3476,9081,2053,1726,199,1972,3368,9318,18,278
610,1246,76,2901,2291,7124,468,1832,212,2408,2501,7421,18,279
465,794,4,2323,1730,5316,336,1264,15,2177,2028,5820,18,280
2253,1116,5,2062,3287,8723,2243,1488,10,1876,3431,9048,18,281
2826,1203,11,2427,3245,9712,2420,1807,19,1996,3729,9971,18,282
2721,1294,17,2285,3248,9565,2314,1761,38,2025,3793,9931,18,283
2388,1299,4,2298,2993,8982,1576,1958,32,2061,3621,9248,18,284
1709,1376,55,2359,3081,8580,1451,1733,142,2219,3161,8706,18,285
587,1159,66,2992,2109,6913,428,1743,183,2319,2392,7065,18,286
583,791,5,2373,1971,5723,327,1477,33,2160,2101,6098,18,287
1001,815,4,2131,2225,6176,809,1354,26,1912,2515,6616,18,288
2663,1129,24,2186,3379,9381,2240,1770,31,1837,3871,9749,18,289
2772,1227,4,2367,3466,9836,2312,1939,30,2145,3852,10278,18,290
2613,1231,18,2221,3566,9649,2229,2081,44,1956,3608,9918,18,291
2008,1582,103,2526,3574,9793,2062,2043,174,2295,3340,9914,18,292
585,1410,115,2940,2412,7462,466,2030,301,2382,2537,7716,18,293
425,703,6,2420,1926,5480,320,1560,23,2068,2026,5997,18,294
2180,1009,6,2150,3328,8673,2171,1540,46,1973,3429,9159,18,295
2752,1115,4,2185,3348,9404,2292,1727,20,1921,3856,9816,18,296
2787,1200,9,2344,3495,9835,2330,1911,26,2014,3875,10156,18,297
2591,1312,15,2225,3764,9907,2236,2064,37,1983,4009,10329,18,298
1909,1428,87,2441,3490,9355,1923,1922,182,2326,3445,9798,18,299
646,1311,139,2847,2150,7093,432,1810,236,2445,2455,7378,18,300
719,825,2,2507,2028,6081,328,1330,23,2476,2137,6294,18,301
2247,1085,7,2039,3219,8597,2097,1489,16,1814,3647,9063,18,302
2745,1139,5,2156,3684,9729,2310,2174,35,1909,3734,10162,18,303
2775,1336,9,2252,3616,9988,2226,1893,18,2005,4152,10294,18,304
2499,1599,15,2249,3353,9715,2213,1949,38,2068,3899,10167,18,305
1947,1470,126,2393,3519,9455,1951,1962,253,2300,3383,9849,18,306
604,1489,144,2656,2565,7458,451,1909,205,2697,2557,7819,18,307
507,672,7,2390,1790,5366,384,1118,23,2205,1990,5720,18,308
2166,951,8,2235,2783,8143,1715,1456,18,1929,3287,8405,18,309
2123,1063,10,2294,2759,8249,1569,1412,70,2302,3353,8706,18,310
2370,1094,3,2248,3338,9053,2301,1535,17,2132,3445,9430,18,311
2464,1063,10,2229,3419,9185,2261,1653,28,2046,3583,9571,18,312
1955,1305,90,2417,3726,9493,1996,1813,193,2231,3359,9592,18,313
657,1170,62,2749,2179,6817,468,1533,177,2367,2444,6989,18,314
465,709,11,2933,1846,5964,403,1077,21,2069,2622,6192,18,315
1057,647,2,2102,2106,5914,768,1311,19,1918,2366,6382,18,316
2795,1048,10,2256,3449,9558,2391,1648,21,2015,3975,10050,18,317
2931,1147,8,2349,3389,9824,2425,1751,26,2106,4001,10309,18,318
2656,973,11,2218,3324,9182,2270,1690,25,1904,3689,9578,18,319
2047,1242,72,2304,3526,9191,1975,1719,177,2209,3391,9471,18,320
627,1228,99,3436,2339,7729,496,1608,228,2719,3108,8159,18,321
425,761,2,2419,1903,5510,386,1179,25,2254,2066,5910,18,322
2361,1023,3,2107,3336,8830,2204,1457,16,1992,3435,9104,18,323
2909,1116,11,2347,3415,9798,2385,1778,19,2042,3939,10163,18,324
2933,1151,2,2319,3465,9870,2390,1750,26,2232,3902,10300,18,325
2746,1130,4,2254,3513,9647,2212,1913,30,1988,3739,9882,18,326
2081,1115,47,2293,3374,8910,2076,1709,179,2032,3054,9050,18,327
619,1234,89,2792,2279,7013,431,1623,209,2291,2471,7025,18,328
465,726,5,2278,1622,5096,294,1072,22,1983,1942,5313,18,329
2027,1036,4,2268,3176,8511,2109,1265,26,1972,3262,8634,18,330
2061,1000,7,2340,3166,8574,1906,1340,26,1990,3163,8425,18,331
1424,821,4,2361,2570,7180,1175,1104,19,2291,2221,6810,18,332
316,270,2,1266,770,2624,209,585,12,900,696,2402,18,333
750,778,47,2250,1912,5737,668,1152,109,2071,2129,6129,18,334
447,829,34,2074,1571,4955,335,1207,119,1904,2017,5582,18,335
387,545,16,1959,1417,4324,326,1212,24,1872,1927,5361,18,336
2180,963,5,2096,3244,8488,2143,1475,15,1983,3409,9025,18,337
2745,994,7,2274,3395,9415,2237,1915,23,2074,3943,10192,18,338
2871,1034,15,2293,3374,9587,2243,1924,27,2037,3838,10069,18,339
2677,1005,10,2241,3390,9323,2051,1871,23,1878,3921,9744,18,340
2028,1256,62,2327,3457,9130,1912,1764,181,2147,3387,9391,18,341
537,1234,110,2936,2387,7204,390,1943,237,2317,2512,7399,18,342
410,721,7,2568,1958,5664,339,1322,37,2164,2177,6039,18,343
2334,1095,5,2069,3208,8711,2137,1565,21,1949,3535,9207,18,344
2960,1111,7,2346,3485,9909,2264,1967,29,1954,4227,10441,18,345
3023,1166,5,2282,3126,9602,2106,1954,27,2074,3744,9905,18,346
2831,1299,9,2482,3557,10178,2168,2162,42,2118,4032,10522,18,347
2136,1482,78,2552,3715,9963,1946,2032,261,2327,3576,10142,18,348
574,1423,107,3206,2409,7719,397,1846,263,2554,2790,7850,18,349
426,628,9,2450,1670,5183,328,1205,16,2056,2000,5605,18,350
2204,1072,7,2217,3228,8728,2118,1481,18,1985,3564,9166,18,351
2686,1152,17,2499,3520,9874,2218,1929,33,2131,3863,10174,18,352
2682,1094,9,2395,3586,9766,2206,1797,33,2206,3761,10003,18,353
2334,1148,4,2285,3450,9221,1962,1739,33,2054,3421,9209,18,354
1827,1158,55,2320,3259,8619,1733,1522,148,2214,2763,8380,18,355
534,862,33,2579,1872,5880,382,1028,127,2107,1955,5599,18,356
423,518,8,2057,1512,4518,262,851,19,1653,1643,4428,18,357
1090,755,5,2122,2442,6414,1019,993,16,1869,2273,6170,18,358
784,505,1,2007,1644,4941,793,621,13,1822,1401,4650,18,359
158,197,1,702,505,1563,104,404,5,509,532,1554,18,360
749,625,15,1554,1872,4815,812,958,28,1516,1823,5137,18,361
916,771,37,1724,2149,5597,872,1020,94,1688,1972,5646,18,362
400,694,53,1503,1325,3975,263,887,123,1280,1452,4005,18,363
344,522,5,1571,1260,3702,232,813,30,1429,1520,4024,18,364
1105,763,2,2065,2375,6310,1029,1234,17,1941,2582,6803,18,365
1062,1118,428,2220,2014,6842,950,1294,526,2168,2051,6989,18,366
93,81,9,244,139,566,46,169,11,142,230,598,19,1
483,107,33,432,348,1403,160,293,45,282,579,1359,19,2
658,109,17,428,481,1693,248,303,18,337,754,1660,19,3
746,133,25,420,442,1766,296,322,34,324,763,1739,19,4
655,133,5,384,410,1587,277,298,27,290,654,1546,19,5
142,99,8,226,131,606,56,206,20,153,171,606,19,6
112,84,9,320,414,939,44,206,9,431,238,928,19,7
753,107,17,412,491,1780,304,295,20,320,819,1758,19,8
742,90,9,370,336,1547,277,195,8,371,607,1458,19,9
804,126,18,416,481,1845,291,303,20,348,797,1759,19,10
879,132,9,497,487,2004,363,336,17,384,832,1932,19,11
741,123,5,407,423,1699,294,299,29,308,646,1576,19,12
159,112,16,429,227,943,46,240,35,179,308,808,19,13
105,96,8,243,127,579,39,180,12,151,195,577,19,14
164,113,5,285,135,702,108,247,11,297,258,921,19,15
284,96,7,271,217,875,107,268,16,197,280,868,19,16
620,178,10,591,451,1850,218,346,12,396,777,1749,19,17
840,114,4,416,457,1831,324,312,12,350,836,1834,19,18
287,133,7,301,236,964,127,218,31,210,299,885,19,19
144,110,6,313,153,726,42,217,21,159,212,651,19,20
92,108,25,263,144,632,34,176,23,155,203,591,19,21
750,130,10,449,446,1785,322,291,21,305,847,1786,19,22
850,150,9,461,489,1959,348,375,21,371,894,2009,19,23
851,137,20,407,489,1904,331,327,15,323,893,1889,19,24
754,155,7,406,497,1819,289,383,7,290,845,1814,19,25
554,153,7,489,392,1595,214,400,29,341,566,1550,19,26
166,187,22,403,237,1015,64,295,35,217,325,936,19,27
100,100,13,271,130,614,42,192,7,132,235,608,19,28
768,126,7,339,425,1665,333,296,13,264,815,1721,19,29
864,155,19,452,484,1974,378,377,22,369,894,2040,19,30
768,118,13,492,528,1919,320,377,19,367,829,1912,19,31
846,126,14,485,529,2000,329,317,24,368,939,1977,19,32
739,151,14,487,550,1941,306,327,26,415,754,1828,19,33
154,158,10,388,238,948,64,254,33,196,376,923,19,34
124,98,6,326,173,727,53,227,14,179,250,723,19,35
839,128,21,441,444,1873,380,298,24,340,869,1911,19,36
891,201,5,490,511,2098,357,403,13,395,935,2103,19,37
859,170,13,478,569,2089,365,419,27,390,879,2080,19,38
860,174,6,491,545,2076,385,375,15,415,906,2096,19,39
768,133,8,480,486,1875,308,328,24,373,738,1771,19,40
183,141,9,429,219,981,51,304,34,246,306,941,19,41
100,92,6,247,184,629,38,184,5,154,285,666,19,42
740,137,11,422,498,1808,297,283,27,315,878,1800,19,43
898,152,16,469,500,2035,333,366,36,359,859,1953,19,44
871,157,13,469,526,2036,339,356,21,437,879,2032,19,45
768,135,0,428,491,1822,329,348,9,324,862,1872,19,46
564,111,7,463,333,1478,193,304,29,370,549,1445,19,47
145,108,7,327,173,760,44,237,22,167,244,714,19,48
91,118,12,238,193,652,38,245,12,147,223,665,19,49
234,133,10,310,220,907,84,310,16,188,392,990,19,50
770,168,7,418,489,1852,303,378,18,277,852,1828,19,51
838,161,7,418,486,1910,329,355,9,370,866,1929,19,52
746,152,8,418,485,1809,300,323,19,343,802,1787,19,53
705,147,7,504,479,1842,279,334,25,376,712,1726,19,54
174,123,11,424,181,913,62,213,67,202,308,852,19,55
120,92,25,265,151,653,44,235,27,153,206,665,19,56
752,169,6,443,472,1842,302,389,11,329,844,1875,19,57
878,120,29,427,463,1917,380,312,26,334,863,1915,19,58
795,127,12,464,416,1814,314,286,19,409,739,1767,19,59
757,128,6,431,469,1791,328,328,13,368,784,1821,19,60
795,224,10,473,509,2011,351,364,36,347,801,1899,19,61
140,113,6,361,199,819,54,242,21,172,244,733,19,62
109,98,5,319,208,739,46,203,9,202,254,714,19,63
803,148,5,421,502,1879,270,317,16,309,880,1792,19,64
828,172,11,502,520,2033,311,357,12,421,951,2052,19,65
820,130,10,440,553,1953,321,326,22,393,922,1984,19,66
866,194,2,437,520,2019,336,407,11,405,845,2004,19,67
803,193,9,510,581,2096,357,369,26,451,731,1934,19,68
143,195,4,330,231,903,57,293,30,278,273,931,19,69
114,165,3,347,214,843,50,242,9,279,252,832,19,70
755,196,3,423,427,1804,331,306,13,324,863,1837,19,71
803,252,3,421,415,1894,331,415,7,308,984,2045,19,72
854,184,5,475,572,2090,354,368,15,445,927,2109,19,73
685,206,5,528,474,1898,235,443,16,405,793,1892,19,74
493,196,7,570,389,1655,159,349,41,426,668,1643,19,75
152,161,10,433,301,1057,64,369,47,294,361,1135,19,76
106,145,3,282,222,758,48,249,8,184,257,746,19,77
830,143,4,444,475,1896,347,358,9,328,862,1904,19,78
911,145,4,450,503,2013,349,377,10,357,949,2042,19,79
932,242,2,551,528,2255,377,454,5,452,917,2205,19,80
959,160,15,500,539,2173,425,376,20,388,925,2134,19,81
831,212,9,482,524,2058,344,419,36,394,821,2014,19,82
129,125,16,379,217,866,58,282,30,180,288,838,19,83
127,99,10,315,275,826,50,254,12,271,290,877,19,84
810,152,13,484,472,1931,333,388,17,338,917,1993,19,85
924,179,13,512,565,2193,364,360,14,405,988,2131,19,86
885,141,23,477,472,1998,345,405,20,472,744,1986,19,87
869,178,18,479,519,2063,362,344,25,439,903,2073,19,88
730,180,6,546,576,2038,296,424,31,439,789,1979,19,89
156,143,8,439,214,960,54,313,38,227,308,940,19,90
87,115,11,324,162,699,38,249,15,146,243,691,19,91
706,126,26,505,458,1821,295,343,38,323,785,1784,19,92
812,216,9,557,484,2078,302,380,15,450,967,2114,19,93
863,167,13,427,497,1967,361,410,13,417,762,1963,19,94
900,184,7,575,612,2278,391,395,22,440,1036,2284,19,95
622,169,4,552,378,1725,223,355,31,338,700,1647,19,96
173,187,8,447,226,1041,53,359,19,239,344,1014,19,97
125,126,4,375,188,818,54,298,7,218,283,860,19,98
743,141,5,484,411,1784,316,332,13,339,784,1784,19,99
959,176,9,471,479,2094,374,415,17,395,819,2020,19,100
902,163,8,599,633,2305,413,388,20,492,981,2294,19,101
936,152,4,503,524,2119,375,342,10,417,842,1986,19,102
804,166,6,519,492,1987,344,349,31,443,765,1932,19,103
182,169,8,496,268,1123,82,336,32,307,308,1065,19,104
132,134,2,393,233,894,45,325,8,187,308,873,19,105
546,163,6,525,350,1590,158,369,17,328,702,1574,19,106
600,171,2,585,341,1699,144,444,13,436,688,1725,19,107
652,164,8,484,334,1642,203,357,16,345,603,1524,19,108
585,219,8,498,366,1676,191,418,11,369,704,1693,19,109
539,225,25,479,338,1606,159,412,40,338,563,1512,19,110
176,178,6,461,357,1178,71,404,38,267,348,1128,19,111
134,135,4,297,156,726,60,277,6,152,243,738,19,112
795,155,9,447,481,1887,288,319,13,344,916,1880,19,113
972,160,6,493,548,2179,381,397,16,394,922,2110,19,114
920,152,4,503,499,2078,335,399,12,426,824,1996,19,115
853,197,3,500,482,2035,321,419,12,403,851,2006,19,116
779,164,0,497,457,1897,373,366,24,395,766,1924,19,117
180,146,5,403,211,945,70,315,24,242,291,942,19,118
138,129,2,355,234,858,57,290,8,220,288,863,19,119
906,138,3,498,467,2012,380,269,11,373,725,1758,19,120
921,166,3,496,437,2023,391,409,11,430,854,2095,19,121
941,235,2,530,523,2231,375,466,7,456,857,2161,19,122
891,173,6,504,524,2098,362,367,12,377,924,2042,19,123
767,182,8,521,556,2034,332,388,35,391,788,1934,19,124
164,127,7,375,195,868,49,314,30,206,272,871,19,125
98,119,2,349,188,756,52,262,4,206,268,792,19,126
829,163,3,459,467,1921,345,363,7,380,841,1936,19,127
876,176,6,489,481,2028,340,419,10,391,831,1991,19,128
997,170,6,933,497,2603,455,405,15,828,845,2548,19,129
904,162,6,496,551,2119,393,374,16,436,867,2086,19,130
754,154,7,481,449,1845,354,334,38,412,719,1857,19,131
163,121,9,406,222,921,65,284,33,236,341,959,19,132
108,123,3,341,167,742,52,236,7,182,268,745,19,133
812,150,1,461,436,1860,320,341,13,352,797,1823,19,134
922,833,5,478,409,2647,377,394,8,402,1438,2619,19,135
848,115,7,508,439,1917,316,318,8,443,785,1870,19,136
880,157,1,537,412,1987,368,376,10,432,839,2025,19,137
815,182,18,496,481,1992,360,358,41,382,747,1888,19,138
129,171,11,348,178,837,51,286,30,213,285,865,19,139
147,110,5,338,826,1426,64,254,20,734,366,1438,19,140
848,139,2,476,461,1926,320,333,7,376,841,1877,19,141
906,159,1,466,504,2036,362,413,11,357,857,2000,19,142
928,162,2,562,485,2139,389,359,15,461,849,2073,19,143
814,165,2,462,481,1924,327,368,6,394,814,1909,19,144
665,164,13,504,535,1881,288,379,66,390,727,1850,19,145
162,115,9,412,249,947,63,345,41,212,307,968,19,146
113,125,2,365,202,807,36,310,22,164,253,785,19,147
142,110,4,324,174,754,56,237,9,200,258,760,19,148
809,153,2,470,432,1866,333,349,9,364,785,1840,19,149
873,632,3,483,403,2394,351,356,8,382,1226,2323,19,150
843,185,2,509,464,2003,350,357,13,406,866,1992,19,151
821,188,5,533,470,2017,341,423,20,429,762,1975,19,152
166,156,10,452,362,1146,61,342,39,305,406,1153,19,153
166,106,7,383,195,857,59,247,19,214,309,848,19,154
880,114,0,568,425,1987,382,353,3,474,846,2058,19,155
819,129,6,546,400,1900,261,360,8,395,758,1782,19,156
989,149,0,550,382,2070,410,329,8,427,779,1953,19,157
824,156,1,485,492,1958,320,390,3,379,803,1895,19,158
718,194,7,553,489,1961,301,419,32,453,696,1901,19,159
163,195,7,506,357,1228,74,464,75,253,320,1186,19,160
136,114,1,367,200,818,43,329,7,191,293,863,19,161
762,122,4,493,377,1758,286,308,7,388,736,1725,19,162
785,127,0,489,436,1837,313,315,5,363,768,1764,19,163
892,146,0,608,546,2192,384,420,8,495,838,2145,19,164
747,139,6,537,518,1947,272,308,13,462,794,1849,19,165
599,594,5,535,417,2150,252,547,35,380,874,2088,19,166
166,171,6,456,247,1046,63,301,34,254,400,1052,19,167
114,113,4,355,149,735,50,289,10,192,242,783,19,168
604,185,7,568,399,1763,261,360,10,380,728,1739,19,169
621,216,7,631,356,1831,352,376,11,432,644,1815,19,170
280,228,10,434,268,1220,95,366,12,262,455,1190,19,171
587,181,7,505,419,1699,234,344,17,372,670,1637,19,172
536,155,14,532,422,1659,224,362,32,415,557,1590,19,173
149,165,11,365,850,1540,83,297,47,671,338,1436,19,174
126,98,3,274,668,1169,60,243,18,500,350,1171,19,175
631,133,0,478,284,1526,190,330,6,358,604,1488,19,176
713,139,0,490,297,1639,225,299,5,404,711,1644,19,177
784,137,6,494,327,1748,245,327,8,365,722,1667,19,178
718,711,7,514,354,2304,226,466,22,380,1158,2252,19,179
645,171,10,577,308,1711,224,351,34,435,646,1690,19,180
156,125,1,354,815,1451,71,294,37,698,307,1407,19,181
109,98,5,321,166,699,57,253,7,193,221,731,19,182
697,130,4,552,292,1675,256,356,11,387,654,1664,19,183
723,154,1,544,340,1762,257,363,6,457,676,1759,19,184
685,153,4,590,347,1779,242,386,16,524,595,1763,19,185
158,312,3,305,228,1006,63,572,46,215,349,1245,19,186
452,118,9,390,238,1207,156,297,17,332,398,1200,19,187
141,144,10,333,153,781,48,265,37,178,263,791,19,188
120,108,4,292,146,670,54,202,10,166,235,667,19,189
632,116,3,510,277,1538,228,295,9,377,554,1463,19,190
709,138,6,517,271,1641,249,309,12,428,618,1616,19,191
773,91,3,477,289,1633,230,261,5,410,643,1549,19,192
716,127,7,500,301,1651,228,332,9,401,700,1670,19,193
572,131,5,476,305,1489,191,311,29,357,521,1409,19,194
144,138,28,371,187,868,61,324,38,204,237,864,19,195
125,85,1,282,668,1161,75,204,4,613,255,1151,19,196
660,90,25,438,282,1495,208,287,31,337,621,1484,19,197
704,102,13,436,276,1531,210,292,11,394,594,1501,19,198
676,86,8,434,283,1487,225,239,11,336,654,1465,19,199
676,110,1,491,299,1577,207,294,10,364,619,1494,19,200
491,104,5,387,325,1312,150,335,39,282,544,1350,19,201
126,107,7,348,165,753,54,268,27,195,247,791,19,202
123,105,0,314,174,716,39,206,5,168,226,644,19,203
665,79,1,388,263,1396,220,233,5,339,592,1389,19,204
682,120,10,444,322,1578,220,279,6,360,689,1554,19,205
679,111,9,489,345,1633,186,297,12,404,666,1565,19,206
638,121,5,394,278,1436,179,280,8,321,609,1397,19,207
544,137,4,447,346,1478,178,261,23,343,585,1390,19,208
122,110,4,416,220,872,73,298,49,189,287,896,19,209
109,92,2,311,168,682,48,241,10,166,230,695,19,210
589,103,5,415,297,1409,194,256,8,315,561,1334,19,211
667,103,3,402,323,1498,227,258,3,327,624,1439,19,212
684,109,3,445,266,1507,232,255,12,332,619,1450,19,213
637,107,0,529,315,1588,216,274,9,378,637,1514,19,214
547,119,7,462,316,1451,207,285,39,367,491,1389,19,215
136,114,3,366,156,775,48,241,26,199,272,786,19,216
133,70,10,282,142,637,42,201,13,147,249,652,19,217
578,117,3,428,299,1425,209,270,7,314,552,1352,19,218
611,120,3,458,297,1489,205,290,9,332,601,1437,19,219
589,95,3,437,298,1422,225,276,5,279,603,1388,19,220
591,86,1,447,275,1400,210,246,5,336,557,1354,19,221
472,106,2,382,282,1244,171,299,23,258,424,1175,19,222
140,119,4,326,239,828,61,264,20,230,265,840,19,223
138,86,2,282,157,665,66,204,9,197,217,693,19,224
530,95,1,406,297,1329,206,243,10,331,541,1331,19,225
618,119,2,406,352,1497,218,245,8,306,696,1473,19,226
627,114,7,386,316,1450,211,276,18,290,632,1427,19,227
625,107,3,404,358,1497,230,266,6,317,617,1436,19,228
587,120,6,461,362,1536,231,256,22,371,511,1391,19,229
147,95,3,335,716,1296,60,215,29,693,236,1233,19,230
114,81,1,290,135,621,57,167,5,176,206,611,19,231
584,79,7,386,302,1358,219,224,7,265,606,1321,19,232
659,761,4,407,331,2162,231,371,6,311,1189,2108,19,233
669,131,4,458,347,1609,215,318,4,344,655,1536,19,234
638,103,0,456,345,1542,221,295,7,355,673,1551,19,235
620,687,5,498,383,2193,214,515,25,337,971,2062,19,236
159,112,14,359,186,830,53,230,25,184,260,752,19,237
119,81,9,259,175,643,49,200,9,148,221,627,19,238
724,84,3,411,356,1578,282,280,4,338,691,1595,19,239
777,112,8,432,417,1746,315,305,13,341,756,1730,19,240
1011,107,10,456,431,2015,399,292,15,430,762,1898,19,241
799,97,4,455,391,1746,299,250,8,342,747,1646,19,242
762,536,5,417,384,2104,299,390,24,325,943,1981,19,243
137,123,7,339,723,1329,59,247,30,636,304,1276,19,244
125,80,3,323,158,689,52,190,5,208,245,700,19,245
125,113,2,271,153,664,43,231,2,179,255,710,19,246
814,135,2,440,416,1807,308,325,9,318,822,1782,19,247
859,88,1,429,408,1785,350,261,7,351,725,1694,19,248
855,163,3,474,443,1938,353,368,8,349,797,1875,19,249
788,171,7,459,401,1826,324,382,26,319,748,1799,19,250
135,97,8,346,198,784,47,223,17,207,252,746,19,251
109,117,5,305,663,1199,58,267,4,592,327,1248,19,252
841,113,0,429,387,1770,345,276,4,246,733,1604,19,253
897,170,0,441,434,1942,357,362,4,332,822,1877,19,254
943,117,2,456,441,1959,354,333,14,349,788,1838,19,255
854,117,1,422,433,1827,327,341,13,304,803,1788,19,256
793,131,5,472,467,1868,315,373,27,326,724,1765,19,257
148,135,8,401,210,902,55,288,34,205,311,893,19,258
148,93,1,328,696,1266,72,212,5,589,321,1199,19,259
875,101,2,436,400,1814,377,294,2,330,791,1794,19,260
908,845,3,429,404,2589,381,444,6,346,1468,2645,19,261
868,141,5,416,451,1881,342,342,13,356,763,1816,19,262
930,326,1,497,532,2286,403,497,8,365,906,2179,19,263
822,155,35,485,461,1958,342,393,46,349,763,1893,19,264
159,95,7,387,218,866,74,297,40,211,311,933,19,265
129,89,1,306,191,716,46,220,3,205,227,701,19,266
833,101,11,371,383,1699,344,305,17,318,744,1728,19,267
899,136,8,452,463,1958,357,378,8,333,834,1910,19,268
1081,156,5,520,460,2222,421,388,13,414,837,2073,19,269
1068,166,12,500,496,2242,417,348,23,402,951,2141,19,270
774,148,5,444,465,1836,334,433,20,361,674,1822,19,271
178,240,21,495,286,1220,75,431,80,277,383,1246,19,272
146,75,1,345,163,730,55,239,4,166,253,717,19,273
836,165,3,431,445,1880,355,388,8,329,834,1914,19,274
832,154,5,391,396,1778,331,355,12,305,789,1792,19,275
862,140,3,460,436,1901,351,362,7,354,823,1897,19,276
831,150,2,467,434,1884,347,378,6,366,797,1894,19,277
767,167,7,504,440,1885,312,375,40,332,702,1761,19,278
153,112,3,358,210,836,58,274,18,230,270,850,19,279
109,96,22,283,169,679,36,209,19,157,239,660,19,280
830,125,14,400,409,1778,346,370,9,283,755,1763,19,281
979,155,7,472,482,2095,356,395,10,362,892,2015,19,282
865,143,15,460,434,1917,360,359,23,362,841,1945,19,283
680,167,5,463,396,1711,249,408,10,349,712,1728,19,284
600,109,7,482,352,1550,227,314,29,371,586,1527,19,285
171,101,4,344,201,821,66,271,27,216,273,853,19,286
146,93,10,362,178,789,41,239,14,199,260,753,19,287
286,97,6,320,240,949,105,245,6,206,420,982,19,288
840,110,6,463,499,1918,353,345,11,318,913,1940,19,289
903,118,12,471,440,1944,368,355,16,410,838,1987,19,290
868,161,5,460,406,1900,336,352,9,348,829,1874,19,291
747,146,9,473,447,1822,325,362,43,315,707,1752,19,292
159,145,9,421,274,1008,49,337,39,219,329,973,19,293
133,122,6,282,134,677,50,240,6,145,252,693,19,294
820,109,4,452,431,1816,347,303,7,319,791,1767,19,295
864,111,9,474,455,1913,367,310,13,370,850,1910,19,296
852,131,6,453,414,1856,330,332,4,372,865,1903,19,297
811,134,5,483,434,1867,352,325,11,313,838,1839,19,298
868,138,8,423,411,1848,377,305,30,318,678,1708,19,299
178,129,2,407,186,902,79,248,34,237,300,898,19,300
129,77,3,286,131,626,51,222,7,186,226,692,19,301
865,128,1,411,409,1814,343,291,3,333,800,1770,19,302
860,112,2,476,522,1972,332,351,3,348,919,1953,19,303
933,181,2,494,463,2073,379,424,5,384,828,2020,19,304
806,158,3,473,481,1921,340,340,16,359,770,1825,19,305
767,145,2,435,456,1805,339,302,37,350,702,1730,19,306
157,136,6,362,226,887,49,257,34,226,324,890,19,307
138,69,2,362,158,729,67,160,13,196,257,693,19,308
781,77,5,417,334,1614,268,251,2,322,670,1513,19,309
594,91,8,452,329,1474,186,228,15,375,624,1428,19,310
897,82,4,515,398,1896,408,189,3,422,749,1771,19,311
812,92,1,475,447,1827,327,283,4,344,858,1816,19,312
742,181,7,431,520,1881,340,303,21,322,808,1794,19,313
146,98,0,352,180,776,56,214,26,199,289,784,19,314
126,62,2,279,198,667,67,162,5,207,275,716,19,315
274,86,5,351,203,919,109,219,11,248,386,973,19,316
881,114,7,433,448,1883,374,289,4,367,836,1870,19,317
871,106,0,491,404,1872,340,282,4,383,817,1826,19,318
831,76,1,423,425,1756,339,252,4,368,758,1721,19,319
719,95,3,437,435,1689,302,244,17,345,759,1667,19,320
156,89,2,354,232,833,63,216,26,208,313,826,19,321
118,57,3,269,164,611,53,167,6,199,230,655,19,322
831,98,3,423,387,1742,358,282,4,316,799,1759,19,323
838,123,2,463,365,1791,364,307,9,367,805,1852,19,324
861,92,21,444,410,1828,322,267,22,339,853,1803,19,325
791,87,4,445,433,1760,345,276,3,347,797,1768,19,326
691,146,1,369,341,1548,287,255,19,327,667,1555,19,327
138,81,2,338,187,746,55,193,22,173,274,717,19,328
138,82,2,256,114,592,35,172,2,164,237,610,19,329
745,132,8,368,408,1661,271,277,28,327,752,1655,19,330
635,80,5,428,369,1517,249,276,8,358,701,1592,19,331
444,149,1,474,397,1465,144,321,6,389,623,1483,19,332
80,55,0,166,68,369,48,77,4,162,144,435,19,333
260,115,3,359,216,953,52,197,22,222,376,869,19,334
109,88,33,282,182,694,56,156,53,175,244,684,19,335
100,64,5,234,153,556,46,160,17,141,220,584,19,336
733,76,1,381,324,1515,317,251,0,302,747,1617,19,337
869,95,28,463,390,1845,345,338,27,373,802,1885,19,338
819,91,2,442,337,1691,314,240,15,371,791,1731,19,339
781,94,3,467,456,1801,350,292,5,392,787,1826,19,340
714,148,0,412,372,1646,271,247,19,364,747,1648,19,341
147,104,2,350,265,868,65,265,18,241,286,875,19,342
113,65,7,284,191,660,32,217,14,202,220,685,19,343
983,84,9,444,398,1918,382,284,9,357,805,1837,19,344
1044,88,15,503,432,2082,423,286,17,368,840,1934,19,345
801,80,3,353,377,1614,308,249,7,321,743,1628,19,346
985,100,1,525,493,2104,399,312,8,407,781,1907,19,347
840,98,2,460,453,1853,338,270,29,354,753,1744,19,348
139,85,1,341,255,821,56,208,26,229,265,784,19,349
116,103,4,294,193,710,53,217,7,229,231,737,19,350
947,75,2,413,466,1903,342,259,3,382,810,1796,19,351
1049,110,2,509,441,2111,408,322,6,420,856,2012,19,352
940,682,1,548,384,2555,369,595,5,497,1021,2487,19,353
841,100,4,438,429,1812,341,304,9,385,714,1753,19,354
732,107,20,421,352,1632,320,259,31,372,577,1559,19,355
135,109,6,341,182,773,93,194,16,216,300,819,19,356
114,71,9,267,155,616,46,195,11,158,234,644,19,357
449,112,9,435,285,1290,121,263,10,290,500,1184,19,358
308,81,0,405,197,991,110,167,6,305,331,919,19,359
49,57,4,130,90,330,39,81,7,93,119,339,19,360
326,77,0,361,251,1015,105,263,1,262,398,1029,19,361
351,89,4,381,234,1059,118,227,14,279,387,1025,19,362
96,75,9,304,146,630,41,192,27,140,209,609,19,363
96,48,4,270,246,664,43,154,7,225,261,690,19,364
411,85,2,460,280,1238,143,226,0,335,480,1184,19,365
424,198,21,411,277,1331,140,296,45,342,442,1265,19,366
95,167,30,516,268,1076,45,290,43,374,488,1240,20,1
1191,222,5,675,673,2766,476,443,3,516,1484,2922,20,2
1410,240,6,725,888,3269,564,599,11,555,1712,3441,20,3
1453,270,7,692,825,3247,500,583,13,573,1701,3370,20,4
847,367,29,684,959,2886,349,816,62,510,1222,2959,20,5
182,293,20,722,463,1680,68,537,43,540,494,1682,20,6
164,186,8,923,389,1670,70,368,14,627,724,1803,20,7
1278,281,8,536,844,2947,450,625,20,510,1418,3023,20,8
1710,259,7,663,722,3361,581,520,12,612,1741,3466,20,9
1853,359,8,760,983,3963,658,744,11,649,2170,4232,20,10
1724,393,8,803,1098,4026,586,952,16,602,1936,4092,20,11
23,14,2,5,3,47,26,19,2,7,6,60,20,12
3,0,2,2,1,8,3,1,3,5,2,14,20,13
1,4,1,3,10,19,1,3,3,5,11,23,20,14
4,3,7,10,5,29,4,3,8,8,5,28,20,15
644,263,2,509,632,2050,299,587,4,464,741,2095,20,16
1658,376,4,768,885,3691,480,858,12,580,1827,3757,20,17
1820,381,5,848,1095,4149,560,1163,6,683,2074,4486,20,18
677,484,38,714,763,2676,227,912,91,598,1024,2852,20,19
226,445,26,1169,758,2624,86,786,95,824,903,2694,20,20
156,174,5,873,536,1744,68,444,14,654,731,1911,20,21
1347,229,8,648,765,2997,471,639,13,498,1535,3156,20,22
1969,359,6,815,1054,4203,636,888,8,596,2226,4354,20,23
1949,322,0,868,1066,4205,609,1029,15,651,2030,4334,20,24
1750,384,0,868,1049,4051,584,985,14,597,1916,4096,20,25
980,542,37,800,1023,3382,389,910,112,690,1341,3442,20,26
222,469,50,1219,772,2732,89,787,94,876,1060,2906,20,27
162,262,3,890,471,1788,78,440,6,728,675,1927,20,28
1363,246,2,672,739,3022,456,658,9,538,1529,3190,20,29
2032,354,0,864,978,4228,657,922,5,617,2240,4441,20,30
1996,362,1,824,1015,4198,623,1034,6,634,2146,4443,20,31
1915,352,3,890,1025,4185,623,942,12,661,2047,4285,20,32
1047,576,28,733,1023,3407,407,904,101,650,1245,3307,20,33
207,544,29,1321,791,2892,101,776,112,827,1093,2909,20,34
143,171,1,1002,456,1773,87,384,5,704,722,1902,20,35
1354,265,1,714,816,3150,496,658,9,584,1563,3310,20,36
2062,351,1,778,1125,4317,650,977,15,615,2239,4496,20,37
2043,368,1,882,1063,4357,685,965,20,671,2150,4491,20,38
1878,373,4,850,1046,4151,583,914,14,647,2051,4209,20,39
986,525,35,743,983,3272,401,879,87,629,1307,3303,20,40
173,436,18,1172,833,2632,71,871,104,731,1051,2828,20,41
150,456,3,881,523,2013,65,498,28,559,1081,2231,20,42
1281,204,9,718,794,3006,478,612,7,541,1508,3146,20,43
1859,375,7,864,1010,4115,602,966,9,608,2046,4231,20,44
1865,300,1,874,1050,4090,632,911,13,712,2000,4268,20,45
1753,331,7,867,1038,3996,557,873,35,595,2003,4063,20,46
961,518,35,888,982,3384,382,908,115,684,1267,3356,20,47
255,351,31,1392,763,2792,69,814,84,845,1104,2916,20,48
273,253,0,1171,503,2200,62,519,9,778,948,2316,20,49
475,230,1,961,570,2237,227,530,4,658,936,2355,20,50
1967,300,10,849,1056,4182,652,911,14,621,2164,4362,20,51
2020,279,0,878,1042,4219,629,902,4,710,2078,4323,20,52
1890,344,1,815,1062,4112,605,1032,14,629,1902,4182,20,53
1068,531,32,849,939,3419,404,921,77,689,1365,3456,20,54
216,432,32,1323,835,2838,102,892,88,799,1071,2952,20,55
215,179,2,1020,548,1964,99,477,4,734,785,2099,20,56
1408,253,2,752,908,3323,498,797,5,584,1629,3513,20,57
2056,294,3,859,1062,4274,654,940,10,593,2304,4501,20,58
2024,378,4,802,940,4148,641,837,7,649,2176,4310,20,59
1830,424,10,884,1048,4196,595,977,16,643,2107,4338,20,60
1063,505,30,837,1145,3580,405,929,101,680,1455,3570,20,61
233,504,64,1277,844,2922,109,853,107,847,1043,2959,20,62
199,216,14,1308,556,2293,82,469,23,830,1143,2547,20,63
1448,334,4,767,772,3325,524,736,8,556,1669,3493,20,64
2107,328,7,859,1034,4335,632,897,14,586,2228,4357,20,65
2088,362,13,847,1141,4451,673,1060,11,669,2179,4592,20,66
1909,444,9,905,1092,4359,590,1058,48,688,2091,4475,20,67
1202,548,35,831,1083,3699,428,998,100,698,1421,3645,20,68
277,464,45,1317,737,2840,97,827,82,890,1052,2948,20,69
240,238,5,1138,572,2193,74,506,7,798,959,2344,20,70
1400,308,2,806,804,3320,493,786,7,553,1580,3419,20,71
2088,414,6,984,1070,4562,603,1084,16,662,2415,4780,20,72
2098,395,1,1066,1170,4730,638,1255,19,772,2150,4834,20,73
1933,473,7,1073,1388,4874,614,1234,92,765,2259,4964,20,74
1072,630,27,1154,1207,4090,383,1108,195,951,1697,4334,20,75
676,829,56,2048,1092,4701,166,1422,124,1706,1657,5075,20,76
276,387,1,1315,722,2701,101,830,4,1028,1312,3275,20,77
1497,320,3,868,987,3675,565,862,7,646,1891,3971,20,78
2225,379,8,910,1202,4724,634,1118,11,620,2344,4727,20,79
2050,417,14,959,1340,4780,655,1411,24,683,2301,5074,20,80
1947,441,25,1084,1317,4814,638,1367,27,753,2127,4912,20,81
1337,581,58,1069,1430,4475,449,1359,117,758,1664,4347,20,82
323,647,48,1376,1034,3428,92,1129,110,766,1281,3378,20,83
345,286,0,1888,818,3337,78,792,5,1082,1468,3425,20,84
1565,364,7,1261,1171,4368,455,1055,38,705,1924,4177,20,85
2121,429,7,1327,1298,5182,585,1213,11,674,2484,4967,20,86
1879,437,13,1058,931,4318,555,983,14,654,2262,4468,20,87
1731,401,12,1201,1188,4533,502,1100,21,754,2098,4475,20,88
961,637,36,1369,1177,4180,339,1138,108,841,1640,4066,20,89
345,486,29,2285,1001,4146,102,1245,110,1168,1540,4165,20,90
329,215,11,1330,540,2425,116,616,14,865,988,2599,20,91
1300,341,5,1168,890,3704,457,940,14,642,1739,3792,20,92
2073,350,9,1135,1076,4643,642,1112,11,844,2422,5031,20,93
2161,354,15,959,1227,4716,672,1144,13,677,2369,4875,20,94
2117,462,17,1239,1364,5199,598,1344,31,876,2402,5251,20,95
1131,609,37,1196,1323,4296,385,1441,79,732,1761,4398,20,96
529,554,45,1974,1073,4175,118,1284,126,1239,1390,4157,20,97
762,218,9,1450,606,3045,109,725,9,1257,1009,3109,20,98
1374,276,5,960,816,3431,488,778,12,601,1699,3578,20,99
2059,400,7,953,1082,4501,655,1096,23,649,2179,4602,20,100
2044,435,4,1078,1071,4632,642,1099,16,723,2284,4764,20,101
1921,411,9,932,1091,4364,557,1112,19,681,2037,4406,20,102
1148,634,44,1001,1015,3842,411,1072,91,732,1459,3765,20,103
342,597,35,1743,1030,3747,115,1231,114,1031,1249,3740,20,104
242,299,1,1346,532,2420,110,671,2,903,1079,2765,20,105
1468,300,7,920,958,3653,479,1002,14,650,1782,3927,20,106
2245,427,1,955,1114,4742,681,1147,4,698,2295,4825,20,107
2172,472,11,1060,1106,4821,649,1122,29,905,2370,5075,20,108
1994,478,9,1047,1207,4735,619,1235,20,756,2167,4797,20,109
1216,533,37,1030,1243,4059,394,1190,130,721,1609,4044,20,110
294,599,25,2080,1205,4203,111,1462,92,910,1557,4132,20,111
216,198,2,1164,524,2104,70,483,10,740,948,2251,20,112
1488,318,7,886,825,3524,506,746,10,689,1739,3690,20,113
2172,376,12,969,1242,4771,709,1266,19,624,2328,4946,20,114
2085,437,20,995,1284,4821,652,1305,24,735,2233,4949,20,115
2009,432,5,1098,1168,4712,617,1289,23,747,2073,4749,20,116
1077,577,25,926,1229,3834,375,1251,82,690,1545,3943,20,117
270,530,32,1436,913,3181,103,1018,215,937,1071,3344,20,118
215,311,10,1200,656,2392,105,709,86,803,1022,2725,20,119
1408,313,10,832,836,3399,466,833,14,617,1713,3643,20,120
2065,429,13,899,1019,4425,664,1021,19,666,2291,4661,20,121
2006,379,11,983,1099,4478,627,1083,16,755,2220,4701,20,122
1865,460,16,972,1160,4473,624,1132,30,742,2078,4606,20,123
1084,574,58,938,1249,3903,413,1281,116,721,1435,3966,20,124
323,505,47,1434,767,3076,117,999,91,829,1136,3172,20,125
230,240,9,1031,499,2009,146,545,14,778,885,2368,20,126
1384,306,6,802,771,3269,476,747,10,604,1700,3537,20,127
2073,410,18,870,1278,4649,659,1166,20,690,2223,4758,20,128
1987,401,7,899,1275,4569,634,1284,13,695,2090,4716,20,129
1804,451,9,857,1094,4215,614,1046,26,615,1886,4187,20,130
987,595,31,837,983,3433,395,889,78,647,1376,3385,20,131
302,490,31,1402,723,2948,146,755,78,935,1168,3082,20,132
221,216,4,930,468,1839,91,535,15,735,842,2218,20,133
1331,360,13,771,964,3439,539,900,24,610,1608,3681,20,134
2104,360,7,877,978,4326,656,928,12,644,2323,4563,20,135
2142,467,8,971,1116,4704,653,1154,22,727,2224,4780,20,136
2037,515,23,1009,1255,4839,616,1223,34,745,2082,4700,20,137
1069,563,34,969,1141,3776,414,1058,77,944,1415,3908,20,138
347,458,29,1303,829,2966,112,953,85,1028,972,3150,20,139
344,248,8,1311,592,2503,88,577,13,1001,1065,2744,20,140
1481,334,3,839,1017,3674,536,967,11,609,1737,3860,20,141
2085,450,7,981,1207,4730,654,1133,18,740,2190,4735,20,142
1961,408,12,990,1091,4462,669,960,18,696,2170,4513,20,143
1722,403,6,867,1058,4056,642,929,12,673,1886,4142,20,144
852,486,16,891,1221,3466,402,1073,96,764,1191,3526,20,145
293,412,34,1306,926,2971,120,1128,93,783,949,3073,20,146
271,386,6,1204,545,2412,65,749,21,811,943,2589,20,147
197,250,3,937,411,1798,77,433,14,663,822,2009,20,148
1781,298,8,808,1104,3999,660,875,15,681,2012,4243,20,149
2004,378,15,819,1027,4243,657,871,16,698,2171,4413,20,150
1849,410,7,927,1135,4328,621,1161,28,671,2008,4489,20,151
1076,551,41,809,1039,3516,434,948,139,678,1331,3530,20,152
316,518,18,1316,859,3027,135,984,78,970,1023,3190,20,153
228,231,9,1119,511,2098,104,528,10,762,862,2266,20,154
1518,344,7,731,966,3566,541,863,17,663,1803,3887,20,155
2208,363,10,871,1245,4697,726,1153,16,704,2346,4945,20,156
2060,400,11,957,1137,4565,722,1033,18,731,2318,4822,20,157
2038,462,10,906,1240,4656,661,1263,21,698,2145,4788,20,158
1150,670,34,896,1669,4419,446,1483,183,743,1430,4285,20,159
280,599,36,2064,1329,4308,141,1759,173,1034,1402,4509,20,160
217,254,7,1315,576,2369,95,740,12,825,1025,2697,20,161
1492,298,28,812,912,3542,548,774,27,639,1787,3775,20,162
2232,426,4,877,1166,4705,717,1130,20,701,2434,5002,20,163
2171,454,7,1001,1314,4947,701,1370,36,746,2271,5124,20,164
1944,438,4,968,1234,4588,668,1206,18,726,2082,4700,20,165
1143,578,42,1035,1348,4146,445,1281,98,881,1446,4151,20,166
297,509,23,1384,879,3092,146,1037,118,948,966,3215,20,167
209,267,14,1050,535,2075,92,604,28,840,828,2392,20,168
1450,314,6,806,834,3410,541,703,10,662,1741,3657,20,169
2023,550,10,942,1322,4847,657,1121,18,773,2305,4874,20,170
606,321,10,1057,919,2913,266,886,10,854,1062,3078,20,171
1790,432,8,955,989,4174,620,1008,35,646,2026,4335,20,172
1087,559,45,918,1036,3645,427,973,100,782,1351,3633,20,173
250,732,42,1305,848,3177,131,1296,140,958,917,3442,20,174
226,323,12,956,492,2009,98,519,31,738,834,2220,20,175
1405,334,8,706,795,3248,512,681,14,582,1689,3478,20,176
2073,421,19,813,1132,4458,680,930,21,629,2329,4589,20,177
2047,414,10,904,1097,4472,648,1018,17,734,2243,4660,20,178
1915,481,7,962,1127,4492,639,1164,21,684,2120,4628,20,179
1059,571,33,962,1167,3792,429,1075,99,765,1459,3827,20,180
241,548,37,1340,886,3052,122,955,84,1042,1037,3240,20,181
184,260,1,993,567,2005,89,535,12,721,832,2189,20,182
1279,298,6,936,987,3506,546,948,12,617,1662,3785,20,183
1752,389,2,962,1148,4253,622,1038,17,723,1997,4397,20,184
1393,506,8,1074,1313,4294,518,1264,43,849,1619,4293,20,185
314,1185,12,1609,887,4007,127,2077,41,1106,1212,4563,20,186
632,481,22,1145,952,3232,233,952,86,806,1213,3290,20,187
277,477,24,1220,728,2726,136,868,86,896,886,2872,20,188
234,235,18,932,450,1869,94,531,22,776,826,2249,20,189
1402,286,9,766,892,3355,538,740,12,611,1671,3572,20,190
1996,452,10,894,1080,4432,717,938,14,697,2253,4619,20,191
1948,449,6,884,1126,4413,678,1017,14,800,2121,4630,20,192
1769,441,7,926,1161,4304,647,1117,25,672,1981,4442,20,193
1114,560,28,874,1007,3583,412,988,90,724,1380,3594,20,194
231,573,22,1370,956,3152,112,1223,71,941,997,3344,20,195
190,267,9,1073,622,2161,95,516,20,980,795,2406,20,196
1484,290,8,782,871,3435,586,672,13,608,1698,3577,20,197
2060,419,8,785,1121,4393,708,984,13,716,2229,4650,20,198
2070,430,10,922,1023,4455,671,802,17,717,2349,4556,20,199
1921,450,3,950,1159,4483,621,1100,14,691,2027,4453,20,200
1052,610,38,987,1344,4031,387,1180,292,717,1476,4052,20,201
270,563,53,1401,1256,3543,105,1265,131,1036,1169,3706,20,202
219,282,8,1232,544,2285,85,565,11,789,960,2410,20,203
1366,316,7,874,866,3429,521,768,23,694,1709,3715,20,204
2086,421,8,907,1178,4600,671,1108,16,707,2322,4824,20,205
1861,434,18,1004,1289,4606,658,1180,17,689,2345,4889,20,206
1848,458,6,1028,1133,4473,603,1093,12,700,2179,4587,20,207
1040,609,40,983,1061,3733,391,1080,151,743,1540,3905,20,208
316,691,57,1402,960,3426,112,1122,243,947,1130,3554,20,209
238,294,10,1121,593,2256,78,646,20,790,909,2443,20,210
1502,298,3,844,1027,3674,548,814,37,644,1809,3852,20,211
2037,438,12,904,1045,4436,674,937,15,673,2301,4600,20,212
1985,431,8,992,1058,4474,659,916,13,708,2290,4586,20,213
1810,471,10,931,1166,4388,578,1053,18,734,2051,4434,20,214
1096,595,36,975,1222,3924,421,1219,81,709,1523,3953,20,215
293,395,21,1477,777,2963,760,832,94,931,1087,3704,20,216
215,263,7,1113,458,2056,103,523,15,795,891,2327,20,217
1372,335,6,802,881,3396,510,754,7,635,1699,3605,20,218
1927,404,7,893,1133,4364,654,992,12,683,2232,4573,20,219
1852,396,10,859,1053,4170,613,925,31,695,2063,4327,20,220
1593,324,6,828,897,3648,521,766,29,615,1758,3689,20,221
757,553,33,724,985,3052,341,904,156,660,1135,3196,20,222
255,515,40,1334,864,3008,129,965,91,933,930,3048,20,223
191,275,18,1074,515,2073,90,526,18,832,883,2349,20,224
1260,299,14,726,795,3094,479,719,16,529,1649,3392,20,225
1909,422,10,875,1041,4257,616,972,9,621,2191,4409,20,226
1841,448,8,840,1043,4180,602,973,13,682,2149,4419,20,227
1686,482,9,890,1062,4129,584,1068,30,716,1861,4259,20,228
934,759,31,810,1028,3562,379,995,83,690,1488,3635,20,229
209,828,35,1293,945,3310,124,845,110,1201,1160,3440,20,230
164,393,9,1089,639,2294,89,538,8,921,947,2503,20,231
1344,293,9,712,710,3068,479,615,9,623,1578,3304,20,232
1908,416,6,805,1077,4212,600,1019,13,621,2194,4447,20,233
1781,441,5,799,1091,4117,554,1026,16,584,2061,4241,20,234
1626,398,10,905,1079,4018,567,974,20,654,1932,4147,20,235
942,581,31,898,1024,3476,382,1047,105,715,1314,3563,20,236
287,540,41,1297,876,3041,138,1018,115,897,1043,3211,20,237
214,244,5,1102,550,2115,113,579,20,824,825,2361,20,238
1336,295,17,778,985,3411,501,894,20,627,1630,3672,20,239
2052,375,8,899,1299,4633,704,1147,16,597,2319,4783,20,240
1880,347,11,853,1168,4259,614,1142,24,637,2088,4505,20,241
1719,332,14,972,985,4022,558,839,16,723,1974,4110,20,242
862,509,37,962,1169,3539,369,1051,128,804,1196,3548,20,243
269,495,28,1453,785,3030,104,958,85,892,1005,3044,20,244
201,359,10,1273,562,2405,113,725,14,726,1064,2642,20,245
200,241,8,870,486,1805,104,556,15,696,781,2152,20,246
1967,329,19,832,958,4105,648,815,17,668,2203,4351,20,247
2022,355,4,845,1028,4254,666,964,6,650,2229,4515,20,248
1888,404,14,918,1120,4344,638,992,16,691,2125,4462,20,249
1024,578,68,842,1027,3539,428,1004,100,636,1378,3546,20,250
260,596,47,1471,906,3280,159,1057,174,984,1079,3453,20,251
195,290,14,1028,606,2133,107,500,22,938,870,2437,20,252
1513,322,12,775,901,3523,569,880,11,587,1774,3821,20,253
2335,455,5,960,1110,4865,692,1185,17,723,2463,5080,20,254
2177,374,7,913,1159,4630,641,1126,10,708,2421,4906,20,255
2100,497,13,895,1289,4794,595,1370,15,705,2205,4890,20,256
1121,606,28,880,1325,3960,398,1248,127,743,1515,4031,20,257
329,564,29,1526,999,3447,145,1264,135,1043,1069,3656,20,258
278,280,3,1370,646,2577,126,602,14,1002,1119,2863,20,259
1579,305,6,876,890,3656,522,850,12,648,1845,3877,20,260
2290,393,3,925,1153,4764,710,991,10,682,2540,4933,20,261
2166,421,8,891,1141,4627,634,1135,12,683,2327,4791,20,262
2083,451,11,997,1294,4836,638,1293,16,793,2013,4753,20,263
1128,622,38,1001,1157,3946,456,1105,110,831,1493,3995,20,264
295,569,35,1540,925,3364,122,1048,130,997,1149,3446,20,265
171,239,15,1101,582,2108,73,588,13,882,844,2400,20,266
1494,299,2,876,856,3527,526,797,10,651,1846,3830,20,267
2199,406,13,865,1139,4622,710,1020,26,618,2459,4833,20,268
2062,418,4,986,1228,4698,673,1219,13,740,2291,4936,20,269
1859,448,2,1115,1191,4615,590,1138,26,716,2212,4682,20,270
1123,596,53,930,1304,4006,428,1304,101,718,1461,4012,20,271
313,629,63,1662,1189,3856,179,1397,155,971,1129,3831,20,272
219,238,2,1169,556,2184,73,555,6,845,913,2392,20,273
1511,318,2,818,878,3527,559,821,9,639,1811,3839,20,274
2215,408,8,883,1161,4675,709,1059,15,705,2411,4899,20,275
2121,426,2,963,1140,4652,653,1069,9,717,2354,4802,20,276
1831,480,7,1039,1236,4593,603,1131,20,769,2142,4665,20,277
1137,635,52,972,1092,3888,418,1145,104,754,1546,3967,20,278
327,484,31,1427,903,3172,133,1098,89,958,1140,3418,20,279
232,233,1,1208,569,2243,101,565,9,889,973,2537,20,280
1663,285,6,934,892,3780,540,900,10,662,1873,3985,20,281
2349,476,4,968,1111,4908,658,1190,9,827,2510,5194,20,282
2276,433,6,1024,1184,4923,618,1081,12,831,2538,5080,20,283
2015,506,3,991,1252,4767,626,1211,11,704,2341,4893,20,284
1035,569,28,1106,1220,3958,454,1097,104,935,1490,4080,20,285
451,532,35,1627,960,3605,124,1092,78,1039,1327,3660,20,286
451,330,3,1371,634,2789,123,730,6,1139,1069,3067,20,287
921,316,2,1173,846,3258,379,807,8,835,1494,3523,20,288
2284,414,2,1119,1222,5041,742,1166,10,750,2570,5238,20,289
2248,368,4,1107,1225,4952,685,1153,12,771,2540,5161,20,290
2015,462,3,1145,1397,5022,658,1398,19,773,2212,5060,20,291
1155,706,43,1032,1160,4096,439,1243,92,776,1602,4152,20,292
279,629,47,1611,1020,3586,121,1155,136,1086,1312,3810,20,293
229,294,3,1356,695,2577,98,821,17,961,990,2887,20,294
1519,313,7,931,1023,3793,558,845,9,671,1940,4023,20,295
2273,397,9,1013,1164,4856,707,1142,10,680,2538,5077,20,296
2231,424,14,1018,1295,4982,680,1288,18,780,2458,5224,20,297
2030,461,14,1111,1481,5097,656,1433,26,800,2320,5235,20,298
1142,658,34,1124,1188,4146,472,1201,96,885,1599,4253,20,299
377,704,41,1707,1055,3884,134,1198,143,1269,1410,4154,20,300
1468,337,5,3211,1288,6309,227,769,15,1653,1184,3848,20,301
1595,344,7,1056,1021,4023,552,824,12,712,1961,4061,20,302
2210,476,13,1132,1711,5542,735,1615,40,834,2430,5654,20,303
2205,362,3,1084,1315,4969,721,1156,9,788,2445,5119,20,304
1852,484,8,1045,1317,4706,645,1130,39,787,2240,4841,20,305
1043,715,27,1027,1131,3943,443,1101,115,874,1527,4060,20,306
297,608,38,1596,1047,3586,111,1186,126,1035,1231,3689,20,307
226,213,3,1078,566,2086,95,502,7,864,874,2342,20,308
1596,289,11,846,916,3658,544,749,18,650,1878,3839,20,309
1783,438,10,929,925,4085,541,775,23,805,2044,4188,20,310
1696,352,15,869,1059,3991,583,891,26,706,1909,4115,20,311
1890,410,8,891,1188,4387,646,1073,15,693,2137,4564,20,312
1120,585,40,1029,1201,3975,537,1106,106,823,1489,4061,20,313
306,604,42,1598,831,3381,130,948,104,985,1226,3393,20,314
265,235,4,1331,598,2433,108,518,14,935,1161,2736,20,315
825,275,1,1016,716,2833,276,685,1,778,1352,3092,20,316
2263,425,4,912,1106,4710,726,975,13,712,2512,4938,20,317
2243,433,7,1030,1230,4943,654,1171,17,722,2441,5005,20,318
2014,459,11,980,1164,4628,610,1084,30,723,2284,4731,20,319
1193,619,42,940,1116,3910,455,1052,119,746,1605,3977,20,320
262,584,45,1678,860,3429,112,918,100,938,1399,3467,20,321
206,235,5,1099,654,2199,81,572,17,869,986,2525,20,322
1565,305,21,810,941,3642,536,818,34,619,1879,3886,20,323
2305,408,17,928,1147,4805,676,1052,23,700,2543,4994,20,324
2173,424,4,987,1168,4756,691,1048,9,736,2373,4857,20,325
1951,485,21,966,1344,4767,609,1225,26,688,2245,4793,20,326
1071,568,39,820,1119,3617,424,982,99,723,1446,3674,20,327
258,564,40,1381,1013,3256,107,1024,102,948,1065,3246,20,328
194,259,3,1101,559,2116,84,485,7,747,943,2266,20,329
1230,273,4,914,812,3233,459,589,5,604,1582,3239,20,330
1314,378,3,885,934,3514,480,710,5,688,1648,3531,20,331
719,278,2,974,751,2724,352,485,7,760,868,2472,20,332
136,135,1,481,238,991,61,267,5,322,350,1005,20,333
320,238,20,899,529,2006,143,557,39,580,860,2179,20,334
169,301,28,917,527,1942,91,565,45,619,878,2198,20,335
148,204,5,849,496,1702,114,552,6,675,906,2253,20,336
1352,288,3,732,774,3149,503,753,9,596,1686,3547,20,337
2068,350,3,915,1266,4602,718,1134,9,688,2349,4898,20,338
2083,364,1,994,1080,4522,641,1011,9,727,2381,4769,20,339
1966,448,5,1037,1322,4778,636,1248,12,736,2159,4791,20,340
1072,539,62,962,1181,3816,436,1079,108,714,1647,3984,20,341
246,658,79,1527,1244,3754,81,1399,146,936,1368,3930,20,342
196,306,2,1387,757,2648,86,805,19,979,1181,3070,20,343
1661,326,12,942,922,3863,595,991,16,752,2073,4427,20,344
2374,411,4,1000,1287,5076,761,1228,10,683,2428,5110,20,345
2149,451,11,1021,1013,4645,626,1129,16,756,2199,4726,20,346
2075,480,12,1096,1372,5035,707,1384,29,824,2206,5150,20,347
1131,642,44,1033,1343,4193,441,1194,137,816,1622,4210,20,348
449,643,69,1805,1160,4126,107,1225,149,1205,1316,4002,20,349
199,214,8,1123,634,2178,59,582,18,912,845,2416,20,350
1349,324,2,702,854,3231,490,730,6,537,1636,3399,20,351
1929,439,4,885,1114,4371,598,1079,10,683,2172,4542,20,352
1820,351,2,902,1038,4113,572,932,10,666,1986,4166,20,353
1476,404,6,876,1105,3867,549,914,12,627,1675,3777,20,354
644,338,10,680,771,2443,331,484,45,492,770,2122,20,355
146,189,12,778,493,1618,44,297,25,459,487,1312,20,356
105,151,1,599,293,1149,57,230,4,381,425,1097,20,357
363,152,3,548,408,1474,178,248,6,359,518,1309,20,358
206,61,7,396,218,888,94,121,2,249,269,735,20,359
54,81,2,169,116,422,33,101,2,115,148,399,20,360
221,102,2,394,300,1019,120,243,5,289,420,1077,20,361
267,156,2,513,369,1307,166,297,19,343,510,1335,20,362
133,171,10,544,256,1114,54,291,26,315,472,1158,20,363
93,139,3,493,292,1020,61,265,17,407,449,1199,20,364
480,197,2,634,569,1882,265,452,11,544,890,2162,20,365
468,572,295,845,566,2746,235,611,476,689,939,2950,20,366
135,172,4,549,331,1191,88,274,10,383,499,1254,21,1
884,320,9,822,1337,3372,1100,367,15,724,1252,3458,21,2
1147,313,6,913,1734,4113,1383,506,5,795,1482,4171,21,3
1181,315,27,879,1674,4076,1325,445,24,839,1459,4092,21,4
877,399,24,864,1252,3416,816,610,44,725,1274,3469,21,5
162,260,15,660,439,1536,122,403,37,522,474,1558,21,6
138,212,22,819,451,1642,99,391,23,590,618,1721,21,7
1365,342,18,816,1467,4008,1232,490,16,836,1642,4216,21,8
1664,322,2,1032,1572,4592,1548,416,3,1161,1655,4783,21,9
1676,393,8,1043,2072,5192,1669,601,9,1044,1973,5296,21,10
1641,471,14,1041,1959,5126,1503,702,22,1011,1821,5059,21,11
882,340,14,908,1087,3231,753,473,45,765,1059,3095,21,12
242,286,13,1206,592,2339,120,569,37,613,1056,2395,21,13
150,216,1,940,589,1896,72,394,7,600,904,1977,21,14
248,291,5,807,552,1903,269,403,10,527,694,1903,21,15
520,338,13,626,874,2371,556,477,17,584,833,2467,21,16
1923,406,2,1120,1865,5316,1427,813,8,1049,1676,4973,21,17
1837,472,3,1299,2163,5774,1624,1021,19,1099,2304,6067,21,18
1087,404,17,1215,944,3667,512,631,45,739,1673,3600,21,19
577,354,12,1152,768,2863,121,689,60,842,898,2610,21,20
215,220,23,939,610,2007,79,382,27,753,710,1951,21,21
1404,354,19,1035,1767,4579,1278,697,32,870,1717,4594,21,22
1768,473,33,1096,2161,5531,1724,779,29,1014,2105,5651,21,23
1678,485,21,1240,2317,5741,1783,928,29,986,2070,5796,21,24
1705,516,2,1278,2195,5696,1556,994,8,1011,2002,5571,21,25
1407,581,24,1273,1555,4840,974,935,69,1185,1577,4740,21,26
234,401,32,1248,893,2808,139,813,64,800,992,2808,21,27
153,225,19,1007,485,1889,103,470,27,700,797,2097,21,28
1435,401,38,1025,1613,4512,1263,736,27,901,1771,4698,21,29
1778,438,19,1063,2188,5486,1761,771,31,999,2028,5590,21,30
1773,440,24,1125,2241,5603,1756,903,27,982,1936,5604,21,31
1660,429,38,1221,2005,5353,1511,788,46,992,1953,5290,21,32
1125,501,33,1117,1425,4201,884,745,67,903,1578,4177,21,33
196,363,19,1217,712,2507,116,561,65,749,1055,2546,21,34
182,274,29,913,525,1923,99,431,43,673,879,2125,21,35
1452,382,57,1006,1719,4616,1320,720,65,862,1797,4764,21,36
1867,463,20,1145,2433,5928,1844,966,28,976,2060,5874,21,37
1997,487,25,1305,2413,6227,1832,952,26,1047,2121,5978,21,38
1687,522,16,1480,2095,5800,1622,807,18,1062,2099,5608,21,39
1176,523,26,1161,1445,4331,888,686,77,944,1608,4203,21,40
240,399,24,1154,729,2546,131,697,79,737,917,2561,21,41
136,296,15,932,551,1930,83,467,38,542,920,2050,21,42
1329,382,23,996,1608,4338,1250,728,27,860,1675,4540,21,43
1759,511,15,1050,2188,5523,1610,1009,20,985,1974,5598,21,44
1872,484,6,1194,2217,5773,1643,953,22,993,1977,5588,21,45
1586,553,5,1258,2283,5685,1812,826,24,1040,1858,5560,21,46
1105,484,24,1383,1584,4580,951,932,52,983,1544,4462,21,47
645,357,31,1885,760,3678,112,1231,57,967,1229,3596,21,48
462,250,2,1811,656,3181,115,1038,10,806,1297,3266,21,49
769,291,4,1231,831,3126,418,535,7,1039,1179,3178,21,50
1618,397,3,1050,2110,5178,1643,775,12,944,1976,5350,21,51
1837,530,6,1168,2158,5699,1718,902,10,1010,1946,5586,21,52
1650,483,10,1213,2119,5475,1545,918,19,933,1933,5348,21,53
1194,552,27,1253,1413,4439,1014,747,63,900,1585,4309,21,54
299,387,16,1222,765,2689,150,648,46,711,1055,2610,21,55
207,259,10,1029,574,2079,110,468,18,678,894,2168,21,56
1383,380,5,999,1751,4518,1337,834,12,891,1683,4757,21,57
1838,500,15,1110,2257,5720,1786,816,20,1034,2029,5685,21,58
1845,548,10,1200,2190,5793,1736,851,19,1069,2157,5832,21,59
2000,644,12,1294,2047,5997,1623,943,14,952,2316,5848,21,60
1302,552,60,1272,1632,4818,955,985,77,1034,1716,4767,21,61
257,466,19,1224,822,2788,170,743,80,757,1071,2821,21,62
359,325,9,1417,605,2715,116,585,15,826,1295,2837,21,63
1478,459,6,1117,1685,4745,1320,826,9,893,1855,4903,21,64
1983,517,15,1251,2285,6051,1799,958,26,1050,2325,6158,21,65
2190,481,8,1317,2458,6454,1947,1042,10,1168,2038,6205,21,66
1704,595,7,1378,2190,5874,1712,973,23,1045,2050,5803,21,67
1384,601,44,1448,1560,5037,1007,971,72,1196,1824,5070,21,68
375,420,20,1310,799,2924,151,787,32,836,1122,2928,21,69
280,325,11,1479,670,2765,106,602,12,857,1295,2872,21,70
1486,517,11,1363,1757,5134,1397,858,13,1011,1949,5228,21,71
1795,695,2,1418,2390,6300,1792,1133,10,1066,2294,6295,21,72
2255,581,10,1484,2450,6780,1850,1167,14,1155,2273,6459,21,73
1735,623,12,1669,2624,6663,1667,1395,45,1200,2315,6622,21,74
1446,568,18,1802,1726,5560,925,1151,150,1343,1990,5559,21,75
736,770,22,2014,1276,4818,223,1650,90,1264,1527,4754,21,76
363,405,5,1669,963,3405,155,1003,14,1049,1365,3586,21,77
1569,498,5,1371,1929,5372,1305,1071,8,990,2035,5409,21,78
2262,608,2,1302,2445,6619,1792,1309,13,1150,2461,6725,21,79
2186,666,5,1648,2719,7224,1799,1442,17,1184,2459,6901,21,80
1830,632,12,1523,2331,6328,1644,1231,27,1278,2352,6532,21,81
1392,611,32,1838,1837,5710,956,1392,58,1180,2079,5665,21,82
359,545,30,1929,1118,3981,130,1373,65,811,1647,4026,21,83
622,364,3,2280,950,4219,118,844,20,1163,2071,4216,21,84
1531,487,2,1640,1793,5453,1283,1026,27,936,2173,5445,21,85
1906,611,9,1653,2417,6596,1658,1272,17,1144,2510,6601,21,86
2193,478,17,1483,2381,6552,1607,1093,23,1243,2336,6302,21,87
1690,641,11,1814,2112,6268,1454,1269,24,1150,2337,6234,21,88
1447,654,34,2231,1652,6018,854,1456,97,1231,2199,5837,21,89
667,578,34,2613,1324,5216,140,1443,66,1220,2111,4980,21,90
459,317,3,1785,749,3313,120,747,10,926,1522,3325,21,91
1435,460,2,1724,1675,5296,1191,1157,14,1049,2063,5474,21,92
2002,467,3,1624,2290,6386,1682,1092,8,1167,2552,6501,21,93
2009,524,4,1748,2435,6720,1673,1302,11,1135,2479,6600,21,94
2100,534,6,2007,2465,7112,1719,1434,19,1244,2707,7123,21,95
1540,632,25,1935,1746,5878,961,1436,101,1208,2152,5858,21,96
672,431,26,2068,1007,4204,149,1226,83,1055,1577,4090,21,97
543,292,1,1622,914,3372,135,767,11,1091,1380,3384,21,98
1453,439,2,1334,1712,4940,1305,871,20,900,1845,4941,21,99
1735,521,3,1358,2230,5847,1777,1079,15,1175,2119,6165,21,100
2095,563,4,1440,2360,6462,1711,1276,10,1117,2248,6362,21,101
1791,554,5,1506,2185,6041,1702,1185,10,1148,2230,6275,21,102
1495,615,29,1660,1536,5335,899,1124,79,1118,1873,5093,21,103
661,624,31,1761,1212,4289,150,1358,100,1104,1650,4362,21,104
385,398,5,1790,674,3252,110,804,9,1042,1513,3478,21,105
1712,451,3,1471,1913,5550,1376,1167,11,1221,2083,5858,21,106
2038,580,6,1450,2394,6468,1751,1244,13,1245,2250,6503,21,107
2378,593,13,1576,2343,6903,1799,1241,26,1221,2403,6690,21,108
2039,645,3,1585,2267,6539,1519,1327,17,1252,2404,6519,21,109
1513,561,24,1641,1852,5591,1025,1165,93,1205,2028,5516,21,110
421,498,36,2029,1171,4155,206,1348,78,980,1501,4113,21,111
366,297,17,1404,559,2643,119,538,24,715,1148,2544,21,112
1536,452,6,1148,1686,4828,1297,874,16,905,2083,5175,21,113
1948,553,8,1307,2464,6280,1791,1206,19,1050,2306,6372,21,114
2140,528,17,1438,2455,6578,1529,1337,20,1185,2161,6232,21,115
1899,573,3,1629,2256,6360,1543,1278,13,1424,2137,6395,21,116
1602,601,26,1503,1697,5429,964,1206,67,1243,1946,5426,21,117
414,523,31,1566,995,3529,128,1197,122,868,1140,3455,21,118
290,385,11,1800,882,3368,110,771,48,854,1444,3227,21,119
1449,422,5,1171,1879,4926,1307,906,12,999,1775,4999,21,120
1885,598,3,1192,2254,5932,1813,1039,16,1103,2070,6041,21,121
1921,517,8,1330,2240,6016,1773,1020,23,1107,2007,5930,21,122
1718,494,1,1313,2104,5630,1615,852,10,1071,2004,5552,21,123
1288,569,27,1442,1606,4932,964,1015,69,1129,1697,4874,21,124
333,429,21,1370,741,2894,139,840,62,789,1090,2920,21,125
248,303,25,1177,673,2426,96,707,37,807,1129,2776,21,126
1463,441,25,1057,1718,4704,1285,838,31,1016,1728,4898,21,127
2027,620,12,1210,2499,6368,1839,1200,28,1108,2404,6579,21,128
2004,521,28,1296,2403,6252,1784,1153,37,1084,2143,6201,21,129
1765,507,9,1281,2095,5657,1543,929,17,1100,2015,5604,21,130
1217,483,31,1302,1361,4394,846,840,67,1169,1529,4451,21,131
403,405,16,1581,747,3152,144,815,59,777,1298,3093,21,132
313,346,9,1275,593,2536,110,689,24,744,1191,2758,21,133
1529,578,3,1568,1861,5539,1352,1105,23,1157,2025,5662,21,134
1764,554,9,1301,2256,5884,1792,929,15,1090,2224,6050,21,135
2038,604,9,1255,2481,6387,1760,1115,12,1174,2450,6511,21,136
1985,612,1,1643,2312,6553,1592,1193,23,1573,2251,6632,21,137
1500,585,33,1688,1647,5453,948,1232,74,1229,1978,5461,21,138
397,541,25,1674,773,3410,151,974,105,954,1351,3535,21,139
538,362,6,1789,760,3455,127,913,20,1113,1324,3497,21,140
1588,448,2,1337,1917,5292,1385,989,7,1077,1933,5391,21,141
2075,529,11,1247,2394,6256,1769,1074,22,1118,2188,6171,21,142
1880,496,5,1371,2236,5988,1750,887,7,1079,2134,5857,21,143
1581,541,12,1242,1979,5355,1469,783,19,1198,1922,5391,21,144
942,627,33,1318,1403,4323,772,1100,53,951,1297,4173,21,145
405,488,17,1647,973,3530,143,1046,68,914,1221,3392,21,146
406,431,1,1751,775,3364,143,810,14,918,1397,3282,21,147
355,273,12,1297,592,2529,181,602,19,855,1035,2692,21,148
1628,501,2,1228,2123,5482,1654,798,22,1086,2000,5560,21,149
1835,527,13,1267,2207,5849,1779,833,17,1101,2017,5747,21,150
1636,626,1,1346,2132,5741,1626,889,11,1074,1993,5593,21,151
1227,719,29,1380,1585,4940,1073,1005,114,1103,1675,4970,21,152
383,492,17,1620,825,3337,172,931,77,923,1218,3321,21,153
368,372,22,1148,589,2499,121,674,28,840,1088,2751,21,154
1518,469,8,1110,1927,5032,1416,828,20,1033,1849,5146,21,155
1930,644,14,1190,2652,6430,1950,1190,17,1113,2247,6517,21,156
2041,546,5,1341,2411,6344,1911,981,12,1098,2378,6380,21,157
1800,627,5,1419,2506,6357,1777,1297,27,1196,2125,6422,21,158
1498,665,36,1338,1977,5514,910,1532,114,1075,1800,5431,21,159
532,596,39,2141,1452,4760,189,1862,159,1040,1551,4801,21,160
315,395,19,1599,744,3072,134,870,30,757,1299,3090,21,161
1525,481,5,1262,1889,5162,1508,870,15,940,2012,5345,21,162
2013,649,59,1271,2440,6432,1921,1058,73,1054,2471,6577,21,163
2049,619,5,1310,2432,6415,1876,1174,14,1093,2207,6364,21,164
2038,619,2,1367,2257,6283,1644,1139,10,1163,2148,6104,21,165
1417,605,27,1597,1672,5318,932,1146,67,1282,1903,5330,21,166
395,472,21,1418,933,3239,169,1009,80,836,1336,3430,21,167
349,288,7,1201,561,2406,105,626,15,804,1087,2637,21,168
1471,459,5,1116,1778,4829,1441,673,29,965,1826,4934,21,169
1823,587,10,1272,2458,6150,1863,982,21,1231,2131,6228,21,170
652,448,6,1201,1240,3547,591,808,15,959,1139,3512,21,171
1600,543,7,1373,1980,5503,1482,897,17,1096,2076,5568,21,172
1433,613,23,1233,1603,4905,958,1085,56,1045,1632,4776,21,173
582,582,23,1319,902,3408,150,1149,135,938,1041,3413,21,174
457,317,8,1064,630,2476,136,614,16,825,1132,2723,21,175
1520,535,20,1061,1949,5085,1522,755,34,1019,1943,5273,21,176
1862,636,11,1232,2548,6289,1947,883,26,1158,2377,6391,21,177
1882,571,11,1516,2380,6360,1929,939,16,1154,2263,6301,21,178
1860,619,6,1442,2310,6237,1705,1074,21,1240,2183,6223,21,179
1304,675,29,1484,1620,5112,959,961,55,1253,1823,5051,21,180
411,502,9,1365,870,3157,136,859,59,1003,1104,3161,21,181
273,298,18,1040,570,2199,125,523,32,737,860,2277,21,182
1460,455,37,1212,1925,5089,1406,913,49,986,1875,5229,21,183
1801,547,29,1369,2247,5993,1681,981,43,1184,2104,5993,21,184
1504,557,5,1727,2100,5893,1292,1200,38,1308,1936,5774,21,185
552,2309,13,2340,1521,6735,134,3710,46,1250,1619,6759,21,186
760,538,13,1812,1369,4492,492,1179,59,984,1676,4390,21,187
466,477,26,1539,795,3303,158,1024,65,888,1183,3318,21,188
279,368,32,1189,634,2502,132,683,52,771,1046,2684,21,189
1594,534,34,1185,1796,5143,1425,901,46,1046,1991,5409,21,190
1886,609,26,1390,2331,6242,1880,948,32,1213,2355,6428,21,191
1862,552,22,1370,2305,6111,1801,854,26,1140,2321,6142,21,192
1965,666,7,1307,2291,6236,1667,1059,23,1116,2284,6149,21,193
1282,662,43,1331,1544,4862,932,1037,71,1106,1704,4850,21,194
354,681,27,1532,1162,3756,175,1135,64,971,1448,3793,21,195
214,358,12,1313,618,2515,135,590,12,959,934,2630,21,196
1564,431,17,1311,1684,5007,1319,708,25,1279,1884,5215,21,197
1854,584,13,1156,2228,5835,1692,993,32,1120,2129,5966,21,198
1878,484,18,1245,2266,5891,1821,783,24,1027,2210,5865,21,199
1786,551,5,1299,2095,5736,1540,857,9,1083,2107,5596,21,200
1218,658,17,1698,1717,5308,774,1104,126,1127,1756,4887,21,201
391,502,15,1570,1091,3569,148,1099,59,965,1285,3556,21,202
289,332,6,1276,586,2489,150,690,12,787,1030,2669,21,203
1569,379,19,1146,1722,4835,1251,812,24,907,1920,4914,21,204
1877,541,19,1366,2283,6086,1730,1041,26,1136,2180,6113,21,205
1842,524,8,1473,2287,6134,1702,961,19,1197,2394,6273,21,206
1861,679,10,1430,2107,6087,1525,960,50,1176,2269,5980,21,207
1228,718,67,1430,1553,4996,880,1057,137,1002,1842,4918,21,208
422,533,33,1597,910,3495,169,1039,179,914,1283,3584,21,209
245,314,14,1291,703,2567,102,772,49,761,1044,2728,21,210
1428,418,12,1250,1916,5024,1272,885,28,1046,1873,5104,21,211
1866,626,18,1271,2296,6077,1708,884,20,1152,2254,6018,21,212
1879,508,16,1300,2176,5879,1625,834,20,1146,2228,5853,21,213
1774,541,29,1464,2089,5897,1484,1063,43,1172,2130,5892,21,214
1284,632,32,1578,1680,5206,859,1296,92,1075,1896,5218,21,215
472,461,24,1786,798,3541,141,991,82,946,1448,3608,21,216
320,338,21,1477,618,2774,111,621,36,887,1204,2859,21,217
1379,467,6,1401,1729,4982,1263,784,11,1069,1914,5041,21,218
1675,563,13,1238,2310,5799,1743,927,18,1068,2126,5882,21,219
1650,497,10,1254,2216,5627,1783,829,32,1098,2022,5764,21,220
1555,459,20,1274,1823,5131,1456,726,31,1048,1844,5105,21,221
941,501,32,1119,1279,3872,674,809,88,913,1320,3804,21,222
283,464,29,1229,931,2936,133,923,57,780,1050,2943,21,223
208,290,25,1147,591,2261,94,616,31,754,936,2431,21,224
1339,397,34,1081,1624,4475,1222,659,42,927,1727,4577,21,225
1728,511,17,1138,2143,5537,1728,731,18,1055,2014,5546,21,226
1628,533,21,1279,2145,5606,1674,747,20,1040,2023,5504,21,227
1576,537,20,1185,2032,5350,1496,899,35,1054,1865,5349,21,228
1157,563,18,1333,1449,4520,837,929,98,1039,1575,4478,21,229
340,450,18,1459,787,3054,151,736,86,799,1197,2969,21,230
202,246,8,1128,511,2095,102,439,11,701,882,2135,21,231
1334,423,11,1070,1558,4396,1203,632,19,868,1811,4533,21,232
1682,554,13,1166,2198,5613,1660,913,16,984,2164,5737,21,233
1601,524,12,1261,2183,5581,1629,890,18,1036,2026,5599,21,234
1551,559,10,1244,2026,5390,1312,920,17,1106,1970,5325,21,235
1121,577,25,1345,1477,4545,773,1029,77,944,1696,4519,21,236
341,509,16,1587,893,3346,125,1078,85,919,1178,3385,21,237
263,296,10,1292,587,2448,123,546,27,874,929,2499,21,238
1492,415,8,1204,1859,4978,1226,1028,15,1048,1909,5226,21,239
1917,614,16,1243,2467,6257,1738,1178,18,1105,2274,6313,21,240
1812,474,10,1386,2330,6012,1648,1092,13,1147,2114,6014,21,241
1679,443,8,1485,2054,5669,1408,941,21,1199,2102,5671,21,242
1047,502,19,1410,1481,4459,735,1049,74,1084,1424,4366,21,243
388,488,26,1716,878,3496,118,1126,70,824,1279,3417,21,244
331,320,1,1605,625,2882,103,821,10,781,1223,2938,21,245
225,266,7,1210,605,2313,120,598,12,764,964,2458,21,246
1741,379,18,1203,1932,5273,1565,840,20,1037,2040,5502,21,247
1691,495,26,1276,2191,5679,1676,942,31,1056,2065,5770,21,248
1741,507,10,1302,2121,5681,1589,992,22,1017,2002,5622,21,249
1226,579,35,1320,1559,4719,959,848,70,1117,1685,4679,21,250
287,563,28,1340,977,3195,128,1038,94,894,1053,3207,21,251
198,266,18,1114,680,2276,109,631,25,792,937,2494,21,252
1648,473,6,1198,1885,5210,1374,940,18,958,2018,5308,21,253
1974,598,15,1475,2352,6414,1776,1200,38,1134,2421,6569,21,254
2064,566,7,1457,2370,6464,1694,1234,20,1137,2325,6410,21,255
1901,597,4,1472,2373,6347,1628,1314,19,1146,2238,6345,21,256
1368,613,28,1415,1634,5058,872,1203,74,1106,1823,5078,21,257
399,557,26,1491,977,3450,140,1045,84,945,1246,3460,21,258
255,318,9,1300,705,2587,148,589,18,898,1140,2793,21,259
1636,405,18,1241,1852,5152,1338,900,22,1038,1922,5220,21,260
2034,531,10,1266,2292,6133,1766,966,12,1070,2324,6138,21,261
1903,522,14,1455,2394,6288,1754,1136,20,1182,2260,6352,21,262
1960,631,9,1521,2217,6338,1681,1186,19,1112,2207,6205,21,263
1396,714,33,1499,1534,5176,903,1205,96,1201,1871,5276,21,264
466,572,16,1569,1025,3648,188,1171,103,970,1300,3732,21,265
278,320,4,1341,728,2671,130,688,11,889,1036,2754,21,266
1611,373,9,1342,1788,5123,1313,881,17,1047,2055,5313,21,267
2054,496,7,1352,2397,6306,1749,1114,15,1090,2444,6412,21,268
1949,511,13,1496,2389,6358,1714,1237,33,1174,2326,6484,21,269
1877,632,8,1546,2159,6222,1462,1252,20,1273,2170,6177,21,270
1381,624,28,1531,1589,5153,868,1172,91,1211,1809,5151,21,271
406,585,32,1816,1212,4051,166,1344,79,1103,1389,4081,21,272
268,302,6,1345,571,2492,109,574,8,819,1025,2535,21,273
1529,427,12,1257,1808,5033,1305,910,19,1046,1858,5138,21,274
1920,495,2,1116,2182,5715,1673,889,14,1072,2164,5812,21,275
1852,502,27,1437,2321,6139,1688,979,38,1146,2198,6049,21,276
1774,554,42,1491,2145,6006,1501,1043,59,1155,2097,5855,21,277
1203,560,34,1477,1535,4809,870,975,72,1081,1818,4816,21,278
433,522,20,1587,1001,3563,149,1011,82,956,1321,3519,21,279
291,289,9,1373,649,2611,99,651,26,790,1131,2697,21,280
1589,498,13,1304,2037,5441,1391,965,31,1104,2122,5613,21,281
1985,583,11,1376,2378,6333,1849,1026,25,1078,2336,6314,21,282
1940,497,22,1501,2517,6477,1902,1081,26,1135,2280,6424,21,283
1823,526,22,1486,2322,6179,1628,1101,37,1233,2175,6174,21,284
1107,617,27,1684,1502,4937,805,1148,77,1265,1839,5134,21,285
734,629,37,2488,1291,5179,172,1368,65,1473,2270,5348,21,286
813,354,12,1919,930,4028,189,967,25,1635,1365,4181,21,287
1165,390,13,1592,1071,4231,504,1023,22,1124,1740,4413,21,288
2398,503,23,1668,2448,7040,1734,1143,26,1404,2776,7083,21,289
2365,561,17,1695,2460,7098,1821,1072,22,1398,2772,7085,21,290
1863,623,7,1670,2465,6628,1706,1247,22,1198,2439,6612,21,291
1441,662,34,1819,2022,5978,1042,1432,90,1217,2073,5854,21,292
521,620,27,2002,1076,4246,182,1255,156,1048,1565,4206,21,293
354,338,21,1528,703,2944,143,902,36,857,1141,3079,21,294
1609,432,7,1369,1949,5366,1279,967,17,1082,2079,5424,21,295
1961,638,32,1445,2581,6657,1855,1095,31,1266,2513,6760,21,296
2067,618,6,1549,2519,6759,1698,1310,11,1220,2593,6832,21,297
2065,650,2,1652,2449,6818,1595,1452,13,1309,2405,6774,21,298
1504,633,20,1991,1875,6023,914,1169,82,1410,2405,5980,21,299
621,677,33,2733,1292,5356,142,1054,98,1786,2237,5317,21,300
3514,426,16,3977,1213,9146,361,948,21,5161,2549,9040,21,301
1931,513,2,1664,1989,6099,1351,992,9,1218,2247,5817,21,302
1973,604,5,1527,2832,6941,1769,1575,20,1311,2293,6968,21,303
2051,631,8,1494,2560,6744,1765,1094,11,1325,2412,6607,21,304
1700,556,3,1471,2284,6014,1454,951,30,1223,2096,5754,21,305
1169,647,17,1404,1469,4706,827,917,80,1115,1661,4600,21,306
306,550,26,1357,902,3141,117,930,141,813,1146,3147,21,307
280,277,6,1093,574,2230,135,473,18,830,906,2362,21,308
1541,349,29,1191,1774,4884,1348,768,32,987,1848,4983,21,309
1532,455,8,1158,1889,5042,1526,706,28,1037,1828,5125,21,310
1744,512,6,1285,2041,5588,1473,953,17,1099,1957,5499,21,311
1797,680,11,1458,2311,6257,1574,1104,36,1298,2355,6367,21,312
1213,688,18,1468,1502,4889,798,944,120,1194,1724,4780,21,313
358,561,28,1596,809,3352,159,774,107,962,1175,3177,21,314
238,313,28,1266,878,2723,91,517,42,741,1184,2575,21,315
704,380,22,1304,1030,3440,471,797,34,937,1292,3531,21,316
1939,465,23,1232,2248,5907,1751,925,34,1108,2231,6049,21,317
2059,576,10,1345,2543,6533,1768,1169,18,1111,2463,6529,21,318
1821,523,19,1411,2168,5942,1682,884,31,1135,2241,5973,21,319
1333,644,20,1458,1676,5131,1135,932,129,1218,1807,5221,21,320
347,532,25,1470,856,3230,123,758,109,846,1341,3177,21,321
291,246,5,1327,614,2483,103,536,12,884,988,2523,21,322
1644,431,2,1233,1808,5118,1364,865,18,1077,1950,5274,21,323
2079,449,13,1295,2371,6207,1802,942,21,1143,2295,6203,21,324
2204,567,16,1354,2410,6551,1825,992,25,1169,2378,6389,21,325
1971,545,10,1431,2219,6176,1626,1039,19,1148,2226,6058,21,326
1442,522,34,1159,1487,4644,896,808,40,1108,1678,4530,21,327
360,403,38,1385,874,3060,107,909,62,848,1042,2968,21,328
207,251,2,1143,640,2243,83,555,10,688,945,2281,21,329
1386,346,35,1166,1447,4380,1085,659,37,949,1705,4435,21,330
1329,416,18,1209,1706,4678,1212,748,28,867,1687,4542,21,331
855,312,7,1332,1097,3603,701,554,20,903,1083,3261,21,332
143,174,0,603,327,1247,73,280,5,415,504,1277,21,333
406,261,12,1068,737,2484,345,600,32,738,906,2621,21,334
219,274,26,966,653,2138,120,663,35,693,875,2386,21,335
200,326,4,850,891,2271,94,705,7,707,983,2496,21,336
1424,358,19,1110,1692,4603,1233,871,26,1014,1755,4899,21,337
1844,455,27,1315,2374,6015,1709,1019,38,1167,2241,6174,21,338
2108,480,15,1303,2364,6270,1700,1030,23,1288,2262,6303,21,339
1946,526,32,1531,2204,6239,1483,1061,26,1352,2290,6212,21,340
1482,534,34,1516,1578,5144,889,1033,83,1103,1948,5056,21,341
381,525,46,1387,1158,3497,98,1206,103,905,1233,3545,21,342
331,343,9,1474,795,2952,107,778,19,957,1266,3127,21,343
1798,417,20,1234,1915,5384,1374,1080,37,1003,2105,5599,21,344
2198,576,25,1500,2443,6742,1822,1182,27,1228,2478,6737,21,345
2179,653,23,1681,2340,6876,1755,1180,40,1253,2801,7029,21,346
2261,712,0,1599,2375,6947,1580,1419,22,1248,2611,6880,21,347
1596,643,40,1749,1785,5813,875,1246,79,1362,2284,5846,21,348
931,548,32,1920,1156,4587,216,1491,87,1472,1344,4610,21,349
269,267,2,1204,650,2392,118,651,10,799,897,2475,21,350
1430,402,11,1195,1643,4681,1244,750,26,1005,1682,4707,21,351
1680,533,24,1181,2217,5635,1644,852,28,1038,2100,5662,21,352
1585,458,38,1247,2172,5500,1536,787,40,1150,1854,5367,21,353
1405,518,9,1196,1988,5116,1325,714,22,1041,1765,4867,21,354
928,415,26,1109,1280,3758,683,703,47,903,1199,3535,21,355
185,301,11,1046,670,2213,115,543,42,625,842,2167,21,356
205,210,1,948,624,1988,100,511,7,525,805,1948,21,357
652,249,13,1031,966,2911,584,435,17,768,877,2681,21,358
307,209,7,827,531,1881,305,291,10,521,532,1659,21,359
93,164,4,365,294,920,57,290,5,301,378,1031,21,360
393,268,1,1007,785,2454,384,633,4,619,906,2546,21,361
533,298,8,1258,841,2938,435,637,35,746,1181,3034,21,362
223,281,16,1229,573,2322,97,636,71,671,955,2430,21,363
188,275,5,1564,494,2526,93,521,37,551,1392,2594,21,364
716,337,4,1260,1185,3502,695,665,12,789,1273,3434,21,365
530,561,104,1342,816,3353,576,472,324,830,1131,3333,21,366
85,71,2,195,107,460,39,127,7,107,140,420,22,1
348,97,12,340,216,1013,136,202,16,227,353,934,22,2
476,142,19,408,302,1347,201,206,28,281,431,1147,22,3
510,104,11,357,298,1280,210,183,20,270,483,1166,22,4
433,108,11,338,336,1226,189,188,16,243,407,1043,22,5
112,60,9,198,115,494,43,144,21,134,132,474,22,6
79,64,3,233,139,518,31,127,10,156,146,470,22,7
508,80,4,321,305,1218,188,208,9,268,450,1123,22,8
498,67,6,339,208,1118,197,155,13,263,384,1012,22,9
530,113,8,385,333,1369,221,205,26,291,507,1250,22,10
519,110,8,355,362,1354,204,209,24,280,474,1191,22,11
470,75,12,342,337,1236,178,157,34,288,409,1066,22,12
131,88,6,322,180,727,58,160,22,177,217,634,22,13
74,73,2,214,113,476,29,125,7,127,134,422,22,14
148,98,14,263,155,678,79,168,20,185,180,632,22,15
232,77,7,241,106,663,106,121,13,170,167,577,22,16
372,103,8,388,262,1133,121,212,14,266,437,1050,22,17
520,82,9,316,327,1254,188,187,19,244,463,1101,22,18
262,83,23,227,167,762,112,125,47,175,217,676,22,19
109,77,9,250,162,607,64,125,29,132,180,530,22,20
70,63,1,195,98,427,26,121,6,107,113,373,22,21
463,86,4,317,332,1202,178,191,25,221,500,1115,22,22
555,118,4,334,320,1331,184,231,9,272,498,1194,22,23
564,129,14,349,321,1377,202,220,18,240,520,1200,22,24
517,117,5,340,325,1304,176,243,15,253,494,1181,22,25
423,125,11,379,309,1247,155,198,31,283,395,1062,22,26
132,80,4,285,200,701,48,159,16,164,220,607,22,27
80,65,6,232,131,514,32,139,14,137,147,469,22,28
516,101,6,345,296,1264,207,194,20,235,464,1120,22,29
552,128,7,352,333,1372,218,246,20,243,528,1255,22,30
542,87,7,398,289,1323,210,202,18,255,470,1155,22,31
538,104,7,313,377,1339,204,208,19,239,517,1187,22,32
444,121,7,346,317,1235,210,200,21,225,431,1087,22,33
115,90,10,287,179,681,55,134,26,164,196,575,22,34
86,80,13,238,115,532,33,147,15,136,145,476,22,35
501,100,1,335,321,1258,199,218,9,220,481,1127,22,36
606,127,3,371,312,1419,241,231,13,284,490,1259,22,37
569,118,11,369,282,1349,222,220,12,239,489,1182,22,38
519,114,11,369,359,1372,183,227,16,264,495,1185,22,39
496,117,15,367,328,1323,205,214,42,286,409,1156,22,40
116,97,11,275,195,694,56,184,27,160,229,656,22,41
93,83,9,230,122,537,35,131,17,122,172,477,22,42
470,75,5,316,300,1166,200,183,21,246,428,1078,22,43
486,123,5,336,297,1247,211,234,18,267,498,1228,22,44
528,122,5,377,343,1375,220,244,14,272,490,1240,22,45
522,114,8,311,311,1266,203,220,17,207,474,1121,22,46
368,113,18,386,215,1100,119,184,36,266,347,952,22,47
125,104,8,250,153,640,47,133,30,160,179,549,22,48
76,91,2,215,128,512,36,148,12,121,125,442,22,49
214,106,2,280,156,758,99,177,8,132,230,646,22,50
509,137,10,332,349,1337,194,222,25,244,510,1195,22,51
549,112,5,365,295,1326,227,213,13,240,498,1191,22,52
553,120,8,366,332,1379,197,227,18,264,497,1203,22,53
464,81,7,279,317,1148,188,169,19,227,399,1002,22,54
124,84,7,323,133,671,50,147,16,187,206,606,22,55
88,77,13,234,147,559,38,137,12,142,161,490,22,56
506,118,7,325,344,1300,219,205,17,240,454,1135,22,57
584,98,6,324,315,1327,235,184,15,262,508,1204,22,58
529,111,5,402,307,1354,218,188,14,290,522,1232,22,59
544,96,10,221,334,1205,226,221,16,187,513,1163,22,60
456,109,7,352,347,1271,189,192,26,254,456,1117,22,61
112,94,12,250,180,648,48,179,22,139,201,589,22,62
99,113,9,251,162,634,44,163,25,176,216,624,22,63
481,74,17,336,316,1224,190,187,26,246,510,1159,22,64
553,139,10,360,355,1417,276,239,25,243,517,1300,22,65
544,132,12,355,288,1331,201,225,19,228,491,1164,22,66
577,130,11,345,368,1431,223,248,27,278,556,1332,22,67
476,114,11,390,317,1308,226,215,27,265,449,1182,22,68
121,75,6,269,174,645,40,157,25,141,162,525,22,69
71,94,6,223,118,512,34,143,9,123,151,460,22,70
439,145,12,321,315,1232,181,224,29,221,444,1099,22,71
540,127,7,377,330,1381,227,279,14,286,540,1346,22,72
521,109,7,457,348,1442,200,215,20,299,542,1276,22,73
436,139,4,369,284,1232,159,244,21,242,471,1137,22,74
372,137,11,377,245,1142,142,201,31,239,411,1024,22,75
148,114,19,376,192,849,50,208,27,258,250,793,22,76
91,91,3,227,142,554,36,160,7,148,160,511,22,77
500,137,5,334,301,1277,215,216,12,247,506,1196,22,78
577,132,4,391,334,1438,219,240,11,263,564,1297,22,79
572,126,18,436,303,1455,213,239,29,291,549,1321,22,80
498,130,9,330,314,1281,194,249,30,257,507,1237,22,81
466,133,9,371,360,1339,206,231,27,229,503,1196,22,82
108,118,4,263,199,692,38,181,29,157,233,638,22,83
97,88,2,268,156,611,42,188,5,150,188,573,22,84
476,109,4,325,329,1243,195,203,16,222,533,1169,22,85
518,134,7,361,356,1376,207,240,16,252,532,1247,22,86
495,104,6,335,299,1239,215,203,12,259,474,1163,22,87
518,94,5,333,333,1283,210,167,18,274,499,1168,22,88
417,135,6,379,341,1278,189,248,30,281,440,1188,22,89
122,105,12,350,218,807,50,206,32,220,191,699,22,90
83,82,17,269,93,544,52,157,26,164,135,534,22,91
442,108,1,354,281,1186,164,237,12,240,435,1088,22,92
504,125,16,348,295,1288,206,226,24,270,513,1239,22,93
512,101,3,405,242,1263,203,209,11,288,484,1195,22,94
532,136,5,374,342,1389,201,257,17,278,519,1272,22,95
418,113,8,337,219,1095,153,219,34,245,390,1041,22,96
106,102,8,324,162,702,52,176,27,218,186,659,22,97
112,90,3,237,143,585,53,199,13,138,155,558,22,98
491,112,7,332,288,1230,189,216,12,236,516,1169,22,99
526,124,26,395,319,1390,221,225,37,279,556,1318,22,100
503,122,8,429,325,1387,217,232,17,300,578,1344,22,101
514,128,9,327,304,1282,239,209,15,279,486,1228,22,102
448,119,10,371,323,1271,214,236,28,291,464,1233,22,103
141,94,15,329,214,793,42,207,31,211,254,745,22,104
84,121,6,300,137,648,40,194,11,177,195,617,22,105
402,138,16,373,240,1169,136,212,27,268,394,1037,22,106
417,141,19,351,230,1158,135,264,25,209,427,1060,22,107
435,137,11,319,253,1155,132,204,18,203,442,999,22,108
430,135,11,342,259,1177,157,255,16,218,447,1093,22,109
334,128,7,391,242,1102,149,215,24,269,355,1012,22,110
116,102,13,241,169,641,59,145,35,161,140,540,22,111
70,94,3,163,89,419,31,96,10,105,119,361,22,112
491,136,18,325,288,1258,190,231,27,241,513,1202,22,113
541,132,15,400,328,1416,238,270,19,281,542,1350,22,114
526,130,21,390,319,1386,216,234,26,252,559,1287,22,115
535,107,6,335,344,1327,228,246,13,255,543,1285,22,116
472,122,10,306,305,1215,214,230,33,223,447,1147,22,117
25,0,8,1,0,34,18,0,2,2,0,22,22,118
61,82,7,189,107,446,40,123,16,101,119,399,22,119
506,111,4,313,285,1219,199,223,11,232,488,1153,22,120
569,135,7,415,319,1445,230,259,16,286,573,1364,22,121
535,145,9,381,305,1375,206,223,17,288,553,1287,22,122
517,113,12,362,326,1330,221,248,22,276,561,1328,22,123
484,143,10,358,367,1362,205,214,30,286,508,1243,22,124
129,79,12,276,181,677,38,152,31,160,207,588,22,125
99,96,5,218,123,541,41,176,15,134,140,506,22,126
520,110,1,353,268,1252,220,236,6,255,476,1193,22,127
584,114,15,410,303,1426,228,262,24,311,538,1363,22,128
599,118,13,433,309,1472,223,251,26,306,576,1382,22,129
528,112,4,331,323,1298,215,232,8,256,539,1250,22,130
443,126,12,352,330,1263,199,177,34,273,459,1142,22,131
145,106,5,307,179,742,70,158,22,180,235,665,22,132
97,102,6,257,107,569,44,159,8,150,178,539,22,133
526,134,9,357,337,1363,224,252,10,244,539,1269,22,134
582,123,10,391,290,1396,240,220,22,307,572,1361,22,135
543,108,12,409,304,1376,207,254,16,301,535,1313,22,136
591,134,6,393,361,1485,249,280,15,302,560,1406,22,137
509,137,15,401,284,1346,216,218,31,270,456,1191,22,138
138,89,9,272,149,657,67,167,18,169,211,632,22,139
115,100,10,265,113,603,49,165,14,166,157,551,22,140
568,111,7,312,312,1310,221,220,7,245,539,1232,22,141
583,120,14,383,313,1413,237,223,24,299,521,1304,22,142
508,135,5,364,274,1286,195,201,15,246,516,1173,22,143
519,74,14,321,258,1186,223,192,24,229,488,1156,22,144
392,100,8,350,230,1080,199,159,30,231,387,1006,22,145
111,78,6,228,155,578,53,171,25,138,198,585,22,146
96,77,1,232,92,498,43,130,11,153,133,470,22,147
85,65,3,190,127,470,49,135,11,125,140,460,22,148
541,71,14,322,252,1200,227,189,26,247,484,1173,22,149
514,87,7,374,215,1197,234,176,13,243,478,1144,22,150
512,69,11,334,286,1212,216,161,15,262,462,1116,22,151
401,102,14,283,273,1073,216,181,31,199,436,1063,22,152
110,87,10,285,138,630,34,179,21,193,163,590,22,153
86,74,6,208,131,505,48,131,14,154,152,499,22,154
491,85,3,280,257,1116,194,174,10,226,463,1067,22,155
469,95,4,282,255,1105,186,194,14,218,463,1075,22,156
532,86,15,337,226,1196,211,191,20,256,492,1170,22,157
503,97,1,306,260,1167,199,209,10,223,452,1093,22,158
400,105,11,305,290,1111,204,183,36,222,411,1056,22,159
121,115,9,269,180,694,52,215,40,159,162,628,22,160
71,75,4,229,134,513,42,145,16,133,190,526,22,161
458,61,1,345,226,1091,195,176,5,261,480,1117,22,162
517,78,7,320,237,1159,208,220,12,219,490,1149,22,163
514,95,4,317,208,1138,202,215,12,237,462,1128,22,164
497,69,5,301,232,1104,184,186,12,224,467,1073,22,165
417,91,6,291,244,1049,185,180,25,228,334,952,22,166
111,92,3,263,179,648,42,160,28,182,179,591,22,167
99,62,4,199,99,463,44,129,7,156,159,495,22,168
436,67,7,307,198,1015,175,175,8,216,425,999,22,169
485,92,7,335,236,1155,184,206,17,256,439,1102,22,170
201,68,11,266,192,738,96,178,15,188,215,692,22,171
432,118,9,316,250,1125,160,199,21,248,455,1083,22,172
353,94,13,292,227,979,173,165,31,246,342,957,22,173
121,72,2,277,156,628,55,153,30,197,158,593,22,174
91,47,1,189,110,438,49,111,23,143,116,442,22,175
451,77,1,301,218,1048,181,182,14,231,390,998,22,176
489,75,7,294,237,1102,197,175,18,198,473,1061,22,177
508,84,11,289,189,1081,158,197,28,201,407,991,22,178
507,91,5,290,210,1103,179,191,13,230,447,1060,22,179
404,82,10,273,218,987,158,191,27,240,358,974,22,180
119,76,2,274,131,602,60,162,20,186,164,592,22,181
95,60,3,190,99,447,42,118,5,127,143,435,22,182
438,83,2,331,217,1071,200,173,11,232,432,1048,22,183
462,88,12,324,205,1091,200,198,21,221,419,1059,22,184
461,89,6,314,208,1078,177,194,15,283,388,1057,22,185
100,232,4,211,211,758,50,290,14,155,221,730,22,186
277,104,2,281,183,847,109,161,18,191,264,743,22,187
121,72,5,242,135,575,67,149,25,164,178,583,22,188
90,73,4,206,103,476,38,120,10,131,143,442,22,189
411,79,1,290,181,962,174,146,14,204,363,901,22,190
442,64,3,337,212,1058,190,177,8,246,381,1002,22,191
467,72,4,289,226,1058,183,183,14,237,388,1005,22,192
433,73,54,320,216,1096,161,181,72,238,407,1059,22,193
352,61,1,253,179,846,158,178,21,230,270,857,22,194
117,85,7,272,166,647,63,127,22,195,172,579,22,195
101,68,6,194,115,484,44,114,20,147,149,474,22,196
416,61,15,303,187,982,164,146,30,197,400,937,22,197
479,83,3,277,212,1054,171,182,12,224,402,991,22,198
473,47,6,279,172,977,168,131,17,211,381,908,22,199
450,72,8,283,199,1012,164,174,25,223,390,976,22,200
351,109,12,311,209,992,130,178,35,248,397,988,22,201
124,88,5,469,380,1066,99,132,14,468,286,999,22,202
82,70,5,493,311,961,114,141,10,532,176,973,22,203
442,55,8,263,151,919,166,151,22,202,346,887,22,204
485,84,7,372,206,1154,179,192,15,283,448,1117,22,205
477,98,8,309,186,1078,173,194,24,220,408,1019,22,206
457,70,2,297,190,1016,168,171,12,239,399,989,22,207
371,75,12,303,201,962,156,176,43,204,343,922,22,208
113,94,5,312,165,689,45,155,31,248,162,641,22,209
71,60,10,220,114,475,29,146,15,169,126,485,22,210
379,61,10,279,203,932,149,146,21,180,371,867,22,211
474,62,2,284,203,1025,176,190,12,208,411,997,22,212
454,94,5,318,177,1048,161,190,13,233,381,978,22,213
431,65,5,339,172,1012,144,184,14,214,402,958,22,214
344,84,14,323,173,938,127,191,37,189,318,862,22,215
113,65,10,264,138,590,46,116,22,182,183,549,22,216
88,67,2,194,144,495,39,130,8,152,142,471,22,217
383,72,2,282,167,906,143,166,11,182,331,833,22,218
444,97,11,292,164,1008,142,174,24,202,367,909,22,219
437,82,4,291,195,1009,138,178,20,200,399,935,22,220
388,84,3,275,167,917,123,167,10,207,348,855,22,221
322,61,6,209,151,749,111,184,23,146,260,724,22,222
111,87,5,258,113,574,58,154,15,177,149,553,22,223
82,65,4,213,107,471,46,141,6,119,132,444,22,224
376,79,1,263,177,896,135,177,7,193,368,880,22,225
411,69,2,289,203,974,135,168,19,195,389,906,22,226
421,79,5,285,191,981,140,215,12,192,363,922,22,227
399,73,2,292,192,958,152,168,19,194,383,916,22,228
354,81,4,282,204,925,120,166,41,176,302,805,22,229
99,63,2,228,134,526,31,119,29,158,158,495,22,230
76,46,14,201,105,442,38,113,24,138,127,440,22,231
377,60,3,362,193,995,167,151,7,264,344,933,22,232
420,70,6,278,207,981,175,170,22,195,377,939,22,233
402,87,8,279,182,958,141,192,23,192,365,913,22,234
431,76,4,287,191,989,166,164,8,211,391,940,22,235
361,57,9,274,213,914,151,166,25,195,283,820,22,236
107,65,2,234,155,563,45,145,21,156,178,545,22,237
79,63,3,189,108,442,42,100,22,109,144,417,22,238
474,73,7,266,195,1015,184,162,12,238,385,981,22,239
555,65,8,259,261,1148,222,190,18,169,514,1113,22,240
525,77,13,243,260,1118,206,185,21,196,486,1094,22,241
508,64,18,288,251,1129,212,137,30,210,446,1035,22,242
424,78,9,271,288,1070,198,159,19,189,404,969,22,243
99,50,5,270,145,569,39,130,20,151,194,534,22,244
98,43,1,192,115,449,36,110,6,143,140,435,22,245
95,77,7,179,105,463,38,128,18,107,145,436,22,246
508,64,7,284,255,1118,215,162,8,205,489,1079,22,247
540,80,9,268,225,1122,224,170,17,200,488,1099,22,248
520,61,3,270,283,1137,201,184,13,242,455,1095,22,249
498,95,9,276,294,1172,249,191,27,225,463,1155,22,250
107,48,5,285,134,579,38,100,21,181,162,502,22,251
83,57,2,196,88,426,37,122,7,116,133,415,22,252
545,61,3,267,258,1134,235,155,12,217,414,1033,22,253
568,78,2,281,273,1202,239,185,10,213,521,1168,22,254
576,83,9,295,301,1264,235,202,13,221,508,1179,22,255
553,71,8,302,294,1228,239,189,16,231,459,1134,22,256
506,77,5,269,327,1184,261,201,23,212,430,1127,22,257
120,60,2,284,153,619,61,137,16,156,167,537,22,258
89,46,3,212,130,480,40,131,9,133,162,475,22,259
522,64,2,244,269,1101,247,168,7,211,464,1097,22,260
601,57,3,286,266,1213,270,183,12,246,447,1158,22,261
566,80,19,330,276,1271,225,189,27,256,498,1195,22,262
554,66,2,295,311,1228,225,212,12,251,456,1156,22,263
461,98,1,339,275,1174,199,196,22,249,416,1082,22,264
11,7,6,38,21,83,11,7,2,38,19,77,22,265
10,9,8,12,5,44,14,9,5,9,6,43,22,266
496,57,10,271,279,1113,226,173,15,191,457,1062,22,267
567,56,17,271,270,1181,241,186,21,207,529,1184,22,268
523,88,6,305,267,1189,200,198,11,227,448,1084,22,269
548,62,1,294,286,1191,198,210,6,231,521,1166,22,270
476,62,13,269,330,1150,244,165,36,234,426,1105,22,271
111,67,10,276,172,636,53,160,36,167,177,593,22,272
93,34,2,198,85,412,37,102,6,118,143,406,22,273
479,68,1,268,304,1120,201,184,5,235,493,1118,22,274
457,81,11,281,255,1085,181,193,16,231,448,1069,22,275
605,69,13,296,305,1288,217,198,19,243,554,1231,22,276
507,80,10,307,285,1189,195,188,14,207,498,1102,22,277
454,69,5,295,303,1126,214,184,28,217,408,1051,22,278
141,57,5,255,130,588,59,120,20,160,178,537,22,279
95,48,4,201,112,460,43,103,8,151,159,464,22,280
530,74,8,249,324,1185,193,183,16,178,500,1070,22,281
548,102,49,321,292,1312,208,196,54,239,528,1225,22,282
547,58,5,320,297,1227,206,165,4,271,533,1179,22,283
480,75,2,309,307,1173,162,215,7,248,515,1147,22,284
357,88,6,334,199,984,118,174,23,231,355,901,22,285
111,58,5,288,127,589,55,137,11,161,161,525,22,286
89,78,13,262,133,575,33,154,14,167,180,548,22,287
218,42,2,261,127,650,81,126,4,150,229,590,22,288
552,66,26,298,322,1264,206,199,40,210,610,1265,22,289
545,76,23,337,340,1321,232,202,22,283,566,1305,22,290
526,89,16,347,338,1316,225,204,22,253,614,1318,22,291
454,100,19,362,379,1314,211,217,45,268,538,1279,22,292
124,94,23,323,155,719,67,172,43,189,191,662,22,293
107,55,4,245,88,499,52,135,13,160,157,517,22,294
512,56,7,308,362,1245,209,167,18,241,596,1231,22,295
551,92,10,325,368,1346,222,212,23,257,651,1365,22,296
569,92,19,320,373,1373,217,227,16,234,610,1304,22,297
525,66,26,320,411,1348,229,195,27,260,628,1339,22,298
470,90,20,323,394,1297,207,209,32,239,514,1201,22,299
128,112,23,288,150,701,61,182,44,164,214,665,22,300
131,51,4,214,73,473,62,120,9,117,148,456,22,301
525,66,0,286,317,1194,224,160,9,255,537,1185,22,302
534,74,26,306,474,1414,197,263,25,291,616,1392,22,303
528,81,23,377,400,1409,212,233,24,297,594,1360,22,304
491,108,6,318,430,1353,210,239,18,238,558,1263,22,305
431,97,27,302,347,1204,199,187,40,257,516,1199,22,306
45,16,13,12,20,106,58,16,7,11,21,113,22,307
10,0,0,0,0,10,8,0,0,0,0,8,22,308
473,62,1,268,232,1036,187,145,5,252,406,995,22,309
430,64,1,339,303,1137,179,153,9,245,511,1097,22,310
510,98,6,286,373,1273,213,199,15,235,590,1252,22,311
544,101,3,300,394,1342,214,184,9,255,655,1317,22,312
454,107,5,306,424,1296,235,181,20,243,552,1231,22,313
118,57,3,282,145,605,46,136,18,156,211,567,22,314
100,39,1,208,93,441,45,94,6,135,130,410,22,315
193,57,1,252,134,637,73,135,3,160,223,594,22,316
548,72,4,310,384,1318,223,187,11,285,630,1336,22,317
558,70,1,311,377,1317,227,188,8,264,610,1297,22,318
498,72,1,285,359,1215,198,181,12,245,583,1219,22,319
428,102,7,246,375,1158,183,186,19,250,519,1157,22,320
114,50,4,212,128,508,44,120,18,143,170,495,22,321
97,35,2,189,97,420,46,83,10,134,152,425,22,322
529,64,0,255,337,1185,220,150,8,243,533,1154,22,323
555,78,7,280,403,1323,219,207,12,240,637,1315,22,324
566,95,9,278,362,1310,191,229,16,259,574,1269,22,325
544,93,3,290,379,1309,219,198,5,237,573,1232,22,326
447,88,3,284,304,1126,203,166,15,248,448,1080,22,327
111,75,7,258,145,596,49,148,30,175,213,615,22,328
92,47,2,181,82,404,35,111,8,128,120,402,22,329
463,73,10,289,362,1197,221,155,29,199,539,1143,22,330
468,80,32,283,327,1190,207,189,37,228,505,1166,22,331
318,64,1,301,235,919,128,166,11,236,341,882,22,332
47,33,2,117,76,275,29,66,8,70,117,290,22,333
182,68,10,236,171,667,66,146,22,142,252,628,22,334
90,52,4,188,125,459,46,121,18,148,133,466,22,335
76,57,5,205,88,431,31,89,10,118,120,368,22,336
472,80,14,224,328,1118,192,175,26,195,514,1102,22,337
496,52,0,281,231,1060,165,190,9,207,501,1072,22,338
489,72,4,297,291,1153,154,182,8,244,527,1115,22,339
479,87,8,269,317,1160,198,192,16,222,522,1150,22,340
405,87,6,271,393,1162,166,176,28,212,520,1102,22,341
19,13,4,20,9,65,19,14,5,18,10,66,22,342
12,6,12,7,5,42,11,6,8,7,6,38,22,343
466,106,13,240,351,1176,204,177,17,200,526,1124,22,344
511,81,2,283,362,1239,213,223,12,241,602,1291,22,345
528,71,1,253,297,1150,210,170,10,239,526,1155,22,346
482,88,6,273,359,1208,193,202,20,227,525,1167,22,347
435,90,26,269,347,1167,208,183,29,232,457,1109,22,348
113,59,3,242,167,584,51,142,14,190,189,586,22,349
74,36,4,162,89,365,45,113,6,94,135,393,22,350
446,82,3,256,266,1053,192,178,12,218,487,1087,22,351
512,64,7,315,290,1188,251,196,12,234,494,1187,22,352
477,65,1,312,264,1119,237,169,8,218,457,1089,22,353
449,67,38,309,313,1176,227,181,30,217,436,1091,22,354
388,82,3,259,253,985,165,147,18,215,344,889,22,355
107,34,4,203,97,445,42,80,22,117,148,409,22,356
72,44,3,146,88,353,33,104,11,82,105,335,22,357
259,40,6,256,143,704,98,117,12,161,267,655,22,358
190,36,1,215,91,533,115,76,5,168,127,491,22,359
28,25,4,78,46,181,23,65,8,44,59,199,22,360
197,44,3,211,129,584,80,126,11,149,218,584,22,361
221,65,3,224,136,649,94,99,14,133,204,544,22,362
58,32,7,158,78,333,33,78,27,86,106,330,22,363
52,43,4,142,100,341,33,72,20,86,110,321,22,364
264,78,3,250,153,748,133,154,5,172,279,743,22,365
263,97,15,275,157,807,118,133,28,187,244,710,22,366
105,107,6,182,145,545,55,127,15,170,211,578,23,1
1054,128,2,381,295,1860,180,311,14,329,1073,1907,23,2
1397,146,1,392,317,2253,219,334,21,349,1353,2276,23,3
1282,125,9,411,304,2131,181,326,23,331,1294,2155,23,4
948,136,10,452,391,1937,197,342,42,317,981,1879,23,5
145,101,10,258,163,677,77,220,44,172,184,697,23,6
100,210,6,326,211,853,53,239,21,211,227,751,23,7
1232,136,11,371,327,2077,219,357,31,331,1173,2111,23,8
1506,102,9,331,229,2177,224,262,22,453,1209,2170,23,9
1574,140,5,400,304,2423,234,369,31,346,1495,2475,23,10
1443,171,5,465,414,2498,198,393,37,383,1432,2443,23,11
964,162,23,407,376,1932,203,353,65,370,941,1932,23,12
156,143,14,413,290,1016,68,243,53,290,382,1036,23,13
86,91,9,262,151,599,51,160,18,156,219,604,23,14
203,99,28,268,162,760,86,169,30,215,271,771,23,15
375,77,0,267,165,884,136,187,26,171,362,882,23,16
1239,117,3,426,279,2064,183,333,23,300,1266,2105,23,17
1538,126,7,440,376,2487,214,448,37,345,1393,2437,23,18
471,101,8,346,209,1135,153,201,29,300,418,1101,23,19
138,141,7,321,224,831,114,252,61,250,232,909,23,20
99,99,0,240,178,616,61,205,30,151,210,657,23,21
1226,115,9,373,299,2022,191,292,38,301,1196,2018,23,22
1701,139,3,455,335,2633,234,413,20,374,1571,2612,23,23
1732,144,10,440,358,2684,223,438,26,311,1586,2584,23,24
1539,127,9,456,338,2469,211,446,30,323,1442,2452,23,25
1058,177,11,429,418,2093,199,371,50,409,1054,2083,23,26
178,115,9,407,268,977,85,255,51,257,378,1026,23,27
115,101,5,266,139,626,69,175,17,202,231,694,23,28
1342,142,7,408,282,2181,243,356,29,360,1218,2206,23,29
1731,148,2,491,329,2701,225,382,27,375,1648,2657,23,30
1764,132,7,431,339,2673,245,438,24,383,1609,2699,23,31
1485,175,5,439,352,2456,227,434,18,358,1377,2414,23,32
1021,150,10,387,353,1921,199,321,49,312,1022,1903,23,33
148,135,8,367,253,911,65,246,55,234,303,903,23,34
113,100,12,270,179,674,51,162,26,195,259,693,23,35
1346,145,5,390,324,2210,246,353,20,316,1292,2227,23,36
1677,132,6,428,360,2603,237,411,33,355,1571,2607,23,37
1722,141,5,442,332,2642,235,438,37,390,1550,2650,23,38
1537,165,2,453,337,2494,208,419,26,351,1431,2435,23,39
1045,147,10,390,335,1927,198,381,61,356,959,1955,23,40
160,123,6,386,310,985,75,303,47,239,358,1022,23,41
104,104,10,232,131,581,57,150,18,163,186,574,23,42
1255,132,3,384,294,2068,210,336,23,319,1175,2063,23,43
1574,128,6,411,328,2447,232,430,22,328,1408,2420,23,44
1688,148,12,428,388,2664,243,424,49,346,1533,2595,23,45
1493,144,14,406,344,2401,225,426,37,254,1329,2271,23,46
938,153,16,389,346,1842,213,333,55,346,904,1851,23,47
136,129,4,320,221,810,77,222,42,228,289,858,23,48
107,96,2,265,168,638,59,176,21,176,227,659,23,49
348,97,6,365,210,1026,185,215,22,257,374,1053,23,50
1594,143,2,443,356,2538,246,386,30,374,1541,2577,23,51
1752,153,6,466,343,2720,255,403,31,404,1586,2679,23,52
1527,132,8,487,378,2532,242,494,26,362,1407,2531,23,53
1026,165,9,397,339,1936,187,364,35,359,968,1913,23,54
152,129,9,369,217,876,73,237,36,262,320,928,23,55
90,132,6,267,180,675,54,184,25,197,267,727,23,56
1361,155,11,447,299,2273,241,439,21,331,1231,2263,23,57
1759,106,7,461,369,2702,240,448,19,359,1658,2724,23,58
1825,127,10,426,355,2743,264,448,23,390,1601,2726,23,59
1614,165,3,463,373,2618,209,481,26,378,1497,2591,23,60
1116,154,12,412,376,2070,230,397,51,400,1040,2118,23,61
123,125,5,213,186,652,47,106,28,125,139,445,23,62
97,93,13,246,135,584,35,76,25,114,138,388,23,63
1282,159,8,443,324,2216,244,381,20,385,1224,2254,23,64
1756,127,1,441,342,2667,230,442,22,373,1613,2680,23,65
1783,145,9,466,294,2697,248,439,25,377,1617,2706,23,66
1602,132,4,446,407,2591,237,465,43,405,1426,2576,23,67
1064,166,12,470,404,2116,222,399,62,412,1028,2123,23,68
156,139,12,382,173,862,67,267,58,250,299,941,23,69
126,102,7,317,150,702,62,210,12,172,285,741,23,70
1350,129,3,376,247,2105,202,369,33,320,1305,2229,23,71
1761,150,9,476,372,2768,221,480,40,351,1687,2779,23,72
1838,150,5,484,352,2829,243,464,39,384,1730,2860,23,73
1563,161,4,509,392,2629,212,515,37,406,1465,2635,23,74
1036,200,13,456,409,2114,191,433,50,416,1066,2156,23,75
200,228,12,533,290,1263,85,339,67,323,448,1262,23,76
122,122,6,304,191,745,67,244,25,202,252,790,23,77
1302,141,1,424,310,2178,192,380,26,347,1291,2236,23,78
1754,159,1,501,376,2791,245,511,33,354,1697,2840,23,79
1837,160,11,553,375,2936,220,628,33,396,1636,2913,23,80
1575,146,10,497,359,2587,284,470,39,406,1516,2715,23,81
1046,196,7,485,332,2066,213,416,45,371,1069,2114,23,82
154,134,11,337,241,877,65,246,46,216,351,924,23,83
175,136,2,469,190,972,80,275,18,248,428,1049,23,84
1370,153,4,587,329,2443,232,433,27,361,1463,2516,23,85
1756,131,8,609,382,2886,238,522,39,380,1760,2939,23,86
1772,142,4,518,379,2815,265,449,31,410,1727,2882,23,87
1461,147,7,579,353,2547,228,467,42,411,1460,2608,23,88
1009,189,6,638,442,2284,236,493,64,434,1124,2351,23,89
210,221,7,648,272,1358,101,369,44,356,543,1413,23,90
131,138,13,377,195,854,74,228,29,241,308,880,23,91
1267,147,1,578,357,2350,207,449,35,340,1317,2348,23,92
1717,143,10,467,372,2709,212,478,41,389,1635,2755,23,93
1742,129,4,497,357,2729,253,521,28,379,1623,2804,23,94
1619,151,4,551,419,2744,250,498,34,430,1552,2764,23,95
1081,164,14,451,436,2146,228,437,78,408,1060,2211,23,96
189,195,12,461,290,1147,96,346,52,348,407,1249,23,97
173,158,8,373,197,909,85,253,29,309,319,995,23,98
1330,172,11,447,300,2260,219,418,37,368,1278,2320,23,99
1766,140,2,496,390,2794,239,504,32,399,1727,2901,23,100
1807,127,7,557,374,2872,282,520,38,434,1703,2977,23,101
1654,118,9,462,333,2576,241,475,44,388,1445,2593,23,102
1110,182,11,452,401,2156,225,466,65,362,1099,2217,23,103
197,213,10,541,314,1275,98,365,57,333,465,1318,23,104
123,163,24,451,215,976,82,261,44,297,346,1030,23,105
1289,172,36,496,357,2350,248,413,59,378,1248,2346,23,106
1716,197,30,511,411,2865,237,527,56,414,1587,2821,23,107
1836,148,18,473,350,2825,267,475,40,407,1677,2866,23,108
1599,152,10,414,349,2524,223,429,33,373,1494,2552,23,109
1043,124,4,439,407,2017,227,399,47,385,1021,2079,23,110
134,146,3,405,291,979,70,260,53,234,239,856,23,111
86,90,4,225,97,502,48,92,29,142,175,486,23,112
1305,126,3,432,287,2153,233,365,30,339,1244,2211,23,113
1768,113,8,483,363,2735,244,489,27,377,1667,2804,23,114
1883,131,0,508,348,2870,237,511,28,402,1676,2854,23,115
1635,145,6,507,344,2637,197,485,38,416,1616,2752,23,116
1101,147,1,480,319,2048,193,438,39,357,1114,2141,23,117
147,107,8,238,188,688,65,159,55,160,207,646,23,118
113,111,5,345,230,804,69,250,37,236,289,881,23,119
1368,111,2,455,258,2194,239,362,22,335,1287,2245,23,120
1821,115,22,456,315,2729,205,454,35,336,1691,2721,23,121
1816,150,12,505,334,2817,233,407,55,400,1644,2739,23,122
1629,155,43,465,295,2587,259,508,70,366,1334,2537,23,123
1079,167,15,458,349,2068,203,421,55,372,1022,2073,23,124
25,0,0,0,0,25,24,6,4,6,8,48,23,125
0,0,0,0,0,0,10,13,6,12,7,48,23,126
1361,133,8,411,300,2213,229,404,17,338,1258,2246,23,127
1810,111,8,435,329,2693,247,461,26,352,1651,2737,23,128
1839,135,14,496,376,2860,233,487,41,411,1667,2839,23,129
1585,123,12,434,331,2485,218,460,30,339,1461,2508,23,130
1131,139,12,415,365,2062,256,389,65,379,1043,2132,23,131
5,0,0,0,0,5,20,5,4,13,8,50,23,132
0,0,5,0,0,5,2,11,8,5,6,32,23,133
1333,163,18,446,318,2278,223,493,35,373,1215,2339,23,134
1789,98,2,482,300,2671,247,431,40,360,1710,2788,23,135
1879,113,19,475,287,2773,184,503,50,348,1693,2778,23,136
1710,144,16,500,356,2726,211,555,42,378,1551,2737,23,137
1215,164,16,471,401,2267,218,458,59,418,1063,2216,23,138
200,114,9,372,173,868,74,236,39,235,283,867,23,139
147,123,31,356,145,802,83,220,47,238,325,913,23,140
1426,107,18,472,349,2372,234,438,27,322,1384,2405,23,141
1851,121,0,497,343,2812,237,521,26,397,1689,2870,23,142
1891,128,4,505,316,2844,240,481,21,393,1675,2810,23,143
1599,115,5,478,355,2552,237,477,35,375,1457,2581,23,144
1004,172,2,450,465,2093,242,426,53,452,877,2050,23,145
143,269,39,428,301,1180,90,350,77,291,343,1151,23,146
31,0,0,9,0,40,31,4,5,12,2,54,23,147
0,0,0,0,0,0,4,7,2,7,4,24,23,148
1632,138,0,447,300,2517,251,398,28,371,1580,2628,23,149
1712,119,2,420,302,2555,237,396,19,341,1607,2600,23,150
1625,159,9,461,329,2583,247,496,40,359,1506,2648,23,151
1157,155,9,474,354,2149,224,401,67,422,1102,2216,23,152
156,184,6,434,254,1034,84,296,45,348,324,1097,23,153
120,146,13,322,163,764,59,221,33,272,260,845,23,154
1395,116,7,437,364,2319,227,410,32,348,1396,2413,23,155
1818,129,6,463,409,2825,254,473,32,417,1728,2904,23,156
1849,135,7,504,378,2873,225,467,41,393,1784,2910,23,157
1646,118,11,555,443,2773,239,536,46,416,1564,2801,23,158
1095,221,13,497,428,2254,218,443,70,500,1080,2311,23,159
196,624,21,744,665,2250,103,775,142,434,453,1907,23,160
151,162,15,485,264,1077,86,308,48,317,376,1135,23,161
1400,139,14,488,343,2384,187,403,49,408,1425,2472,23,162
1870,148,11,526,331,2886,214,527,34,398,1770,2943,23,163
1877,146,10,519,404,2956,225,576,50,475,1703,3029,23,164
1718,126,15,504,404,2767,256,503,26,435,1571,2791,23,165
1085,456,22,496,433,2492,196,484,101,405,1179,2365,23,166
203,191,13,484,288,1179,87,311,60,362,412,1232,23,167
140,168,14,358,185,865,90,221,41,295,341,988,23,168
1407,176,14,443,338,2378,221,401,34,375,1402,2433,23,169
1777,202,11,466,433,2889,228,499,40,486,1660,2913,23,170
425,162,13,448,344,1392,164,386,49,368,546,1513,23,171
1532,166,11,537,376,2622,249,499,33,396,1405,2582,23,172
1075,194,12,443,323,2047,193,424,51,395,1069,2132,23,173
167,224,9,423,290,1113,88,378,75,310,285,1136,23,174
138,137,12,298,200,785,63,215,62,231,267,838,23,175
1416,158,39,473,284,2370,202,424,68,394,1162,2250,23,176
1853,187,22,455,353,2870,220,482,50,408,1753,2913,23,177
1819,160,21,496,334,2830,228,486,46,400,1725,2885,23,178
1647,177,12,498,355,2689,193,460,37,400,1603,2693,23,179
1112,226,8,532,329,2207,205,423,53,505,1073,2259,23,180
190,223,7,430,258,1108,92,298,37,383,383,1193,23,181
122,153,10,337,171,793,84,224,39,272,288,907,23,182
1323,165,2,493,349,2332,211,425,28,422,1375,2461,23,183
1665,211,5,483,404,2768,218,519,65,412,1612,2826,23,184
1448,219,4,530,446,2647,229,438,45,642,1246,2600,23,185
203,573,25,514,452,1767,88,755,83,375,366,1667,23,186
731,191,2,447,341,1712,166,391,49,352,779,1737,23,187
181,185,8,368,231,973,101,253,48,320,286,1008,23,188
109,106,3,326,159,703,68,177,17,268,254,784,23,189
1260,169,4,492,293,2218,198,392,24,380,1253,2247,23,190
1536,184,5,437,347,2509,247,448,27,427,1437,2586,23,191
1499,151,5,490,334,2479,207,440,26,418,1390,2481,23,192
1430,157,5,463,381,2436,227,513,33,359,1309,2441,23,193
1013,143,39,439,375,2009,187,392,99,337,951,1966,23,194
143,217,11,445,274,1090,99,294,67,310,336,1106,23,195
114,111,2,338,184,749,86,178,16,258,267,805,23,196
1354,139,3,420,341,2257,224,367,33,369,1316,2309,23,197
1779,139,4,431,323,2676,229,479,40,373,1564,2685,23,198
1767,155,4,478,371,2775,244,400,27,422,1736,2829,23,199
1569,165,1,476,384,2595,215,406,20,436,1543,2620,23,200
1021,179,6,461,350,2017,208,420,93,432,971,2124,23,201
170,172,9,393,287,1031,91,274,60,362,321,1108,23,202
157,164,2,370,193,886,77,244,26,286,322,955,23,203
1305,166,13,413,347,2244,234,447,50,269,1185,2185,23,204
1733,159,5,480,399,2776,193,510,31,429,1668,2831,23,205
1638,159,7,460,400,2664,236,464,54,401,1564,2719,23,206
1566,166,4,486,326,2548,220,416,29,445,1441,2551,23,207
995,447,49,522,403,2416,187,441,55,452,1072,2207,23,208
218,422,34,515,351,1540,93,397,120,376,430,1416,23,209
131,133,3,398,254,919,81,250,50,300,316,997,23,210
1287,156,7,472,363,2285,210,377,47,405,1273,2312,23,211
1762,146,4,513,334,2759,234,503,24,407,1624,2792,23,212
1796,160,13,519,310,2798,218,349,46,415,1429,2457,23,213
1592,154,4,468,368,2586,235,436,25,441,1452,2589,23,214
1062,174,27,471,339,2073,210,481,136,414,901,2142,23,215
222,145,15,465,245,1092,87,333,56,371,381,1228,23,216
132,123,3,368,188,814,72,221,18,294,302,907,23,217
1322,171,3,478,376,2350,217,434,14,424,1303,2392,23,218
1746,147,4,437,366,2700,231,498,27,399,1592,2747,23,219
1705,201,6,486,356,2754,203,568,30,399,1622,2822,23,220
1458,130,38,485,329,2440,183,453,126,335,1326,2423,23,221
911,141,15,471,284,1822,173,390,76,296,843,1778,23,222
172,196,21,393,250,1032,107,315,78,300,342,1142,23,223
114,150,5,333,216,818,70,231,32,259,318,910,23,224
1248,163,2,481,301,2195,207,367,26,374,1241,2215,23,225
1676,160,7,491,381,2715,229,467,34,419,1573,2722,23,226
1685,141,6,492,347,2671,238,439,45,353,1569,2644,23,227
1478,158,2,537,398,2573,201,501,24,512,1387,2625,23,228
1017,229,4,476,356,2082,187,372,82,422,996,2059,23,229
168,173,10,493,268,1112,99,291,63,350,402,1205,23,230
143,150,3,321,197,814,68,238,28,243,282,859,23,231
1218,139,7,425,318,2107,210,373,28,347,1210,2168,23,232
1621,140,5,452,388,2606,204,521,39,382,1490,2636,23,233
1621,202,10,499,406,2738,225,471,83,366,1551,2696,23,234
1456,132,10,446,354,2398,210,456,34,307,1433,2440,23,235
997,154,6,441,388,1986,222,401,53,342,982,2000,23,236
191,152,6,515,259,1123,83,312,49,370,405,1219,23,237
119,209,14,343,231,916,67,240,39,285,324,955,23,238
1292,120,5,436,362,2215,263,423,26,359,1191,2262,23,239
1720,135,7,494,400,2756,226,531,40,381,1614,2792,23,240
1742,131,5,465,382,2725,255,496,26,345,1603,2725,23,241
1457,136,8,431,316,2348,200,405,49,320,1451,2425,23,242
927,136,9,420,361,1853,198,356,56,458,857,1925,23,243
144,177,12,393,268,994,79,272,51,306,381,1089,23,244
103,134,11,332,216,796,63,225,38,223,295,844,23,245
124,125,14,347,201,811,73,223,24,272,247,839,23,246
1572,152,2,454,324,2504,234,440,18,350,1620,2662,23,247
1783,130,9,482,331,2735,242,459,30,412,1714,2857,23,248
1637,125,4,477,364,2607,210,470,21,423,1570,2694,23,249
1125,141,11,399,359,2035,208,397,49,410,1063,2127,23,250
197,142,7,424,251,1021,80,234,67,368,377,1126,23,251
154,132,3,289,199,777,73,236,20,307,213,849,23,252
1382,124,5,474,381,2366,258,431,29,371,1369,2458,23,253
1892,131,2,462,381,2868,255,489,29,396,1782,2951,23,254
1835,126,5,498,377,2841,257,506,36,439,1714,2952,23,255
1642,143,5,485,394,2669,232,498,29,411,1601,2771,23,256
1126,178,9,458,391,2162,214,460,69,384,1079,2206,23,257
276,156,9,850,294,1585,97,314,54,385,851,1701,23,258
144,137,5,432,463,1181,81,244,23,374,406,1128,23,259
1304,99,5,512,370,2290,221,324,29,394,1330,2298,23,260
1846,124,9,498,337,2814,227,487,37,424,1726,2901,23,261
1879,127,4,452,351,2813,231,552,45,393,1679,2900,23,262
1690,148,4,550,382,2774,228,508,43,394,1594,2767,23,263
1111,164,7,451,353,2086,206,393,57,439,1037,2132,23,264
172,121,7,368,193,861,64,218,36,248,225,791,23,265
89,96,4,220,153,562,46,169,20,161,158,554,23,266
1402,106,10,401,342,2261,245,388,30,338,1368,2369,23,267
1812,124,4,481,361,2782,225,505,31,355,1665,2781,23,268
1802,144,10,498,356,2810,233,478,40,369,1748,2868,23,269
1601,157,11,514,355,2638,208,493,26,390,1552,2669,23,270
1049,122,5,471,341,1988,180,397,57,367,1021,2022,23,271
193,212,7,472,258,1142,96,354,64,329,349,1192,23,272
115,103,3,289,160,670,62,222,38,237,235,794,23,273
1380,101,12,422,319,2234,216,380,20,345,1325,2286,23,274
1844,122,2,439,318,2725,245,463,28,384,1689,2809,23,275
1805,152,2,439,336,2734,227,495,32,389,1716,2859,23,276
1619,102,13,473,370,2577,194,468,32,387,1541,2622,23,277
1089,156,6,415,371,2037,207,385,74,379,1067,2112,23,278
191,219,4,453,294,1161,90,311,56,345,394,1196,23,279
127,141,4,392,513,1177,76,235,19,295,410,1035,23,280
1377,144,0,464,328,2313,226,405,25,396,1372,2424,23,281
1918,117,2,453,335,2825,223,469,28,375,1821,2916,23,282
1893,111,1,524,332,2861,244,445,29,423,1784,2925,23,283
1641,148,2,485,321,2597,210,492,17,423,1517,2659,23,284
1014,147,10,491,374,2036,191,404,47,463,1019,2124,23,285
239,192,6,492,267,1196,86,371,47,372,404,1280,23,286
137,137,2,315,203,794,67,257,19,292,277,912,23,287
525,104,3,436,209,1277,185,264,17,298,603,1367,23,288
1771,115,5,474,397,2762,220,499,27,370,1726,2842,23,289
1902,127,4,566,332,2931,244,514,34,444,1800,3036,23,290
1642,119,12,522,382,2677,201,544,37,403,1553,2738,23,291
1086,210,5,500,448,2249,215,549,76,391,1130,2361,23,292
227,215,14,505,354,1315,84,392,69,372,482,1399,23,293
129,348,7,387,304,1175,69,371,23,253,378,1094,23,294
1419,107,17,472,357,2372,234,467,33,355,1364,2453,23,295
1938,136,18,548,385,3025,229,534,52,425,1841,3081,23,296
1901,148,3,466,359,2877,226,527,32,384,1810,2979,23,297
1715,119,3,502,354,2693,221,569,23,409,1622,2844,23,298
1128,152,16,423,352,2071,192,384,57,377,1179,2189,23,299
229,182,14,463,322,1210,87,313,66,397,469,1332,23,300
209,531,2,428,278,1448,91,335,23,399,379,1227,23,301
1379,138,4,431,353,2305,193,397,17,340,1385,2332,23,302
1758,143,4,526,592,3023,211,786,32,449,1690,3168,23,303
1862,128,3,496,353,2842,218,470,27,410,1761,2886,23,304
1596,149,9,458,362,2574,221,447,28,425,1562,2683,23,305
1097,150,4,507,298,2056,203,407,42,399,1066,2117,23,306
200,156,8,565,288,1217,90,396,48,338,404,1276,23,307
132,113,6,341,188,780,66,221,24,280,268,859,23,308
1491,114,6,397,359,2367,207,400,29,366,1463,2465,23,309
1468,133,13,456,334,2404,212,369,44,524,1305,2454,23,310
1638,98,19,470,329,2554,249,397,49,382,1525,2602,23,311
1660,124,21,522,304,2631,241,446,43,439,1566,2735,23,312
1089,133,14,448,347,2031,183,423,39,402,1041,2088,23,313
160,111,6,432,264,973,75,266,49,268,383,1041,23,314
108,144,6,461,535,1254,76,241,37,286,397,1037,23,315
545,120,3,377,270,1315,148,301,32,297,663,1441,23,316
1868,112,6,492,342,2820,202,430,35,390,1782,2839,23,317
1916,108,11,444,349,2828,232,481,35,375,1864,2987,23,318
1685,96,3,458,331,2573,201,434,42,410,1596,2683,23,319
1201,114,4,415,321,2055,212,378,31,371,1121,2113,23,320
145,111,12,363,232,863,68,250,40,229,328,915,23,321
95,91,7,285,180,658,67,219,21,208,235,750,23,322
1513,117,5,428,301,2364,220,407,23,365,1505,2520,23,323
1975,122,5,455,312,2869,209,458,25,406,1868,2966,23,324
1901,116,10,491,330,2848,195,478,50,401,1809,2933,23,325
1683,105,9,477,289,2563,193,417,39,341,1646,2636,23,326
1152,113,6,395,307,1973,182,360,47,422,1050,2061,23,327
190,115,17,458,224,1004,67,255,54,285,418,1079,23,328
114,108,2,410,355,989,76,207,21,242,412,958,23,329
1360,124,9,455,315,2263,176,348,46,374,1370,2314,23,330
1509,90,4,452,336,2391,193,436,34,372,1456,2491,23,331
995,111,18,379,297,1800,169,325,35,528,852,1909,23,332
65,94,3,143,98,403,50,85,15,245,187,582,23,333
434,96,7,528,237,1302,125,266,33,326,520,1270,23,334
150,89,13,357,201,810,67,233,41,219,312,872,23,335
97,98,5,358,302,860,69,204,14,252,282,821,23,336
1401,111,2,355,278,2147,207,346,18,310,1366,2247,23,337
1867,102,9,428,287,2693,191,482,28,374,1703,2778,23,338
1802,105,3,438,269,2617,172,414,34,379,1738,2737,23,339
1579,103,0,456,339,2477,182,477,13,388,1465,2525,23,340
1058,105,4,395,284,1846,171,362,48,320,1009,1910,23,341
132,73,9,240,155,609,49,171,36,167,154,577,23,342
79,79,5,187,116,466,40,149,17,93,144,443,23,343
1384,88,6,390,272,2140,182,363,40,314,1367,2266,23,344
1929,122,7,439,291,2788,208,502,39,361,1638,2748,23,345
1960,116,11,410,265,2762,191,444,35,374,1686,2730,23,346
1699,110,3,444,319,2575,172,524,31,369,1508,2604,23,347
1085,113,9,458,322,1987,187,374,56,349,1057,2023,23,348
247,379,6,502,316,1450,89,421,54,368,380,1312,23,349
112,137,20,290,160,719,48,250,27,163,262,750,23,350
1442,107,2,389,273,2213,250,395,18,323,1347,2333,23,351
1842,122,3,524,290,2781,198,436,30,389,1804,2857,23,352
1798,134,5,479,291,2707,217,457,37,390,1619,2720,23,353
1506,123,3,533,314,2479,202,441,26,442,1422,2533,23,354
917,114,7,376,335,1749,188,368,53,343,793,1745,23,355
102,136,6,354,187,785,53,240,40,237,231,801,23,356
95,85,10,328,421,939,64,175,19,172,373,803,23,357
739,74,4,344,269,1430,143,267,30,296,705,1441,23,358
368,55,2,271,144,840,116,149,15,260,346,886,23,359
48,47,2,79,68,244,28,47,14,108,93,290,23,360
442,70,4,276,213,1005,84,268,15,213,456,1036,23,361
454,111,4,338,232,1139,98,215,42,223,537,1115,23,362
105,107,4,242,154,612,49,169,44,134,234,630,23,363
83,121,114,280,193,791,46,192,138,160,237,773,23,364
673,96,1,358,314,1442,149,276,19,300,785,1529,23,365
707,152,20,337,240,1456,155,220,46,426,631,1478,23,366
201,599,1,554,862,2217,59,175,6,535,404,1179,24,1
376,530,0,522,855,2283,217,158,8,673,466,1522,24,2
300,611,5,512,881,2309,255,211,15,599,493,1573,24,3
284,492,1,436,785,1998,249,195,10,659,452,1565,24,4
236,676,8,395,843,2158,214,220,11,639,461,1545,24,5
239,676,7,523,1007,2452,71,208,14,583,324,1200,24,6
231,639,2,479,894,2245,66,193,12,495,394,1160,24,7
290,384,2,475,702,1853,213,146,14,590,363,1326,24,8
216,378,1,396,694,1685,186,114,8,537,302,1147,24,9
176,326,0,327,699,1528,224,143,11,637,423,1438,24,10
185,341,0,358,745,1629,258,246,14,831,687,2036,24,11
207,396,11,410,594,1618,192,173,17,625,518,1525,24,12
160,375,2,306,421,1264,75,137,9,483,274,978,24,13
137,417,1,264,583,1402,52,123,8,373,221,777,24,14
174,647,1,387,697,1906,91,136,2,431,233,893,24,15
231,373,1,422,598,1625,188,124,13,520,222,1067,24,16
146,372,0,357,465,1340,178,144,5,475,295,1097,24,17
165,316,0,305,467,1253,212,145,6,487,404,1254,24,18
208,347,2,356,571,1484,274,197,17,648,365,1501,24,19
172,394,6,255,385,1212,65,145,19,612,234,1075,24,20
142,472,1,309,579,1503,33,126,5,481,271,916,24,21
198,377,2,303,586,1466,129,129,8,441,305,1012,24,22
147,286,0,305,480,1218,162,118,10,460,258,1008,24,23
166,329,2,294,507,1298,175,160,12,494,312,1153,24,24
157,278,2,259,517,1213,177,164,8,536,427,1312,24,25
160,346,4,373,509,1392,218,193,16,647,470,1544,24,26
177,370,6,296,506,1355,66,140,7,563,276,1052,24,27
116,464,2,338,546,1466,42,145,8,469,300,964,24,28
233,333,1,315,582,1464,168,96,2,573,351,1190,24,29
170,330,2,273,550,1325,178,135,9,454,261,1037,24,30
161,290,0,267,485,1203,198,152,11,517,319,1197,24,31
153,325,1,325,512,1316,272,165,7,652,484,1580,24,32
180,279,2,289,662,1412,282,155,10,619,429,1495,24,33
154,324,2,242,491,1213,62,157,9,551,283,1062,24,34
141,400,1,420,677,1639,69,122,6,562,406,1165,24,35
202,358,4,423,580,1567,215,141,6,548,297,1207,24,36
192,268,2,265,499,1226,196,126,11,469,260,1062,24,37
162,242,2,281,536,1223,240,170,13,518,401,1342,24,38
212,280,1,324,569,1386,274,157,11,612,574,1628,24,39
191,399,4,347,572,1513,251,205,19,750,513,1738,24,40
153,313,11,283,542,1302,67,139,7,609,284,1106,24,41
139,515,5,339,571,1569,51,124,7,485,364,1031,24,42
246,410,2,375,624,1657,165,148,4,525,320,1162,24,43
180,285,0,271,523,1259,210,163,7,479,345,1204,24,44
152,295,3,301,593,1344,225,169,16,599,484,1493,24,45
214,353,1,366,620,1554,258,291,10,696,515,1770,24,46
235,431,5,383,713,1767,314,291,32,794,939,2370,24,47
211,312,4,308,540,1375,87,209,15,722,527,1560,24,48
130,500,1,327,627,1585,46,176,12,613,428,1275,24,49
247,487,7,454,910,2105,152,161,9,736,528,1586,24,50
367,397,1,402,848,2015,224,141,11,615,364,1355,24,51
208,376,2,327,793,1706,216,156,9,621,399,1401,24,52
206,362,6,370,689,1633,252,217,11,713,577,1770,24,53
218,412,9,386,735,1760,269,205,14,744,642,1874,24,54
181,409,8,322,587,1507,92,146,5,641,351,1235,24,55
205,587,0,413,701,1906,72,169,7,549,440,1237,24,56
313,434,0,405,847,1999,192,120,7,583,456,1358,24,57
252,361,1,349,757,1720,221,152,13,620,367,1373,24,58
185,302,2,252,643,1384,250,129,9,621,492,1501,24,59
183,368,1,319,759,1630,272,236,9,758,786,2061,24,60
245,423,3,399,725,1795,295,224,14,821,735,2089,24,61
172,392,7,336,799,1706,100,184,14,740,491,1529,24,62
158,476,2,458,731,1825,60,189,14,586,443,1292,24,63
283,380,1,434,780,1878,173,141,11,610,378,1313,24,64
273,341,0,302,671,1587,201,176,10,550,407,1344,24,65
194,420,4,326,699,1643,272,196,19,754,467,1708,24,66
248,324,0,418,762,1752,300,382,16,891,871,2460,24,67
284,460,5,486,876,2111,360,372,30,896,962,2620,24,68
197,465,0,417,712,1791,103,204,17,850,528,1702,24,69
205,679,2,524,688,2098,85,218,12,627,756,1698,24,70
377,584,0,562,903,2426,211,188,9,635,654,1697,24,71
301,389,1,453,816,1960,245,198,12,630,497,1582,24,72
271,400,1,499,947,2118,246,218,15,798,754,2031,24,73
290,473,0,503,923,2189,310,332,17,841,918,2418,24,74
341,631,2,495,947,2416,367,400,26,911,906,2610,24,75
236,651,7,543,807,2244,91,224,39,893,667,1914,24,76
202,763,3,601,1018,2587,101,283,18,704,642,1748,24,77
495,660,3,611,1093,2862,248,192,9,722,702,1873,24,78
329,407,3,366,830,1935,226,231,9,587,531,1584,24,79
313,462,7,369,765,1916,272,341,14,738,728,2093,24,80
305,528,3,394,1063,2293,292,336,10,775,749,2162,24,81
368,577,5,594,1045,2589,276,332,16,765,663,2052,24,82
276,653,9,510,828,2276,56,303,12,684,531,1586,24,83
273,788,0,650,1067,2778,63,298,6,748,760,1875,24,84
410,579,1,682,1008,2680,253,261,5,722,795,2036,24,85
484,481,1,493,893,2352,250,275,15,754,688,1982,24,86
266,457,1,456,905,2085,266,331,9,812,698,2116,24,87
282,578,1,552,895,2308,322,330,8,868,812,2340,24,88
375,669,0,715,749,2508,340,371,22,910,868,2511,24,89
301,380,6,494,696,1877,98,286,20,914,774,2092,24,90
218,668,1,526,715,2128,81,289,12,895,857,2134,24,91
443,543,0,609,948,2543,235,261,5,904,666,2071,24,92
376,494,2,544,915,2331,241,222,7,766,570,1806,24,93
332,531,4,546,874,2287,275,280,17,777,532,1881,24,94
349,466,1,539,975,2330,322,357,13,969,878,2539,24,95
369,489,2,561,895,2316,323,378,17,1042,865,2625,24,96
263,488,4,361,651,1767,88,254,17,1123,649,2131,24,97
276,670,1,553,784,2284,139,313,15,972,835,2274,24,98
373,584,2,434,869,2262,262,244,9,871,726,2112,24,99
381,498,1,537,1053,2470,251,243,13,772,598,1877,24,100
365,472,0,495,961,2293,305,276,15,858,771,2225,24,101
378,491,0,534,799,2202,342,347,13,1001,958,2661,24,102
396,512,5,560,869,2342,393,402,34,1082,1107,3018,24,103
301,702,1,452,812,2268,94,261,19,1023,778,2175,24,104
262,696,2,592,1151,2703,75,316,16,901,800,2108,24,105
435,607,4,585,892,2523,244,250,18,1011,754,2277,24,106
347,480,4,488,863,2182,280,251,16,899,623,2069,24,107
327,426,1,448,784,1986,286,310,13,755,873,2237,24,108
486,473,4,537,1091,2591,341,380,28,976,1061,2786,24,109
388,537,1,569,1024,2519,380,415,12,1053,1042,2902,24,110
296,570,8,520,898,2292,90,264,14,951,605,1924,24,111
205,642,2,626,967,2442,72,264,13,904,656,1909,24,112
448,586,1,578,1082,2695,272,257,14,965,647,2155,24,113
393,491,1,514,906,2305,250,228,9,839,555,1881,24,114
300,484,3,501,789,2077,274,256,10,803,682,2025,24,115
352,501,0,548,998,2399,328,347,28,1015,882,2600,24,116
433,563,4,523,1254,2777,421,335,18,930,908,2612,24,117
279,579,6,421,877,2162,112,255,11,857,511,1746,24,118
223,659,3,673,1269,2827,96,321,9,921,651,1998,24,119
495,516,3,642,1126,2782,264,256,11,880,596,2007,24,120
370,483,3,510,1088,2454,297,234,9,798,586,1924,24,121
341,494,6,506,982,2329,295,350,14,861,722,2242,24,122
327,491,12,466,963,2259,358,404,35,1165,955,2917,24,123
295,530,8,641,888,2362,418,380,18,1159,898,2873,24,124
262,579,5,412,813,2071,128,233,22,1008,612,2003,24,125
253,743,5,590,1029,2620,77,363,11,932,709,2092,24,126
435,591,2,546,999,2573,280,292,15,895,659,2141,24,127
382,527,3,437,868,2217,293,313,25,864,676,2171,24,128
314,430,4,456,981,2185,365,378,16,880,718,2357,24,129
377,459,3,547,980,2366,406,415,12,1229,1069,3131,24,130
387,589,6,581,960,2523,516,399,25,1210,950,3100,24,131
235,636,1,554,826,2252,161,333,18,1030,658,2200,24,132
271,824,3,652,1080,2830,71,387,15,1008,741,2222,24,133
507,657,0,654,1136,2954,270,335,19,917,635,2176,24,134
432,539,3,575,1088,2637,284,294,11,956,650,2195,24,135
360,609,2,539,926,2436,288,414,11,879,766,2358,24,136
386,592,3,659,1213,2853,407,447,18,1151,1075,3098,24,137
475,692,6,727,1586,3486,449,457,27,1179,1101,3213,24,138
390,677,2,565,1098,2732,109,302,22,687,960,2080,24,139
376,775,4,733,982,2870,98,430,18,987,902,2435,24,140
512,609,6,616,1081,2824,323,428,24,1153,886,2814,24,141
460,634,3,551,1071,2719,405,437,27,1299,1043,3211,24,142
366,553,3,566,1034,2522,501,472,20,1174,1087,3254,24,143
463,559,4,537,1037,2600,474,587,29,1207,1207,3504,24,144
469,607,8,613,1100,2797,441,564,66,1167,1191,3429,24,145
423,589,9,579,807,2407,136,324,34,1162,695,2351,24,146
239,643,7,632,920,2441,88,330,10,893,654,1975,24,147
339,866,3,682,1219,3109,97,316,20,934,776,2143,24,148
616,635,2,676,1322,3251,314,274,13,912,773,2286,24,149
463,558,2,598,949,2570,301,340,7,836,742,2226,24,150
356,522,4,585,973,2440,319,409,18,923,1004,2673,24,151
424,570,10,526,966,2496,392,437,20,1062,941,2852,24,152
359,670,10,555,931,2525,110,339,20,986,763,2218,24,153
357,852,12,757,1137,3115,92,361,20,740,675,1888,24,154
570,589,0,610,1201,2970,275,305,20,806,665,2071,24,155
502,570,3,551,1034,2660,303,343,12,796,714,2168,24,156
462,483,13,588,961,2507,317,350,13,821,754,2255,24,157
420,497,7,586,1007,2517,396,454,16,933,972,2771,24,158
436,607,2,574,959,2578,343,448,24,938,954,2707,24,159
335,560,7,565,939,2406,113,342,22,954,700,2131,24,160
308,701,1,852,1140,3002,92,403,12,949,820,2276,24,161
529,602,0,653,1085,2869,341,277,15,864,770,2267,24,162
438,572,2,489,899,2400,307,349,11,840,641,2148,24,163
411,469,6,585,859,2330,299,421,10,786,882,2398,24,164
420,506,5,571,952,2454,356,461,46,970,1040,2873,24,165
446,671,7,624,1000,2748,383,417,27,1130,991,2948,24,166
324,645,6,520,1055,2550,109,328,31,898,717,2083,24,167
327,738,4,725,1136,2930,88,306,14,884,635,1927,24,168
543,604,2,595,953,2697,304,286,18,842,621,2071,24,169
426,533,0,458,904,2321,295,395,35,864,818,2407,24,170
423,543,1,522,871,2360,333,320,17,890,607,2167,24,171
389,475,4,490,1010,2368,369,350,17,934,805,2475,24,172
450,698,5,536,857,2546,334,430,21,902,879,2566,24,173
351,640,14,554,812,2371,136,326,26,1027,681,2196,24,174
402,643,2,678,1160,2885,99,375,15,929,690,2108,24,175
668,759,5,583,1103,3118,279,278,25,818,707,2107,24,176
550,541,8,554,1064,2717,252,374,17,798,581,2022,24,177
499,474,3,594,974,2544,326,457,26,787,789,2385,24,178
495,574,6,585,1002,2662,402,560,15,1085,1057,3119,24,179
467,615,4,604,953,2643,320,570,26,1065,1177,3158,24,180
437,602,4,472,735,2250,109,427,26,1070,786,2418,24,181
382,620,0,710,921,2633,124,356,14,911,678,2083,24,182
553,599,1,565,986,2704,298,363,12,943,659,2275,24,183
449,522,4,632,1028,2635,353,430,24,925,796,2528,24,184
553,687,4,675,1108,3027,410,602,31,1022,1060,3125,24,185
431,401,9,635,778,2254,159,319,33,992,688,2191,24,186
308,633,2,481,904,2328,322,359,15,1088,764,2548,24,187
283,618,8,586,931,2426,130,356,13,1130,645,2274,24,188
571,823,3,937,1470,3804,121,333,21,1036,689,2200,24,189
719,761,1,752,1262,3495,303,320,13,951,603,2190,24,190
627,652,5,618,1063,2965,291,325,9,808,591,2024,24,191
421,493,2,487,998,2401,281,313,21,792,638,2045,24,192
438,598,2,575,1028,2641,410,381,18,974,976,2759,24,193
461,562,3,545,1090,2661,344,403,52,1001,964,2764,24,194
384,634,2,645,911,2576,129,328,26,963,712,2158,24,195
422,676,3,708,1098,2907,89,323,21,923,680,2036,24,196
627,688,2,635,1015,2967,323,243,22,926,622,2136,24,197
439,553,4,467,920,2383,317,292,15,787,634,2045,24,198
372,570,7,508,949,2406,314,309,18,859,615,2115,24,199
425,621,1,521,1040,2608,376,460,24,970,981,2811,24,200
245,771,10,489,950,2465,305,450,30,931,951,2667,24,201
313,547,7,617,948,2432,109,364,32,983,593,2081,24,202
383,751,1,741,1029,2905,66,376,8,990,617,2057,24,203
529,720,1,756,1119,3125,265,355,21,658,789,2088,24,204
508,667,3,567,1149,2894,282,408,18,913,670,2291,24,205
433,529,6,514,933,2415,347,393,25,874,728,2367,24,206
438,627,2,576,976,2619,357,478,24,894,989,2742,24,207
443,606,4,599,1020,2672,333,503,23,1022,1019,2900,24,208
362,585,5,511,877,2340,134,330,29,964,747,2204,24,209
411,650,3,691,917,2672,103,331,12,918,680,2044,24,210
538,643,4,585,1184,2954,270,278,18,1039,713,2318,24,211
472,644,5,548,901,2570,278,339,13,841,650,2121,24,212
444,552,6,463,848,2313,347,403,16,875,754,2395,24,213
459,663,4,514,1041,2681,335,465,17,1066,1031,2914,24,214
416,579,7,477,1060,2539,335,506,23,967,870,2701,24,215
366,704,9,603,545,2227,56,356,33,1096,787,2328,24,216
411,679,4,734,1092,2920,145,414,15,1055,853,2482,24,217
628,791,4,616,1120,3159,267,327,9,1047,830,2480,24,218
441,653,2,529,1023,2648,305,334,16,950,670,2275,24,219
400,578,4,558,823,2363,364,387,18,925,807,2501,24,220
404,639,1,554,996,2594,305,438,17,1101,984,2845,24,221
428,672,5,549,907,2561,363,441,31,917,954,2706,24,222
357,649,8,520,835,2369,120,280,23,1099,656,2178,24,223
337,653,4,632,1050,2676,123,318,13,941,807,2202,24,224
476,627,3,634,1202,2942,263,260,9,923,688,2143,24,225
461,575,9,440,875,2360,311,342,13,931,603,2200,24,226
385,528,5,550,1008,2476,342,376,16,917,779,2430,24,227
392,557,2,509,1074,2534,333,422,8,1041,1122,2926,24,228
403,515,6,563,1003,2490,423,448,28,1041,1042,2982,24,229
318,688,1,526,807,2340,143,316,13,1161,687,2320,24,230
349,534,2,658,1036,2579,102,307,14,981,762,2166,24,231
459,811,26,575,1084,2955,265,307,38,952,705,2267,24,232
375,604,7,507,1151,2644,297,317,22,956,589,2181,24,233
354,513,24,498,1082,2471,253,402,37,891,726,2309,24,234
343,547,6,461,1240,2597,317,393,16,923,906,2555,24,235
319,793,10,557,1181,2860,344,462,32,1027,1078,2943,24,236
274,676,15,493,985,2443,115,246,27,916,640,1944,24,237
264,767,2,647,1165,2845,90,236,13,947,603,1889,24,238
428,793,2,522,1271,3016,266,293,15,911,600,2085,24,239
336,564,1,473,982,2356,280,337,12,921,601,2151,24,240
273,456,2,405,862,1998,302,291,16,832,689,2130,24,241
301,722,6,425,601,2055,338,401,26,1053,1029,2847,24,242
469,658,3,673,873,2676,478,492,26,1307,1229,3532,24,243
357,589,13,543,908,2410,131,287,12,1018,654,2102,24,244
237,632,0,455,955,2279,86,289,13,821,579,1788,24,245
293,817,4,649,1200,2963,108,244,20,933,703,2008,24,246
453,599,6,507,1115,2680,260,208,24,825,600,1917,24,247
329,509,4,389,898,2129,235,260,17,707,455,1674,24,248
254,462,5,402,862,1985,198,289,13,803,709,2012,24,249
291,539,1,418,953,2202,318,308,15,901,561,2103,24,250
263,618,16,389,806,2092,109,197,21,837,533,1697,24,251
222,677,3,632,1257,2791,66,307,17,848,653,1891,24,252
416,608,2,494,1053,2573,251,223,9,786,515,1784,24,253
299,456,1,430,890,2076,248,273,18,743,589,1871,24,254
275,424,3,470,879,2051,263,330,18,795,597,2003,24,255
284,491,3,404,959,2141,312,361,11,944,887,2515,24,256
327,570,6,493,1183,2579,340,431,20,974,899,2664,24,257
250,614,2,822,1100,2788,131,274,20,1474,639,2538,24,258
325,757,0,639,1191,2912,83,283,12,780,668,1826,24,259
489,627,1,567,1170,2854,233,294,9,995,647,2178,24,260
359,532,2,495,1041,2429,277,283,15,862,721,2158,24,261
315,540,3,481,975,2314,264,341,13,839,708,2165,24,262
346,530,9,431,1125,2441,361,429,26,1064,1105,2985,24,263
334,565,8,505,1078,2490,324,390,11,1068,918,2711,24,264
262,562,8,531,841,2204,129,348,28,1068,632,2205,24,265
258,659,0,612,1096,2625,117,309,10,840,747,2023,24,266
479,576,0,563,1247,2865,295,276,4,833,622,2030,24,267
318,454,1,446,1007,2226,237,317,15,797,593,1959,24,268
330,430,2,435,984,2181,290,355,12,919,721,2297,24,269
310,454,8,580,1096,2448,298,450,18,918,1040,2724,24,270
365,600,3,489,1230,2687,319,389,16,1074,903,2701,24,271
262,673,4,586,1000,2525,100,319,24,871,626,1940,24,272
278,644,8,610,1113,2653,86,357,24,903,566,1936,24,273
447,606,2,529,1079,2663,253,270,13,834,696,2066,24,274
321,509,4,414,1011,2259,268,226,17,787,661,1959,24,275
281,482,1,414,1027,2205,355,324,11,851,686,2227,24,276
308,561,2,454,1154,2479,348,416,19,951,1054,2788,24,277
347,563,4,508,1122,2544,360,368,34,1108,923,2793,24,278
275,622,8,528,916,2349,128,280,20,988,564,1980,24,279
279,679,6,742,1158,2864,83,292,24,877,604,1880,24,280
455,599,2,584,1153,2793,264,242,12,787,685,1990,24,281
325,557,2,470,1131,2485,295,261,10,794,676,2036,24,282
259,518,1,483,915,2176,320,455,8,951,940,2674,24,283
405,478,4,684,1221,2792,410,524,18,1064,1166,3182,24,284
451,651,6,762,1246,3116,399,540,25,1266,1284,3514,24,285
310,599,4,624,1020,2557,140,417,13,1087,706,2363,24,286
250,730,7,633,1223,2843,133,333,16,923,786,2191,24,287
531,697,4,667,1391,3290,297,293,20,1131,758,2499,24,288
410,508,0,595,1255,2768,352,264,19,930,725,2290,24,289
354,545,2,657,1065,2623,327,325,22,896,839,2409,24,290
407,559,1,657,1211,2835,366,446,11,1101,1055,2979,24,291
444,663,2,607,1161,2877,343,394,23,1117,1077,2954,24,292
248,643,2,529,888,2310,115,330,20,1086,678,2229,24,293
340,707,6,674,1288,3015,97,324,21,1088,867,2397,24,294
481,626,0,543,1244,2894,285,211,12,937,698,2143,24,295
373,554,15,497,1133,2572,333,250,25,802,722,2132,24,296
277,540,2,545,1070,2434,327,345,21,746,769,2208,24,297
346,498,0,537,1242,2623,328,392,22,907,911,2560,24,298
384,660,7,577,1414,3042,372,397,16,1103,933,2821,24,299
278,806,5,562,1073,2724,107,338,17,872,631,1965,24,300
287,614,5,661,1219,2786,187,346,19,797,782,2131,24,301
442,472,0,623,1174,2711,301,233,9,912,880,2335,24,302
343,465,1,392,867,2068,317,306,13,718,735,2089,24,303
294,408,1,379,850,1932,319,327,14,803,839,2302,24,304
304,477,2,448,994,2225,400,380,18,929,979,2706,24,305
335,496,6,500,999,2336,276,356,26,836,882,2376,24,306
217,554,3,382,811,1967,113,390,22,765,608,1898,24,307
205,602,8,705,956,2476,112,307,12,961,726,2118,24,308
405,514,0,501,799,2219,283,215,5,776,574,1853,24,309
261,402,1,449,683,1796,272,190,8,706,531,1707,24,310
257,392,4,452,726,1831,310,234,8,762,669,1983,24,311
309,435,7,450,827,2028,314,336,17,913,927,2507,24,312
361,436,8,547,891,2243,371,317,27,957,597,2269,24,313
266,445,5,508,691,1915,112,242,11,872,621,1858,24,314
264,498,4,528,732,2026,81,261,13,780,572,1707,24,315
350,608,0,686,951,2595,186,211,10,787,526,1720,24,316
391,436,0,541,1018,2386,257,212,11,706,554,1740,24,317
335,421,1,493,819,2069,269,214,11,714,562,1770,24,318
307,430,4,547,910,2198,343,344,11,744,738,2180,24,319
343,538,3,586,950,2420,377,321,18,871,939,2526,24,320
237,514,3,440,644,1838,95,198,5,844,522,1664,24,321
233,551,9,643,978,2414,91,245,16,715,580,1647,24,322
416,499,1,670,1016,2602,287,214,11,761,554,1827,24,323
333,371,1,457,767,1929,293,221,11,750,652,1927,24,324
286,398,9,479,800,1972,349,304,15,772,711,2151,24,325
306,395,3,512,926,2142,384,444,12,856,1156,2852,24,326
284,489,6,485,956,2220,470,413,30,947,1270,3130,24,327
287,468,7,422,776,1960,170,253,21,1116,976,2536,24,328
264,508,4,474,647,1897,115,282,11,1016,796,2220,24,329
327,385,3,584,748,2047,391,236,12,997,899,2535,24,330
281,401,3,513,933,2131,428,600,11,1051,1205,3295,24,331
340,474,2,610,853,2279,485,504,16,1553,1449,4007,24,332
206,294,3,463,595,1561,93,127,8,730,413,1371,24,333
252,638,13,643,1058,2604,208,195,16,628,523,1570,24,334
468,743,12,829,1251,3303,87,265,16,679,552,1599,24,335
728,988,6,1196,1605,4523,94,303,15,780,636,1828,24,336
903,737,8,809,1554,4011,236,193,12,705,626,1772,24,337
512,663,3,728,1431,3337,292,201,10,662,533,1698,24,338
355,467,5,497,956,2280,286,193,14,685,611,1789,24,339
281,491,1,425,794,1992,243,271,11,863,725,2113,24,340
293,458,7,475,915,2148,302,250,25,857,741,2175,24,341
216,658,12,562,1382,2830,105,208,18,790,494,1615,24,342
388,752,5,1204,1996,4345,84,234,18,837,669,1842,24,343
448,442,6,697,1126,2719,266,214,19,736,605,1840,24,344
256,410,2,503,920,2091,288,265,12,729,575,1869,24,345
347,448,3,370,727,1895,315,308,12,734,687,2056,24,346
245,390,0,483,949,2067,337,347,10,1048,935,2677,24,347
305,486,2,509,955,2257,455,434,15,1311,1220,3435,24,348
208,443,4,488,698,1841,292,378,18,1827,1267,3782,24,349
173,523,6,505,814,2021,127,293,12,1172,818,2422,24,350
326,486,7,519,870,2208,315,252,15,1090,744,2416,24,351
277,425,7,398,892,1999,346,309,25,1006,906,2592,24,352
280,428,1,434,835,1978,384,328,10,1094,1013,2829,24,353
230,464,6,416,782,1898,496,533,10,1066,1179,3284,24,354
351,397,4,486,821,2059,369,552,27,880,961,2789,24,355
244,435,4,397,544,1624,96,394,24,942,860,2316,24,356
252,434,1,374,627,1688,95,374,8,869,954,2300,24,357
331,392,2,382,659,1766,332,461,10,1022,1060,2885,24,358
285,326,4,410,571,1596,348,258,16,922,604,2148,24,359
229,401,2,442,611,1685,91,130,6,523,334,1084,24,360
421,556,6,710,943,2636,181,233,8,588,455,1465,24,361
628,535,3,729,1038,2933,189,229,15,626,433,1492,24,362
467,678,1,629,841,2616,103,243,17,668,462,1493,24,363
465,648,7,751,898,2769,112,299,16,650,503,1580,24,364
567,514,6,722,932,2741,237,240,17,787,569,1850,24,365
452,607,26,639,870,2594,281,305,39,794,536,1955,24,366
71,43,0,181,112,407,28,118,4,149,194,493,25,1
766,81,2,306,298,1453,193,181,6,218,872,1470,25,2
842,96,8,311,425,1682,237,335,13,226,929,1740,25,3
848,93,1,321,305,1568,230,257,7,240,892,1626,25,4
498,162,2,293,383,1338,192,291,31,218,616,1348,25,5
81,84,4,226,133,528,42,165,18,145,185,555,25,6
85,55,0,342,136,618,44,146,5,196,241,632,25,7
742,80,0,292,326,1440,232,244,9,183,787,1455,25,8
981,66,4,267,235,1553,219,184,12,291,900,1606,25,9
1015,106,2,290,323,1736,243,306,6,238,1032,1825,25,10
972,87,7,335,417,1818,249,399,21,234,960,1863,25,11
465,98,2,237,266,1068,179,175,11,182,382,929,25,12
89,99,2,487,162,839,40,199,23,176,330,768,25,13
62,54,0,180,108,404,24,111,3,153,135,426,25,14
123,48,3,186,153,513,76,123,10,152,163,524,25,15
281,76,2,162,210,731,137,218,5,157,265,782,25,16
801,81,3,319,314,1518,235,286,7,201,804,1533,25,17
954,115,2,333,432,1836,214,409,12,241,982,1858,25,18
321,140,5,262,240,968,125,225,35,218,351,954,25,19
86,89,5,304,277,761,34,263,33,217,255,802,25,20
87,64,3,291,148,593,37,168,7,186,243,641,25,21
738,65,2,299,343,1447,225,248,7,216,796,1492,25,22
1097,104,3,338,405,1947,287,347,10,250,1125,2019,25,23
1075,108,8,332,403,1926,252,383,23,231,1055,1944,25,24
974,101,5,334,416,1830,227,408,12,228,955,1830,25,25
540,146,3,364,417,1470,204,287,51,271,682,1495,25,26
122,154,4,456,324,1060,57,266,47,322,422,1114,25,27
92,82,0,300,132,606,39,161,9,174,245,628,25,28
766,99,0,313,311,1489,240,259,8,222,804,1533,25,29
1153,91,1,331,415,1991,283,332,7,253,1143,2018,25,30
1063,107,7,325,397,1899,251,363,18,230,1051,1913,25,31
1005,104,4,344,338,1795,233,339,17,267,978,1834,25,32
553,164,9,301,432,1459,177,292,57,254,612,1392,25,33
118,186,5,461,225,995,57,234,42,289,377,999,25,34
93,86,0,321,156,656,33,157,4,229,299,722,25,35
738,78,0,320,338,1474,235,250,7,214,791,1497,25,36
1054,97,6,339,433,1929,265,393,16,260,1052,1986,25,37
1096,114,10,321,408,1949,271,357,20,231,1087,1966,25,38
963,109,1,369,390,1832,247,355,18,250,999,1869,25,39
555,168,1,290,369,1383,204,281,67,219,650,1421,25,40
133,168,2,387,302,992,47,301,57,231,367,1003,25,41
64,96,0,334,178,672,25,186,23,207,324,765,25,42
733,78,0,328,338,1477,226,226,12,212,812,1488,25,43
966,119,2,323,428,1838,306,377,19,238,948,1888,25,44
1018,107,10,368,430,1933,245,452,21,275,973,1966,25,45
1012,125,9,302,368,1816,232,350,14,202,982,1780,25,46
531,179,15,315,343,1383,190,269,44,248,625,1376,25,47
144,134,2,385,256,921,42,249,44,216,374,925,25,48
97,82,1,389,153,722,29,192,8,269,307,805,25,49
221,101,1,289,272,884,130,199,3,247,375,954,25,50
1047,96,2,334,422,1901,308,336,16,264,1065,1989,25,51
1134,78,5,352,398,1967,254,334,16,246,1075,1925,25,52
1024,107,4,380,430,1945,245,429,7,266,1010,1957,25,53
636,148,1,312,329,1426,189,254,53,264,691,1451,25,54
98,165,4,442,335,1044,58,285,84,283,393,1103,25,55
118,71,4,286,219,698,43,221,13,222,274,773,25,56
834,84,0,339,407,1664,268,355,6,270,843,1742,25,57
1144,95,2,350,449,2040,272,376,11,253,1165,2077,25,58
1108,105,5,353,391,1962,267,388,11,244,1125,2035,25,59
1065,116,7,394,388,1970,245,390,14,288,1066,2003,25,60
615,144,11,325,483,1578,219,348,63,234,719,1583,25,61
108,135,7,382,258,890,41,262,52,223,394,972,25,62
93,79,0,417,186,775,40,209,4,262,411,926,25,63
844,100,3,362,347,1656,264,299,11,233,919,1726,25,64
1128,94,3,380,420,2025,258,361,11,287,1140,2057,25,65
1280,89,3,360,422,2154,284,412,12,249,1245,2202,25,66
1070,141,4,425,474,2114,245,458,36,332,1052,2123,25,67
595,175,6,446,463,1685,200,368,66,361,710,1705,25,68
162,172,6,432,294,1066,56,306,55,257,411,1085,25,69
104,90,1,372,173,740,35,206,9,193,381,824,25,70
796,103,0,351,343,1593,236,307,9,257,835,1644,25,71
1149,113,6,404,488,2160,232,471,13,273,1178,2167,25,72
1135,140,10,454,494,2233,269,469,33,286,1285,2342,25,73
1093,159,3,498,480,2233,248,523,44,290,1153,2258,25,74
620,160,5,398,530,1713,243,348,75,254,762,1682,25,75
231,186,0,798,407,1622,55,566,96,401,603,1721,25,76
117,104,7,506,280,1014,39,300,15,295,419,1068,25,77
818,97,0,403,379,1697,254,329,1,264,915,1763,25,78
1156,112,6,421,478,2173,306,394,13,269,1223,2205,25,79
1110,118,4,509,528,2269,263,538,11,287,1189,2288,25,80
1033,115,1,454,487,2090,270,498,12,279,1117,2176,25,81
608,178,3,518,643,1950,230,483,85,339,800,1937,25,82
137,158,5,503,308,1111,47,316,63,241,479,1146,25,83
180,91,0,898,276,1445,54,353,11,381,713,1512,25,84
741,103,0,570,464,1878,245,335,38,266,1016,1900,25,85
1048,99,5,560,477,2189,246,472,10,326,1201,2255,25,86
941,108,4,372,388,1813,227,338,16,246,984,1811,25,87
896,108,1,441,392,1838,228,387,8,245,1004,1872,25,88
505,174,6,668,442,1795,210,388,65,349,864,1876,25,89
180,174,6,1045,379,1784,61,494,49,367,854,1825,25,90
108,91,0,480,242,921,50,291,6,251,423,1021,25,91
746,105,1,545,349,1746,222,439,3,273,884,1821,25,92
1100,123,3,466,437,2129,317,399,11,251,1189,2167,25,93
1086,104,5,459,455,2109,278,451,13,275,1140,2157,25,94
1075,125,2,491,498,2191,242,544,16,323,1132,2257,25,95
642,140,2,460,496,1740,232,414,43,281,753,1723,25,96
214,158,3,727,389,1491,56,432,51,410,510,1459,25,97
240,98,2,549,261,1150,45,307,7,441,429,1229,25,98
766,87,0,401,363,1617,240,277,21,269,852,1659,25,99
1164,109,1,324,467,2065,267,420,39,280,1127,2133,25,100
1108,139,4,442,418,2111,256,456,24,318,1106,2160,25,101
1079,97,4,371,378,1929,258,400,21,276,1057,2012,25,102
578,174,6,340,462,1560,209,431,39,258,695,1632,25,103
195,173,4,686,426,1484,55,537,68,328,579,1567,25,104
139,98,0,603,214,1054,46,277,8,346,467,1144,25,105
780,85,1,422,460,1748,279,399,6,260,847,1791,25,106
1159,121,1,400,477,2158,307,497,10,290,1147,2251,25,107
1137,131,4,356,440,2068,284,466,11,279,1099,2139,25,108
1102,125,17,428,459,2131,286,470,32,290,1119,2197,25,109
620,181,5,395,489,1690,228,390,48,253,763,1682,25,110
135,213,7,918,452,1725,58,718,40,290,629,1735,25,111
102,75,6,432,185,800,45,200,8,264,387,904,25,112
771,113,6,358,404,1652,273,288,10,249,874,1694,25,113
1070,137,2,367,580,2156,323,485,13,280,1114,2215,25,114
1044,139,1,388,543,2115,309,491,5,240,1066,2111,25,115
1104,128,5,435,531,2203,288,518,16,302,1051,2175,25,116
622,167,5,403,532,1729,228,399,83,301,671,1682,25,117
165,147,6,500,363,1181,59,371,115,308,364,1217,25,118
93,115,0,479,268,955,35,299,64,279,403,1080,25,119
818,120,2,352,377,1669,266,355,15,242,871,1749,25,120
1142,125,3,384,497,2151,309,401,8,242,1242,2202,25,121
1126,126,5,361,452,2070,286,403,14,268,1111,2082,25,122
1048,127,0,377,436,1988,285,376,16,305,1036,2018,25,123
631,219,4,399,551,1804,218,483,61,338,687,1787,25,124
168,145,7,515,283,1118,58,346,60,243,454,1161,25,125
102,94,0,402,211,809,26,271,6,222,337,862,25,126
820,86,0,358,400,1664,247,259,19,275,878,1678,25,127
1216,134,18,360,552,2280,294,487,34,276,1179,2270,25,128
1155,143,4,371,601,2274,305,477,19,288,1175,2264,25,129
1036,136,2,381,420,1975,246,395,17,285,1023,1966,25,130
610,168,16,365,440,1599,235,316,68,277,693,1589,25,131
223,157,4,535,279,1198,65,275,56,337,537,1270,25,132
90,104,1,341,152,688,35,209,6,282,269,801,25,133
832,112,1,384,416,1745,263,288,7,285,958,1801,25,134
1141,93,4,372,421,2031,289,378,21,281,1130,2099,25,135
1112,135,2,377,464,2090,267,447,17,267,1112,2110,25,136
1031,166,1,490,486,2174,284,473,2,320,1039,2118,25,137
652,181,7,451,425,1716,243,336,44,308,739,1670,25,138
159,178,10,456,251,1054,51,304,72,208,415,1050,25,139
175,125,0,411,220,931,39,274,13,273,395,994,25,140
808,117,0,368,425,1718,257,337,17,267,917,1795,25,141
1212,145,4,365,492,2218,301,508,11,269,1186,2275,25,142
1173,133,1,457,465,2229,296,441,15,308,1213,2273,25,143
1035,122,1,393,415,1966,273,376,6,282,1070,2007,25,144
522,170,11,413,525,1641,224,416,63,312,586,1601,25,145
140,153,3,596,393,1285,57,486,67,265,423,1298,25,146
148,136,0,584,204,1072,42,299,36,298,467,1142,25,147
113,94,0,382,188,777,63,231,5,224,362,885,25,148
1062,116,9,415,441,2043,295,356,59,288,1152,2150,25,149
1117,120,10,387,400,2034,301,373,21,270,1177,2142,25,150
996,129,2,376,415,1918,285,387,16,276,981,1945,25,151
620,176,0,384,428,1608,238,363,46,314,700,1661,25,152
143,217,6,426,399,1191,55,418,53,293,391,1210,25,153
104,88,1,406,210,809,49,217,6,273,339,884,25,154
888,91,0,352,433,1764,263,375,12,285,896,1831,25,155
1190,119,3,375,495,2182,298,457,7,282,1197,2241,25,156
1267,116,1,450,434,2268,274,438,11,392,1261,2376,25,157
1105,136,0,387,527,2155,255,545,17,287,1089,2193,25,158
661,208,6,498,698,2071,227,559,92,326,780,1984,25,159
184,212,5,952,517,1870,47,801,81,316,612,1857,25,160
139,114,1,549,266,1069,39,344,10,302,484,1179,25,161
887,94,5,369,377,1732,268,290,19,254,914,1745,25,162
1238,120,11,388,489,2246,303,450,23,284,1242,2302,25,163
1215,153,3,427,491,2289,293,488,41,308,1129,2259,25,164
1090,118,0,425,417,2050,263,413,14,304,1139,2133,25,165
628,205,7,393,536,1769,230,474,93,261,730,1788,25,166
158,211,3,569,350,1291,51,433,53,326,466,1329,25,167
141,114,0,435,198,888,45,241,5,297,386,974,25,168
845,100,3,412,368,1728,266,334,8,276,896,1780,25,169
1158,118,1,445,550,2272,318,469,36,335,1202,2360,25,170
355,133,1,501,433,1423,164,363,23,300,514,1364,25,171
1020,125,0,414,383,1942,249,394,7,270,1044,1964,25,172
588,204,3,381,366,1542,227,318,49,253,705,1552,25,173
177,208,7,409,375,1176,53,408,99,284,374,1218,25,174
115,110,0,320,177,722,45,227,12,268,275,827,25,175
831,119,0,376,364,1690,278,301,9,288,915,1791,25,176
1153,107,1,383,444,2088,311,410,11,296,1182,2210,25,177
1223,109,3,438,464,2237,321,411,15,327,1161,2235,25,178
1061,160,0,476,439,2136,295,459,7,305,1143,2209,25,179
628,204,5,452,418,1707,225,412,63,302,727,1729,25,180
162,184,3,508,300,1157,51,343,62,304,435,1195,25,181
135,102,0,380,202,819,44,220,5,308,308,885,25,182
828,116,4,384,427,1759,261,355,18,237,923,1794,25,183
1030,115,1,433,456,2035,317,388,9,289,1095,2098,25,184
819,150,9,466,548,1992,255,469,18,344,853,1939,25,185
161,770,5,601,747,2284,32,1471,103,327,394,2327,25,186
340,196,5,367,376,1284,170,322,46,297,488,1323,25,187
120,157,4,418,267,966,51,336,47,237,386,1057,25,188
109,98,0,318,169,694,47,203,11,219,348,828,25,189
763,113,0,348,379,1603,273,296,13,243,820,1645,25,190
1012,122,2,345,458,1939,307,386,10,317,962,1982,25,191
1016,110,2,367,429,1924,343,394,9,202,1057,2005,25,192
947,138,0,360,413,1858,273,406,14,284,936,1913,25,193
550,143,9,332,492,1526,220,365,74,256,601,1516,25,194
126,188,6,543,439,1302,49,465,83,292,395,1284,25,195
106,107,0,331,177,721,33,249,8,274,262,826,25,196
796,97,5,290,322,1510,261,277,4,247,834,1623,25,197
1106,118,5,296,420,1945,274,401,7,282,1023,1987,25,198
1119,97,5,318,413,1952,282,305,11,295,1077,1970,25,199
954,124,0,357,438,1873,262,351,14,278,1006,1911,25,200
553,204,4,353,535,1649,202,400,155,245,698,1700,25,201
165,174,13,476,475,1303,57,554,73,290,394,1368,25,202
116,107,1,473,195,892,40,243,12,252,430,977,25,203
768,100,0,340,494,1702,210,476,6,236,793,1721,25,204
1134,97,2,383,477,2093,286,402,7,274,1163,2132,25,205
1072,146,5,408,532,2163,289,505,13,289,1103,2199,25,206
968,108,4,473,460,2013,285,393,16,263,1054,2011,25,207
587,192,6,417,423,1625,214,337,73,270,713,1607,25,208
144,201,2,547,335,1229,59,377,83,261,422,1202,25,209
101,107,3,357,222,790,44,254,23,263,302,886,25,210
784,88,5,372,509,1758,250,328,102,272,870,1822,25,211
1099,111,1,356,420,1987,281,432,9,298,1066,2086,25,212
1072,132,7,431,396,2038,261,354,22,261,1197,2095,25,213
951,154,8,411,486,2010,279,375,20,285,1059,2018,25,214
650,161,2,433,537,1783,257,436,69,319,682,1763,25,215
232,163,2,622,302,1321,32,451,86,317,462,1348,25,216
126,115,0,414,186,841,52,192,6,268,412,930,25,217
725,81,2,315,397,1520,254,298,7,248,805,1612,25,218
1051,116,2,348,472,1989,319,381,19,256,1051,2026,25,219
1013,112,8,388,426,1947,285,350,18,295,1053,2001,25,220
890,99,0,365,388,1742,220,300,25,279,927,1751,25,221
473,151,5,290,373,1292,174,301,85,225,527,1312,25,222
152,165,3,455,299,1074,82,330,47,271,378,1108,25,223
114,88,0,471,236,909,46,243,7,275,348,919,25,224
710,115,3,293,315,1436,238,249,11,228,778,1504,25,225
1022,138,2,390,455,2007,295,406,12,274,1050,2037,25,226
1022,118,20,369,428,1957,298,350,25,291,1048,2012,25,227
915,131,6,330,463,1845,304,352,23,301,902,1882,25,228
542,183,10,359,402,1496,233,315,68,276,603,1495,25,229
125,170,7,468,332,1102,59,324,80,277,367,1107,25,230
100,89,0,352,196,737,44,190,13,263,302,812,25,231
729,106,7,301,337,1480,257,221,16,247,840,1581,25,232
1093,125,12,347,534,2111,298,423,23,269,1130,2143,25,233
1094,146,7,339,450,2036,281,396,28,261,1085,2051,25,234
968,134,11,407,433,1953,251,400,32,265,1029,1977,25,235
548,155,5,351,396,1455,202,312,50,274,618,1456,25,236
177,163,3,512,352,1207,51,387,56,334,420,1248,25,237
91,99,4,384,193,771,49,225,22,283,302,881,25,238
781,69,2,327,447,1626,223,378,6,233,814,1654,25,239
1113,107,8,351,542,2121,295,483,12,285,1116,2191,25,240
1075,115,3,381,517,2091,279,472,16,248,1097,2112,25,241
959,121,2,381,436,1899,279,329,35,291,961,1895,25,242
482,138,3,377,483,1483,189,315,78,324,552,1458,25,243
134,151,5,586,263,1139,66,363,75,274,417,1195,25,244
110,137,0,468,208,923,33,247,26,211,434,951,25,245
109,109,0,310,190,718,47,182,4,245,326,804,25,246
1146,99,20,363,425,2053,309,319,29,266,1169,2092,25,247
1177,102,6,412,418,2115,293,386,10,277,1189,2155,25,248
1050,123,3,330,414,1920,256,383,16,252,1045,1952,25,249
620,174,7,341,409,1551,221,336,47,271,703,1578,25,250
157,186,5,541,386,1275,74,340,156,282,432,1284,25,251
134,75,2,369,248,828,41,217,7,311,301,877,25,252
851,88,3,370,373,1685,275,334,15,230,916,1770,25,253
1264,146,1,369,487,2267,299,463,18,294,1254,2328,25,254
1217,123,4,396,497,2237,287,484,12,263,1241,2287,25,255
1088,152,3,446,564,2253,294,531,17,262,1140,2244,25,256
665,209,7,370,521,1772,215,436,70,308,735,1764,25,257
176,218,4,632,370,1400,68,454,73,320,448,1363,25,258
112,86,6,526,205,935,57,225,14,287,446,1029,25,259
833,110,0,457,381,1781,259,386,6,278,919,1848,25,260
1349,124,2,375,491,2341,307,437,14,272,1380,2410,25,261
1270,108,7,405,489,2279,252,467,20,267,1266,2272,25,262
1135,121,2,397,506,2161,273,461,19,256,1124,2133,25,263
682,196,2,389,467,1736,246,352,76,303,799,1776,25,264
161,173,7,570,321,1232,51,377,96,358,401,1283,25,265
104,81,0,348,210,743,40,179,5,244,330,798,25,266
868,85,0,356,373,1682,265,299,14,225,945,1748,25,267
1237,108,2,374,528,2249,325,436,12,245,1312,2330,25,268
1221,138,5,392,523,2279,306,491,24,276,1209,2306,25,269
1090,141,0,471,492,2194,303,414,26,294,1176,2213,25,270
647,162,3,401,533,1746,240,418,96,281,749,1784,25,271
175,194,3,745,501,1618,57,628,73,410,461,1629,25,272
107,99,2,494,230,932,51,250,14,304,442,1061,25,273
930,86,2,387,367,1772,282,333,14,232,979,1840,25,274
1297,108,5,354,485,2249,342,395,18,281,1219,2255,25,275
1193,144,7,401,481,2226,291,413,21,257,1229,2211,25,276
1062,146,1,401,486,2096,311,421,15,283,1066,2096,25,277
656,174,5,361,459,1655,224,325,52,323,741,1665,25,278
152,221,3,482,330,1188,47,400,56,286,420,1209,25,279
115,87,0,397,216,815,44,209,3,250,369,875,25,280
932,119,10,368,409,1838,298,328,11,284,1004,1925,25,281
1275,117,16,421,504,2333,323,438,28,279,1276,2344,25,282
1199,171,5,425,495,2295,304,438,28,296,1301,2367,25,283
1056,144,2,395,497,2094,315,415,15,287,1132,2164,25,284
583,175,3,426,449,1636,227,369,57,322,711,1686,25,285
187,185,5,634,392,1403,46,482,54,325,492,1399,25,286
172,107,1,500,236,1016,42,266,22,331,440,1101,25,287
368,96,9,430,348,1251,223,271,20,294,597,1405,25,288
1252,110,2,391,517,2272,335,454,10,312,1261,2372,25,289
1255,141,6,391,475,2268,299,433,14,246,1275,2267,25,290
1102,127,2,428,544,2203,261,523,9,280,1095,2168,25,291
631,177,7,345,449,1609,225,369,46,277,750,1667,25,292
174,197,9,550,379,1309,61,434,70,337,478,1380,25,293
103,101,0,499,271,974,43,333,8,304,425,1113,25,294
945,105,3,385,424,1862,309,367,5,257,953,1891,25,295
1291,109,4,367,464,2235,339,431,11,272,1282,2335,25,296
1232,134,4,391,588,2349,307,557,22,275,1227,2388,25,297
1107,146,1,451,553,2258,288,477,17,291,1194,2267,25,298
644,173,3,363,467,1650,214,350,35,291,782,1672,25,299
154,212,10,524,454,1354,56,375,92,305,509,1337,25,300
366,100,4,479,264,1213,60,256,43,498,422,1279,25,301
904,85,0,384,389,1762,291,323,9,283,941,1847,25,302
1230,100,1,455,724,2510,336,663,13,334,1191,2537,25,303
1264,158,5,427,486,2340,324,459,11,314,1303,2411,25,304
982,158,2,351,534,2027,291,380,24,274,1061,2030,25,305
568,211,1,372,438,1590,225,323,69,259,708,1584,25,306
151,212,4,544,385,1296,62,413,71,302,440,1288,25,307
119,83,2,351,205,760,47,205,6,270,317,845,25,308
906,75,0,375,429,1785,279,301,6,273,962,1821,25,309
930,92,2,365,432,1821,314,263,29,381,937,1924,25,310
1019,99,4,360,477,1959,312,372,13,260,1032,1989,25,311
1041,98,0,370,453,1962,283,330,8,275,1061,1957,25,312
619,165,4,325,492,1605,216,341,79,271,713,1620,25,313
133,157,8,518,301,1117,69,274,51,303,447,1144,25,314
110,96,0,419,198,823,39,170,20,276,395,900,25,315
442,81,0,397,299,1219,198,222,9,275,620,1324,25,316
1304,82,7,332,487,2212,350,383,19,252,1292,2296,25,317
1261,119,5,403,559,2347,329,496,15,265,1284,2389,25,318
1144,98,0,379,465,2086,288,410,25,292,1095,2110,25,319
658,167,3,374,413,1615,214,321,46,292,743,1616,25,320
148,161,6,511,343,1169,62,295,64,296,481,1198,25,321
92,84,0,339,218,733,37,200,7,278,330,852,25,322
922,86,1,322,390,1721,285,290,9,257,969,1810,25,323
1340,101,0,369,467,2277,329,431,7,279,1298,2344,25,324
1271,103,7,405,460,2246,314,407,15,270,1251,2257,25,325
1097,90,0,397,527,2111,295,452,16,318,1082,2163,25,326
595,142,2,336,416,1491,215,313,37,250,686,1501,25,327
149,141,9,431,338,1068,51,309,49,294,383,1086,25,328
100,82,0,390,190,762,50,186,7,231,359,833,25,329
845,100,0,378,375,1698,271,262,10,240,951,1734,25,330
947,112,1,428,434,1922,267,352,10,296,1041,1966,25,331
517,130,4,400,338,1389,195,236,20,364,598,1413,25,332
57,62,1,138,106,364,24,83,5,147,172,431,25,333
213,108,6,485,233,1045,110,223,29,254,497,1113,25,334
115,94,3,388,241,841,46,221,27,242,318,854,25,335
83,58,0,361,181,683,34,257,2,177,329,799,25,336
828,70,0,325,320,1543,244,255,3,215,912,1629,25,337
1220,98,3,509,522,2352,305,431,13,396,1207,2352,25,338
1227,106,4,411,462,2210,323,403,11,287,1151,2175,25,339
1072,106,1,353,516,2048,278,483,15,266,1042,2084,25,340
638,123,6,311,407,1485,190,359,43,236,719,1547,25,341
112,159,3,488,480,1242,59,428,78,284,418,1267,25,342
102,67,0,392,250,811,54,237,3,264,365,923,25,343
908,83,5,271,354,1621,265,307,11,212,906,1701,25,344
1280,103,4,376,450,2213,320,456,11,262,1265,2314,25,345
1274,100,2,375,407,2158,282,425,8,259,1168,2142,25,346
1132,138,1,428,518,2217,267,501,21,273,1102,2164,25,347
641,156,3,344,449,1593,190,385,61,299,672,1607,25,348
155,135,4,552,494,1340,46,476,65,346,416,1349,25,349
94,91,5,303,229,722,31,244,9,262,303,849,25,350
817,87,2,320,345,1571,253,282,8,237,903,1683,25,351
1188,111,2,431,519,2251,297,393,37,255,1272,2254,25,352
1102,104,4,416,433,2059,262,406,15,285,1128,2096,25,353
938,107,11,406,498,1960,279,448,10,283,967,1987,25,354
421,106,2,288,362,1179,155,277,26,170,405,1033,25,355
78,77,1,307,187,650,38,187,24,162,212,623,25,356
68,44,0,245,146,503,20,171,2,98,158,449,25,357
285,75,0,273,234,867,118,190,2,177,353,840,25,358
118,34,2,170,115,439,94,69,2,150,158,473,25,359
29,25,2,67,57,180,8,66,0,59,73,206,25,360
179,58,3,257,184,681,95,155,9,140,280,679,25,361
190,75,0,281,188,734,100,162,14,135,308,719,25,362
77,75,4,192,134,482,31,145,19,134,163,492,25,363
85,42,0,217,137,481,27,130,9,113,183,462,25,364
317,83,0,355,299,1054,143,220,13,237,507,1120,25,365
352,313,81,368,307,1421,153,219,312,296,468,1448,25,366
98,495,5,1141,801,2540,148,414,7,971,884,2424,26,1
1185,954,26,1441,3031,6637,2134,705,27,1745,2125,6736,26,2
1437,1297,33,1683,3791,8241,2464,870,42,1925,2735,8036,26,3
1465,1545,16,1721,3613,8360,2415,948,14,2106,2949,8432,26,4
1028,2011,165,1652,3142,7998,1816,1391,68,2014,3063,8352,26,5
188,1000,109,1745,1346,4388,295,961,52,1659,1354,4321,26,6
205,786,8,2344,1707,5050,297,582,20,2487,1618,5004,26,7
1482,1165,12,1575,3548,7782,2391,864,15,1872,2487,7629,26,8
1943,1018,7,1879,3395,8242,3068,717,17,1893,2516,8211,26,9
2022,1877,11,2123,4411,10444,3156,1181,16,2285,3462,10100,26,10
1917,1962,12,1931,4216,10038,2857,1352,24,2296,3244,9773,26,11
1224,1687,131,2087,3518,8647,2070,1128,65,2457,2889,8609,26,12
272,1981,237,3188,2607,8285,396,1544,67,2921,3335,8263,26,13
255,1011,17,2923,1978,6184,342,831,29,2826,1896,5924,26,14
279,980,6,2089,1710,5064,532,772,18,1951,1756,5029,26,15
771,1078,9,1331,2101,5290,1187,870,16,1623,1652,5348,26,16
1904,1543,7,1702,3759,8915,2456,1065,14,2298,3004,8837,26,17
2089,1981,21,1899,4394,10384,2977,1769,15,2418,3235,10414,26,18
826,1733,230,1690,2057,6536,1160,1427,83,1673,2261,6604,26,19
262,1624,168,2595,2206,6855,350,1403,113,2676,2420,6962,26,20
231,812,8,2473,1955,5479,316,776,13,2567,1725,5397,26,21
1695,1397,26,1657,3517,8292,2465,954,29,1925,2799,8172,26,22
2221,1823,9,1896,4590,10539,3399,1184,12,2301,3414,10310,26,23
2183,1912,16,1965,4627,10703,3306,1375,23,2376,3441,10521,26,24
2046,2051,34,1954,4346,10431,2947,1348,22,2372,3312,10001,26,25
1154,2504,324,2147,3589,9718,2071,1964,157,2499,3176,9867,26,26
285,1969,226,2836,2671,7987,451,1662,98,3065,2710,7986,26,27
214,921,7,2772,1794,5708,344,697,23,2644,1747,5455,26,28
1650,1432,40,1704,3681,8507,2662,982,33,1976,2698,8351,26,29
2359,1750,11,1864,4464,10448,3431,1091,16,2266,3390,10194,26,30
2192,1927,9,2032,4546,10706,3221,1371,19,2444,3431,10486,26,31
2121,2134,9,1879,4386,10529,2952,1389,15,2402,3569,10327,26,32
1364,2265,302,2130,3644,9705,2270,1933,107,2396,3190,9896,26,33
609,2176,207,5125,3570,11687,862,2483,245,4334,4777,12701,26,34
483,1166,18,4176,2903,8746,675,1557,57,3933,3565,9787,26,35
1753,1414,14,1582,3681,8444,2685,1024,17,1942,2809,8477,26,36
2356,1889,11,1959,4673,10888,3490,1397,17,2287,3528,10719,26,37
2309,2120,22,2017,4633,11101,3330,1333,28,2451,3594,10736,26,38
2179,2070,9,2076,4560,10894,3209,1453,17,2417,3423,10519,26,39
1328,2264,303,2242,3640,9777,2320,1880,94,2486,3227,10007,26,40
340,2056,302,2885,2684,8267,451,1840,133,3095,2773,8292,26,41
248,1020,10,2618,2006,5902,311,783,29,2294,2088,5505,26,42
1629,1362,9,1672,3621,8293,2528,986,9,1894,2832,8249,26,43
2145,1799,12,2003,4543,10502,3140,1455,16,2187,3647,10445,26,44
2214,2010,13,2230,4614,11081,3090,1541,15,2587,3861,11094,26,45
2246,2272,21,2258,4353,11150,3174,1443,26,3167,3730,11540,26,46
1355,2205,194,2481,3600,9835,1913,1760,103,2965,3126,9867,26,47
330,2040,219,2961,2461,8011,446,1671,126,3035,3110,8388,26,48
303,1303,14,3342,3009,7971,437,1086,29,3461,2462,7475,26,49
605,1143,30,2450,2275,6503,894,998,32,2316,2389,6629,26,50
2151,1705,16,2005,4824,10701,3510,1218,13,2475,3332,10548,26,51
2133,2035,35,2125,4682,11010,3502,1312,34,2426,3423,10697,26,52
2047,2253,25,2148,4651,11124,3300,1553,30,2478,3637,10998,26,53
1295,2288,239,2250,3574,9646,2200,1757,84,2480,3177,9698,26,54
293,1677,198,2736,2510,7414,423,1503,102,2772,2674,7474,26,55
237,928,10,2646,2060,5881,388,817,15,2710,1863,5793,26,56
1704,1524,12,1776,3859,8875,2811,1175,22,2006,2914,8928,26,57
2376,1884,8,2074,4794,11136,3599,1290,13,2512,3553,10967,26,58
2274,1924,8,2108,4668,10982,3432,1333,12,2387,3409,10573,26,59
2159,2262,21,2185,4689,11316,3307,1579,21,2644,3498,11049,26,60
1415,2454,239,2488,4067,10663,2440,1918,77,2418,3703,10556,26,61
294,1758,252,2712,2452,7468,444,1660,112,2609,3061,7886,26,62
291,1113,22,3309,2367,7102,422,850,30,3626,2218,7146,26,63
1762,1678,17,1915,3858,9230,2714,1122,24,2065,3065,8990,26,64
2495,1859,11,2095,4777,11237,3516,1454,16,2437,3537,10960,26,65
2479,2019,16,2248,4711,11473,3344,1566,16,2453,3708,11087,26,66
2257,2652,20,2142,4720,11791,3256,1737,43,2463,4212,11711,26,67
1393,2558,270,2454,4021,10696,2293,2178,97,2633,3692,10893,26,68
348,1673,204,2856,2275,7356,445,1516,114,2886,2582,7543,26,69
293,1143,6,3129,2455,7026,388,961,18,3358,2300,7025,26,70
1691,1690,18,2083,3891,9373,2688,1346,23,2319,3169,9545,26,71
2344,2364,29,2480,4898,12115,3483,1594,27,2840,4109,12053,26,72
2448,2408,12,2616,5100,12584,3385,1934,13,3065,4103,12500,26,73
2221,2791,34,2761,4818,12625,3028,1961,153,3027,4284,12453,26,74
1428,2536,197,2814,4321,11296,2151,2031,198,3137,3952,11469,26,75
627,3571,307,4344,3503,12352,796,2546,133,5052,4461,12988,26,76
299,1291,7,3556,2753,7906,420,1265,23,3857,2425,7990,26,77
1795,1837,27,2242,4031,9932,2795,1311,20,2391,3342,9859,26,78
2434,2138,14,2444,4854,11884,3552,1626,13,2713,3881,11785,26,79
2459,2493,12,2508,5241,12713,3398,1980,22,2876,4045,12321,26,80
2419,2662,33,2581,4770,12465,3266,1870,38,2872,4232,12278,26,81
1496,2786,258,2807,4346,11693,2352,2294,98,3019,4095,11858,26,82
295,2375,250,2999,3140,9059,453,2201,98,2827,3438,9017,26,83
409,1619,17,4449,3051,9545,505,1262,12,4507,3040,9326,26,84
1770,1903,26,2640,4202,10541,2684,1647,32,2524,3483,10370,26,85
2423,2179,42,2872,5120,12636,3329,1774,49,2929,4274,12355,26,86
2309,2251,22,2920,4533,12035,3049,1591,32,2796,4123,11591,26,87
2013,2530,37,3034,4200,11814,2800,1855,45,2886,4160,11746,26,88
1285,2775,273,3322,4100,11755,1837,2510,105,3364,4241,12057,26,89
511,2336,234,4181,3646,10908,470,2413,136,3933,4555,11507,26,90
496,1196,33,3961,2620,8306,523,1284,34,3559,2490,7890,26,91
1594,1629,26,2777,3697,9723,2383,1583,31,2418,3315,9730,26,92
2249,1884,11,2868,5000,12012,3436,1643,19,2928,4146,12172,26,93
2317,2297,32,2606,5099,12351,3336,1908,32,2907,4015,12198,26,94
2325,2855,37,3039,5226,13482,3555,2091,26,3092,4626,13390,26,95
1471,3073,217,3245,4600,12606,2292,2661,110,3270,4619,12952,26,96
649,2474,242,4534,3829,11728,595,2320,119,5101,3809,11944,26,97
740,1368,22,4144,2934,9208,524,1285,30,4855,2421,9115,26,98
1916,1720,44,2205,3671,9556,2795,1235,62,2308,3121,9521,26,99
2377,2290,55,2418,4765,11905,3563,1665,58,2656,3801,11743,26,100
2409,2388,38,2688,4702,12225,3397,1588,38,2892,3914,11829,26,101
2280,2374,31,2339,4516,11540,3321,1647,47,2596,3719,11330,26,102
1475,2733,191,2605,4105,11109,2351,2127,97,2778,3715,11068,26,103
485,2548,298,3248,3305,9884,509,2425,175,3851,3452,10412,26,104
381,1474,30,3783,2640,8308,541,1027,34,4205,2577,8384,26,105
1763,1878,11,2306,3833,9791,2598,1499,18,2374,3127,9616,26,106
2297,2311,16,2338,4600,11562,3408,1522,16,2650,3897,11493,26,107
2330,2441,18,2509,4735,12033,3290,1661,19,2911,3771,11652,26,108
2093,2882,27,2368,4609,11979,3148,1847,20,2758,3919,11692,26,109
1329,2435,234,2667,4214,10879,2221,2156,96,2967,3461,10901,26,110
347,2829,273,3225,3590,10264,477,2658,139,3813,3977,11064,26,111
352,1259,10,3266,2276,7163,471,895,16,3587,2344,7313,26,112
1664,1627,16,2049,3804,9160,2755,1093,20,2092,2968,8928,26,113
2116,2042,13,2230,5020,11421,3495,1563,22,2691,3580,11351,26,114
2103,2465,23,2470,5162,12223,3475,1806,29,2706,3808,11824,26,115
2079,2476,19,2505,4703,11782,3371,1735,18,2782,3924,11830,26,116
1345,2579,211,2574,4535,11244,2581,2229,87,2800,3599,11296,26,117
407,2525,263,3136,2842,9173,505,1888,204,3632,2987,9216,26,118
351,1420,20,3430,2750,7971,450,1271,50,4065,2321,8157,26,119
1747,1660,11,2099,3760,9277,2880,1183,13,2187,2976,9239,26,120
2417,2097,10,2242,4795,11561,3651,1468,14,2557,3579,11269,26,121
2355,2363,13,2287,4725,11743,3343,1597,12,2710,3844,11506,26,122
2180,2474,31,2390,4638,11713,3203,1650,28,2669,3873,11423,26,123
1356,2663,191,2436,4130,10776,2163,2125,104,2717,3645,10754,26,124
394,2243,203,5067,6999,14906,856,1696,80,9992,3194,15818,26,125
352,1231,14,3018,2081,6696,422,939,15,3053,2238,6667,26,126
1751,1616,23,2032,3885,9307,2824,1207,21,2120,3020,9192,26,127
2473,2116,7,2371,4975,11942,3479,1729,10,2648,3696,11562,26,128
2432,2411,12,2541,5017,12413,3389,1922,20,2856,3876,12063,26,129
2167,2414,18,2504,4602,11705,3068,1722,19,2647,3782,11238,26,130
1401,2351,181,2582,3673,10188,2158,1756,80,2664,3358,10016,26,131
512,1933,185,4432,5471,12533,744,1548,79,7446,3118,12935,26,132
301,1286,17,3530,2071,7205,470,1139,29,3372,2183,7193,26,133
1770,1965,16,2274,3973,9998,2773,1405,25,2592,3351,10146,26,134
2436,1944,25,2625,5096,12126,3657,1537,33,2703,4019,11949,26,135
2484,2423,22,2398,4933,12260,3382,1706,23,2783,4119,12013,26,136
2264,2956,28,2655,4914,12817,3262,1866,40,3107,4366,12641,26,137
1355,2747,244,2635,4053,11034,2286,1984,95,3026,3579,10970,26,138
323,2052,236,3081,3017,8709,494,1734,108,3793,2765,8894,26,139
403,1487,13,3484,2797,8184,519,1070,29,4280,2247,8145,26,140
1950,1798,12,2234,4064,10058,2952,1298,17,2341,3176,9784,26,141
2502,2310,16,2522,5165,12515,3712,1768,12,2863,4061,12416,26,142
2398,2554,26,2551,5035,12564,3418,1459,34,2888,4238,12037,26,143
2051,2477,17,2361,4390,11296,3024,1459,18,2611,3756,10868,26,144
1191,2239,203,2614,3848,10095,2120,1943,74,2939,3133,10209,26,145
361,2146,171,3017,2579,8274,534,1975,107,3113,2802,8531,26,146
291,1647,11,3851,2293,8093,527,1396,22,3601,2456,8002,26,147
314,959,7,2268,1518,5066,389,866,28,2011,1834,5128,26,148
2075,1753,9,2171,4576,10584,3297,1163,44,2663,3264,10431,26,149
2250,2154,5,2341,4686,11436,3455,1300,10,2806,3683,11254,26,150
2126,2499,10,2408,4765,11808,3275,1543,20,2701,3816,11355,26,151
1423,2570,224,2533,4005,10755,2419,2044,114,2706,3067,10350,26,152
361,2191,214,2945,2627,8338,538,1786,90,3348,2731,8493,26,153
281,1213,15,3517,2240,7266,515,950,20,3566,2110,7161,26,154
2034,1762,5,1873,4056,9730,2805,1447,13,2197,3202,9664,26,155
2557,2248,8,2164,4913,11890,3531,1719,6,2651,3954,11861,26,156
2714,2205,10,2430,4651,12010,3474,1575,12,2773,3887,11721,26,157
2447,2613,31,2409,5040,12540,3371,1960,39,2606,4257,12233,26,158
1537,3387,250,2654,4793,12621,2241,3079,213,2910,4073,12516,26,159
540,11210,607,3574,7518,23449,623,6820,290,9409,10468,27610,26,160
444,1982,12,4003,2789,9230,515,1856,26,3753,3165,9315,26,161
2011,1877,7,2133,3904,9932,2775,1222,22,2350,3265,9634,26,162
2667,2331,24,2356,4873,12251,3518,1707,31,2697,4114,12067,26,163
2693,2627,14,2478,4895,12707,3353,2056,28,2767,4146,12350,26,164
2506,2664,21,2438,4542,12171,3228,1725,18,2758,4275,12004,26,165
1578,2414,240,2675,3964,10871,2273,2445,126,2803,3385,11032,26,166
407,2103,192,3320,2701,8723,504,2180,121,3354,2768,8927,26,167
329,1239,10,3887,2109,7574,517,1055,29,3551,2248,7400,26,168
1949,1718,32,2092,3654,9445,2614,1334,26,2292,3258,9524,26,169
2485,2335,18,2412,4698,11948,3291,1720,43,2654,3942,11650,26,170
835,1954,14,3140,3074,9017,1235,1536,13,2892,2997,8673,26,171
2227,2559,15,2491,4186,11478,2990,1596,15,2622,4133,11356,26,172
1417,2681,280,2568,3336,10282,2041,2123,99,2651,3447,10361,26,173
357,2226,229,2813,2468,8093,518,2537,184,2810,2355,8404,26,174
372,1139,10,3274,1932,6727,509,1039,13,3121,1936,6618,26,175
1994,1751,12,1974,3593,9324,2645,1121,17,2140,3290,9213,26,176
2563,2238,16,2407,4440,11664,3323,1504,23,2586,4036,11472,26,177
2588,2357,12,2321,4464,11742,3172,1517,14,2673,4133,11509,26,178
2388,2679,25,2533,4471,12096,3062,1817,27,2617,4104,11627,26,179
1585,2608,250,2488,3710,10641,2111,2127,86,2680,3572,10576,26,180
429,2184,210,3063,2705,8591,522,1950,136,3156,2869,8633,26,181
422,1030,24,3344,1805,6625,510,1028,37,2834,1918,6327,26,182
1808,1669,9,2017,3616,9119,2497,1312,20,2297,3141,9267,26,183
2059,1993,41,2193,4467,10753,2967,1530,36,2681,3560,10774,26,184
1661,2109,19,2779,4307,10875,2505,1866,22,2922,3305,10620,26,185
439,3293,40,3072,2315,9159,412,2819,37,2790,2488,8546,26,186
835,2054,193,2986,3039,9107,1326,1897,116,2749,2958,9046,26,187
385,1907,232,2981,2326,7831,535,1825,122,2762,2506,7750,26,188
322,1059,10,3241,1940,6572,560,1031,12,3106,2011,6720,26,189
1840,1618,17,1936,3575,8986,2657,1325,18,2157,3015,9172,26,190
2509,2341,25,2336,4510,11721,3377,1637,27,2559,4025,11625,26,191
2460,2329,12,2611,4482,11894,3170,1603,19,2633,4249,11674,26,192
2362,2681,32,2326,4406,11807,2943,1710,36,2806,4198,11693,26,193
1488,2439,233,2324,3312,9796,2132,2121,104,2466,3237,10060,26,194
419,2131,250,2974,2792,8566,504,2249,121,3070,2939,8883,26,195
389,1329,50,3509,2118,7395,510,1119,41,3580,2109,7359,26,196
1813,1565,16,1990,3552,8936,2669,1151,19,2097,2931,8867,26,197
2369,1979,22,2109,4411,10890,3258,1429,22,2293,3773,10775,26,198
2383,1990,17,2314,4395,11099,3204,1276,14,2476,3918,10888,26,199
2184,2620,12,2387,4337,11540,3028,1668,13,2606,3973,11288,26,200
1462,2495,214,2432,3964,10567,2046,2441,267,2502,3324,10580,26,201
350,1959,235,3089,2941,8574,475,2311,138,3221,2703,8848,26,202
357,1214,18,3823,2270,7682,535,986,23,3607,2059,7210,26,203
1809,1517,18,1900,3542,8786,2454,1397,21,2032,2877,8781,26,204
2498,2090,21,2167,4634,11410,3210,1699,27,2531,3788,11255,26,205
2225,2104,19,2470,4677,11495,3059,1631,19,2737,3818,11264,26,206
2251,2350,29,2486,4271,11387,2812,1683,31,2595,4001,11122,26,207
1449,2403,181,2605,3555,10193,1945,2151,171,2522,3419,10208,26,208
359,2207,221,3052,2778,8617,451,2140,221,3045,2886,8743,26,209
379,1195,37,3552,2180,7343,577,1115,46,3440,2174,7352,26,210
1779,1498,16,2117,3717,9127,2526,1325,37,2385,2926,9199,26,211
2306,1974,16,2229,4494,11019,3217,1241,15,2560,3769,10802,26,212
2300,2139,14,2222,4207,10882,2551,1363,13,2627,3781,10335,26,213
2101,2580,33,2246,4071,11031,2893,1719,39,2452,3943,11046,26,214
1253,2187,187,2457,3419,9503,1961,2251,118,2439,3149,9918,26,215
443,1476,180,3134,2398,7631,471,1597,126,2882,2698,7774,26,216
374,1052,19,3509,2030,6984,518,956,16,3291,2124,6905,26,217
1595,1504,22,2101,3540,8762,2474,1203,26,2043,3039,8785,26,218
2073,1817,12,2167,4298,10367,2992,1476,11,2394,3476,10349,26,219
2011,1928,18,2277,4119,10353,2760,1314,27,2491,3600,10192,26,220
1802,1782,11,2179,3666,9440,2452,1288,12,2207,3320,9279,26,221
945,1888,202,2054,2664,7753,1577,1711,173,1837,2508,7806,26,222
383,1947,221,2797,2420,7768,481,1683,91,2772,2585,7612,26,223
363,1101,8,3429,1992,6893,502,866,20,3219,2033,6640,26,224
1457,1485,7,1921,3221,8091,2214,1085,10,1944,2686,7939,26,225
1920,1898,12,2044,4030,9904,2776,1258,17,2375,3310,9736,26,226
1923,2066,22,2096,4024,10131,2727,1389,21,2433,3341,9911,26,227
1732,2243,10,2226,3802,10013,2500,1492,25,2377,3463,9857,26,228
1150,2220,203,2179,3083,8835,1854,1870,102,2223,2808,8857,26,229
391,1864,244,2825,2326,7650,447,1738,126,2762,2473,7546,26,230
239,973,7,3172,1893,6284,435,844,12,3088,1910,6289,26,231
1455,1455,18,1831,3218,7977,2249,1023,16,1968,2671,7927,26,232
1878,1845,33,2079,4297,10132,2895,1450,40,2377,3389,10151,26,233
1874,2025,18,2152,4135,10204,2790,1512,13,2305,3384,10004,26,234
1683,2257,32,2248,3755,9975,2576,1572,39,2341,3252,9780,26,235
1148,2321,264,2271,3251,9255,1806,1960,80,2445,3007,9298,26,236
376,2065,216,2974,2807,8438,557,1941,126,3005,2862,8491,26,237
300,1044,15,3558,2068,6985,560,878,32,3405,1967,6842,26,238
1628,1429,24,1875,3553,8509,2493,1248,21,1893,2720,8375,26,239
2214,1787,33,2334,4636,11004,3398,1559,36,2501,3337,10831,26,240
2052,1965,13,2074,4416,10520,3021,1473,20,2394,3415,10323,26,241
1782,1974,32,2128,4283,10199,2992,1356,29,2500,3318,10195,26,242
1219,2014,226,2352,3687,9498,2074,1778,116,2554,2806,9328,26,243
319,1839,215,2827,2614,7814,555,1762,93,2849,2455,7714,26,244
355,1482,23,3883,2434,8177,569,1492,49,3778,2218,8106,26,245
296,1064,5,2127,1824,5316,382,964,14,2204,1881,5445,26,246
2065,1684,3,1972,4440,10164,3482,1174,7,2279,3226,10168,26,247
2221,2015,20,2098,4652,11006,3525,1292,21,2592,3542,10972,26,248
2151,2571,23,2130,4710,11585,3350,1675,32,2584,3762,11403,26,249
1437,2469,262,2258,3708,10134,2418,1908,91,2514,3220,10151,26,250
438,2243,267,3169,2704,8821,489,2031,173,3259,2882,8834,26,251
343,1228,7,3594,2399,7571,569,902,8,3838,2177,7494,26,252
2025,1670,15,1904,4036,9650,2936,1279,26,2139,3104,9484,26,253
2697,2510,8,2197,4961,12373,3878,2020,17,2488,3800,12203,26,254
2575,2367,14,2379,5212,12547,3574,1794,23,2773,4004,12168,26,255
2480,2637,19,2337,4917,12390,3481,2037,20,2707,3896,12141,26,256
1571,2836,254,2535,4205,11401,2518,2338,133,2684,3666,11339,26,257
429,2111,292,3355,2947,9134,547,2331,193,3472,3018,9561,26,258
341,1204,10,4021,2351,7927,601,948,23,3771,2331,7674,26,259
2081,1691,17,2022,4030,9841,2942,1242,13,2289,3307,9793,26,260
2783,2133,6,2306,5085,12313,3876,1627,13,2634,4113,12263,26,261
2846,2398,15,2247,4837,12343,3376,1788,20,2863,4089,12136,26,262
2591,2820,18,2413,5082,12924,3497,1988,16,2941,4226,12668,26,263
1625,2653,262,2631,4172,11343,2539,2018,110,2808,3540,11015,26,264
418,2174,239,3270,2833,8934,572,2384,130,3246,3071,9403,26,265
353,1147,14,3453,2248,7215,495,1044,29,3681,2192,7441,26,266
2001,1621,7,2013,4102,9744,2999,1346,6,2269,3162,9782,26,267
2631,1948,23,2250,5137,11989,3655,1575,31,2578,4252,12091,26,268
2666,2168,8,2368,4959,12169,3486,1671,15,2718,4017,11907,26,269
2425,2462,9,2374,4786,12056,3182,1759,21,2712,4076,11750,26,270
1518,2670,227,2545,3965,10925,2399,2260,157,2639,3567,11022,26,271
490,3507,345,3308,2923,10573,596,3123,164,3251,3753,10887,26,272
324,1069,6,3439,2088,6926,565,939,27,3210,2128,6869,26,273
1947,1573,8,2003,4199,9730,2981,1212,14,2363,3039,9609,26,274
2559,2107,14,2159,4899,11738,3821,1543,17,2548,3643,11572,26,275
2525,2054,13,2368,4808,11768,3457,1551,10,2757,3807,11582,26,276
2189,2522,11,2376,4662,11760,3232,1771,17,2656,3888,11564,26,277
1467,2852,245,2502,4118,11184,2315,2285,120,2718,3906,11344,26,278
483,2431,278,3240,2772,9204,534,2641,133,3375,3297,9980,26,279
389,1195,11,3770,2388,7753,525,1119,24,3888,2433,7989,26,280
2026,1689,34,2104,4216,10069,3021,1408,25,2430,3281,10165,26,281
2623,2082,9,2407,4981,12102,3741,1483,10,2815,3892,11941,26,282
2706,2413,28,2481,4987,12615,3653,1651,33,2862,4321,12520,26,283
2317,2667,18,2608,4564,12174,3037,1967,26,2899,4201,12130,26,284
1558,2572,241,2799,4174,11344,2103,2308,127,3083,3804,11425,26,285
572,2315,248,3560,2801,9496,508,2316,114,3285,3438,9661,26,286
455,1382,20,4079,2553,8489,542,1435,26,4053,2656,8712,26,287
1081,1423,5,2776,2758,8043,1420,1314,14,2497,2869,8114,26,288
2569,2192,8,2544,5291,12604,3754,1850,9,2894,3990,12497,26,289
2778,2473,19,2507,5145,12922,3528,1660,30,2972,4304,12494,26,290
2447,2751,7,2639,5026,12870,3467,2089,13,2903,4299,12771,26,291
1550,2979,331,2795,4201,11856,2473,2628,148,2921,4074,12244,26,292
447,2504,327,3452,3047,9777,569,2281,180,3433,3280,9743,26,293
381,1337,4,3940,2608,8270,555,1465,14,3796,2381,8211,26,294
2014,1719,19,2209,4337,10298,3072,1446,22,2344,3430,10314,26,295
2649,2228,18,2372,5273,12540,3848,1476,20,2718,3985,12047,26,296
2791,2569,15,2618,5229,13222,3690,1780,22,2956,4342,12790,26,297
2506,2795,11,2584,5254,13150,3390,2217,10,2876,4365,12858,26,298
1652,2865,305,2725,4333,11880,2555,2572,128,2948,4063,12266,26,299
638,3581,432,3631,3369,11651,775,2625,157,4493,4709,12759,26,300
763,1451,8,4007,2567,8796,886,1337,18,4026,2534,8801,26,301
2698,1768,11,2341,4559,11377,3003,1294,18,2702,3673,10690,26,302
2566,3696,22,2430,5586,14300,3860,2669,18,2866,4619,14032,26,303
2619,2563,14,2659,5297,13152,3678,1736,20,2956,4363,12753,26,304
2291,2573,56,2474,4944,12338,3335,2528,66,2801,3998,12728,26,305
1484,2661,288,2454,4179,11066,2252,2199,166,2993,3474,11084,26,306
396,2854,307,2855,3207,9619,622,2210,152,3452,3152,9588,26,307
386,1168,14,3607,2411,7586,745,934,17,3705,2139,7540,26,308
2021,1597,15,2061,3829,9523,2749,1227,15,2222,3070,9283,26,309
2056,1930,41,2335,4039,10401,2955,1405,84,2640,3364,10448,26,310
1977,1923,8,2122,4524,10554,3062,1316,12,2627,3356,10373,26,311
2206,2391,31,2324,4643,11595,3366,1383,39,2680,3962,11430,26,312
1508,2514,260,2626,4453,11361,2484,2087,142,2972,3803,11488,26,313
410,2117,237,3496,2838,9098,565,1770,152,3328,3254,9069,26,314
313,1041,29,3681,2275,7339,517,882,44,3502,2540,7485,26,315
953,1423,12,2354,3070,7812,1738,1049,16,2561,2461,7825,26,316
2665,2072,12,2199,5111,12059,3941,1346,16,2600,4197,12100,26,317
2799,2570,11,2426,5208,13014,3801,1829,19,2790,4422,12861,26,318
2505,2515,14,2455,5032,12521,3599,1650,20,2840,4494,12603,26,319
1635,2751,267,2650,4418,11721,2571,2160,118,2938,3962,11749,26,320
353,2056,250,3532,3023,9214,521,1790,99,3346,3481,9237,26,321
343,1077,15,3619,2452,7506,525,903,20,3599,2176,7223,26,322
2156,1788,9,2107,4139,10199,3004,1299,16,2380,3413,10112,26,323
2691,2287,1,2384,5269,12632,3649,1568,4,2903,4014,12138,26,324
2650,2180,9,2327,5273,12439,3756,1499,20,2776,4068,12119,26,325
2465,2608,45,2570,5125,12813,3438,1822,47,2770,4285,12362,26,326
1549,2474,213,2507,4219,10962,2461,1910,134,2730,3877,11112,26,327
369,2373,241,3998,4764,11745,534,1963,138,4752,4753,12140,26,328
307,1396,10,3706,3474,8893,434,932,27,4352,2956,8701,26,329
1590,1522,15,2395,4473,9995,2734,1024,19,2496,3143,9416,26,330
1570,1762,8,2445,4511,10296,2592,1066,10,2723,3221,9612,26,331
931,1426,15,2766,3484,8622,1635,1042,17,2730,2556,7980,26,332
234,397,2,1224,821,2678,201,546,8,865,737,2357,26,333
342,1311,74,2565,2876,7168,681,1047,68,3152,2884,7832,26,334
207,1424,110,2793,3078,7612,406,1147,63,3450,3223,8289,26,335
196,879,8,2792,2381,6256,403,1015,9,3212,2462,7101,26,336
1696,1519,12,1757,3908,8892,2795,1132,14,2269,3120,9330,26,337
2500,2006,16,2232,5426,12180,3788,1603,21,2889,3995,12296,26,338
2596,2383,5,2537,5291,12812,3717,1564,11,3103,4369,12764,26,339
2278,2749,10,2473,5400,12910,3351,2016,10,2937,4816,13130,26,340
1575,2914,229,2703,4596,12017,2435,2239,98,2952,4454,12178,26,341
382,2663,269,4591,5615,13520,538,2534,166,5478,5099,13815,26,342
365,1515,17,4659,4491,11047,420,1520,27,5319,4052,11338,26,343
2196,2051,4,2158,4305,10714,2996,1653,10,2325,3765,10749,26,344
2916,2822,4,2695,5850,14287,3819,2010,15,3047,4909,13800,26,345
2995,2663,10,2462,5045,13175,3555,1918,21,2806,4813,13113,26,346
2848,3296,53,2943,5774,14914,3457,2490,51,3405,5556,14959,26,347
1752,3462,308,3189,5171,13882,2501,2622,174,3557,5123,13977,26,348
429,3038,322,5079,5289,14157,562,2772,153,5629,5565,14681,26,349
288,1088,10,4021,3017,8424,464,1020,16,4094,2531,8125,26,350
1764,1870,14,2179,4252,10079,2785,1260,22,2460,3481,10008,26,351
2225,2435,14,2410,5364,12448,3526,1678,27,2863,4235,12329,26,352
2220,2229,8,2457,4854,11768,3264,1400,19,2920,3910,11513,26,353
1827,2371,16,2462,4960,11636,2905,1743,26,2884,3945,11503,26,354
1287,2121,119,2402,3908,9837,2068,1578,79,2576,3232,9533,26,355
306,1467,112,3013,3021,7919,404,1171,64,3098,2940,7677,26,356
249,984,13,2562,2289,6097,344,682,17,2505,2097,5645,26,357
636,1214,17,2212,2990,7069,1358,678,16,2213,2224,6489,26,358
381,565,13,1546,1278,3783,842,423,15,1291,896,3467,26,359
142,269,4,572,484,1471,144,344,14,545,452,1499,26,360
312,976,18,1437,1864,4607,882,728,34,1660,1616,4920,26,361
405,1189,86,2035,2175,5890,943,1200,43,2000,2148,6334,26,362
189,1048,87,1964,1620,4908,326,1141,55,1850,1701,5073,26,363
207,778,19,2142,1695,4841,304,663,33,2231,1670,4901,26,364
756,1303,11,2086,2617,6773,1305,1050,19,2237,2377,6988,26,365
628,1320,1030,2281,2046,7305,1130,1598,536,2223,2028,7515,26,366
92,68,1,299,179,639,33,149,2,266,318,768,27,1
1194,119,0,480,383,2176,203,413,13,366,1381,2376,27,2
1370,134,2,530,547,2583,196,510,7,372,1538,2623,27,3
1285,116,1,536,380,2318,196,351,8,412,1437,2404,27,4
776,144,4,460,602,1986,154,493,35,303,1035,2020,27,5
131,117,2,390,294,934,62,307,35,256,308,968,27,6
131,88,2,740,249,1210,38,315,10,354,619,1336,27,7
1184,98,0,457,421,2160,198,374,7,331,1333,2243,27,8
1496,59,7,388,276,2226,176,288,9,418,1388,2279,27,9
1593,120,0,512,430,2655,200,451,10,383,1703,2747,27,10
1440,127,5,530,590,2692,206,565,12,352,1561,2696,27,11
744,111,5,480,398,1738,194,239,16,297,611,1357,27,12
128,98,3,643,264,1136,47,248,26,274,450,1045,27,13
92,64,3,366,155,680,32,157,4,211,293,697,27,14
189,124,30,305,208,856,70,218,30,187,341,846,27,15
464,79,2,315,321,1181,133,327,7,209,480,1156,27,16
1188,103,10,546,331,2178,195,394,12,303,1309,2213,27,17
1498,115,4,539,581,2737,196,644,13,376,1476,2705,27,18
506,108,16,491,305,1426,115,305,39,272,651,1382,27,19
202,154,8,596,366,1326,76,383,55,399,486,1399,27,20
101,60,0,477,210,848,36,260,7,267,367,937,27,21
1167,92,4,525,332,2120,190,353,11,337,1312,2203,27,22
1663,111,6,500,402,2682,194,459,7,329,1696,2685,27,23
1614,109,9,500,457,2689,206,519,24,351,1673,2773,27,24
1414,123,7,525,470,2539,189,516,17,353,1466,2541,27,25
936,188,2,541,569,2236,207,472,37,401,1164,2281,27,26
215,149,19,945,453,1781,77,422,56,503,723,1781,27,27
119,84,3,597,239,1042,45,245,3,365,496,1154,27,28
1264,101,3,501,327,2196,192,354,11,388,1314,2259,27,29
1725,115,5,448,415,2708,198,537,5,337,1692,2769,27,30
1660,130,0,510,456,2756,197,515,9,355,1708,2784,27,31
1565,109,2,498,441,2615,218,506,4,374,1562,2664,27,32
876,167,7,502,511,2063,177,435,42,391,1043,2088,27,33
181,162,11,810,440,1604,68,386,44,446,675,1619,27,34
152,91,2,588,266,1099,51,276,4,364,531,1226,27,35
1287,99,3,420,374,2183,212,352,9,300,1336,2209,27,36
1691,107,0,493,509,2800,184,589,9,365,1695,2842,27,37
1679,150,2,561,449,2841,218,558,6,411,1723,2916,27,38
1586,142,3,525,454,2710,189,504,7,384,1606,2690,27,39
871,176,6,508,495,2056,177,390,50,395,1091,2103,27,40
188,144,3,827,503,1665,70,493,40,535,634,1772,27,41
132,112,17,728,244,1233,42,233,21,316,674,1286,27,42
1238,103,6,462,318,2127,165,372,15,340,1327,2219,27,43
1511,111,18,479,491,2610,164,603,15,321,1557,2660,27,44
1631,93,14,538,417,2693,218,584,22,370,1584,2778,27,45
1519,128,1,575,513,2736,184,496,10,377,1682,2749,27,46
893,167,8,554,521,2143,177,474,50,410,1047,2158,27,47
180,172,6,743,302,1403,59,327,51,389,604,1430,27,48
146,119,2,653,263,1183,39,262,16,410,544,1271,27,49
393,91,1,609,312,1406,135,275,6,407,724,1547,27,50
1688,112,2,550,495,2847,202,566,12,360,1718,2858,27,51
1749,121,2,513,439,2824,218,567,8,397,1777,2967,27,52
1553,104,15,539,495,2706,210,566,26,367,1583,2752,27,53
915,152,5,481,462,2015,175,414,37,370,1060,2056,27,54
202,181,7,830,423,1643,56,413,66,459,636,1630,27,55
148,85,4,571,291,1099,57,307,9,366,498,1237,27,56
1323,100,4,466,451,2344,197,482,9,356,1344,2388,27,57
1674,121,6,493,442,2736,201,567,19,384,1723,2894,27,58
1624,97,9,488,386,2604,173,520,17,375,1672,2757,27,59
1576,129,0,536,440,2681,178,589,8,369,1550,2694,27,60
912,149,8,519,601,2189,191,549,51,409,1051,2251,27,61
163,189,5,708,438,1503,55,473,50,378,643,1599,27,62
124,114,1,841,242,1322,51,296,6,385,741,1479,27,63
1263,103,1,545,381,2293,202,444,10,350,1374,2380,27,64
1649,96,3,623,421,2792,197,540,11,393,1725,2866,27,65
1727,128,3,537,463,2858,200,612,10,364,1698,2884,27,66
1616,142,0,582,524,2864,200,592,14,400,1664,2870,27,67
1016,183,6,637,615,2457,198,594,44,432,1180,2448,27,68
256,153,8,675,432,1524,62,561,55,406,528,1612,27,69
153,113,6,724,247,1243,45,303,12,376,633,1369,27,70
1269,113,2,579,408,2371,202,516,7,330,1494,2549,27,71
1736,143,14,648,497,3038,190,674,17,392,1844,3117,27,72
1751,139,7,703,614,3214,214,733,16,437,1876,3276,27,73
1609,181,12,812,696,3310,211,726,74,471,1814,3296,27,74
985,208,8,707,685,2593,198,582,144,471,1233,2628,27,75
601,276,12,1419,656,2964,86,851,93,848,1197,3075,27,76
206,106,3,997,444,1756,58,479,10,526,846,1919,27,77
1277,103,5,630,465,2480,217,496,11,396,1483,2603,27,78
1761,118,3,614,492,2988,189,614,9,389,1861,3062,27,79
1805,146,8,705,711,3375,209,798,18,504,1893,3422,27,80
1699,221,0,688,594,3202,209,777,13,437,1741,3177,27,81
1004,200,3,831,912,2950,197,792,86,625,1306,3006,27,82
175,198,3,941,545,1862,58,613,50,403,841,1965,27,83
305,138,2,1647,447,2539,71,508,7,597,1473,2656,27,84
1155,144,10,1003,584,2896,174,542,82,517,1594,2909,27,85
1637,130,4,935,672,3378,237,821,18,513,1844,3433,27,86
1479,173,0,763,471,2886,200,603,8,465,1654,2930,27,87
1329,157,2,870,471,2829,182,613,13,434,1612,2854,27,88
843,219,6,1070,591,2729,162,623,63,642,1368,2858,27,89
320,184,10,1961,666,3141,76,827,73,797,1490,3263,27,90
208,140,2,871,356,1577,60,497,7,401,888,1853,27,91
1213,162,4,1033,487,2899,203,762,12,427,1529,2933,27,92
1754,107,0,677,404,2942,201,578,7,386,1808,2980,27,93
1648,131,27,610,493,2909,209,614,35,357,1738,2953,27,94
1635,176,0,745,703,3259,214,858,14,474,1744,3304,27,95
1051,215,8,741,792,2807,218,722,59,470,1291,2760,27,96
352,205,4,1263,554,2378,86,756,61,600,869,2372,27,97
546,115,6,1008,420,2095,75,539,12,809,716,2151,27,98
1280,131,7,599,378,2395,227,423,36,416,1361,2463,27,99
1729,154,9,577,526,2995,261,598,60,415,1818,3152,27,100
1714,118,4,733,496,3065,252,636,13,470,1766,3137,27,101
1646,119,3,590,504,2862,234,651,12,393,1544,2834,27,102
936,172,9,603,611,2331,209,573,52,455,1199,2488,27,103
332,217,5,1170,764,2488,83,836,69,595,993,2576,27,104
212,148,1,928,328,1617,57,418,12,513,749,1749,27,105
1320,104,1,626,520,2571,240,596,11,420,1380,2647,27,106
1785,155,28,627,513,3108,255,633,36,418,1875,3217,27,107
1834,183,50,608,517,3192,363,911,65,427,2783,4549,27,108
1715,182,10,621,600,3128,230,708,24,433,1756,3151,27,109
1038,179,6,590,716,2529,199,690,74,427,1180,2570,27,110
280,227,8,1634,649,2798,91,1060,76,483,1093,2803,27,111
157,114,2,784,301,1358,52,307,7,394,695,1455,27,112
1293,131,8,535,394,2361,223,428,13,376,1413,2453,27,113
1741,160,0,610,657,3168,233,731,6,407,1811,3188,27,114
1709,136,3,652,648,3148,236,762,14,415,1813,3240,27,115
1751,148,5,705,659,3268,270,713,16,467,1764,3230,27,116
966,225,13,614,826,2644,207,720,71,460,1136,2594,27,117
335,223,14,867,551,1990,98,680,153,515,643,2089,27,118
196,167,4,771,465,1603,64,534,46,424,713,1781,27,119
1288,140,2,530,379,2339,210,483,10,447,1331,2481,27,120
1765,177,2,598,494,3036,262,642,10,494,1799,3207,27,121
1747,166,4,572,570,3059,243,681,21,445,1735,3125,27,122
1680,153,14,629,524,3000,252,602,24,443,1605,2926,27,123
949,193,3,681,687,2513,221,653,52,476,1148,2550,27,124
240,176,15,833,537,1801,83,620,81,396,705,1885,27,125
140,113,42,719,269,1283,47,399,45,376,567,1434,27,126
1372,145,24,522,389,2452,224,460,29,375,1419,2507,27,127
1803,143,19,611,656,3232,239,770,29,446,1799,3283,27,128
1718,147,11,621,689,3186,251,847,28,389,1742,3257,27,129
1597,149,17,623,590,2976,276,596,24,441,1644,2981,27,130
936,185,18,549,524,2212,200,506,69,457,1076,2308,27,131
331,174,12,1001,377,1895,98,442,61,536,875,2012,27,132
182,119,4,663,287,1255,68,337,7,402,591,1405,27,133
1267,138,11,569,448,2433,238,511,19,363,1375,2506,27,134
1825,122,6,595,431,2979,277,553,15,398,1843,3086,27,135
1703,157,14,611,560,3045,258,653,28,401,1720,3060,27,136
1623,191,1,647,567,3029,245,723,8,419,1696,3091,27,137
1027,186,9,690,574,2486,229,524,40,521,1221,2535,27,138
233,175,9,798,435,1650,75,536,62,435,605,1713,27,139
256,147,7,785,301,1496,73,438,20,504,634,1669,27,140
1329,121,5,638,559,2652,238,585,18,422,1468,2731,27,141
1900,136,0,584,571,3191,216,697,8,437,1843,3201,27,142
1854,135,3,704,508,3204,215,718,12,478,1908,3331,27,143
1658,128,14,543,546,2889,224,531,24,416,1615,2810,27,144
876,187,8,629,763,2463,221,735,68,504,960,2488,27,145
212,188,4,1085,637,2126,82,904,79,466,654,2185,27,146
253,179,3,1084,360,1879,79,461,26,481,954,2001,27,147
169,118,8,656,236,1187,69,293,13,402,584,1361,27,148
1700,120,6,587,490,2903,238,548,15,429,1765,2995,27,149
1784,150,6,613,472,3025,233,555,12,430,1729,2959,27,150
1638,129,3,705,521,2996,227,649,9,450,1666,3001,27,151
998,229,8,655,591,2481,196,569,91,468,1133,2457,27,152
224,220,8,902,634,1988,95,695,73,512,645,2020,27,153
201,137,9,721,283,1351,72,342,21,437,653,1525,27,154
1390,126,0,547,507,2570,223,577,10,368,1476,2654,27,155
1932,152,2,603,613,3302,271,752,12,405,1923,3363,27,156
1872,148,2,672,499,3193,255,667,5,460,1891,3278,27,157
1750,202,2,705,718,3377,228,859,13,491,1710,3301,27,158
1095,251,4,696,1180,3226,214,1094,126,478,1311,3223,27,159
291,298,11,1700,946,3246,103,1462,121,513,1056,3255,27,160
217,148,7,1253,408,2033,63,573,22,433,1066,2157,27,161
1427,116,3,670,443,2659,220,502,8,438,1550,2718,27,162
1894,155,2,704,528,3283,244,658,11,414,1958,3285,27,163
1861,192,5,736,631,3425,252,839,25,426,1904,3446,27,164
1726,164,1,713,545,3149,226,705,21,444,1747,3143,27,165
1007,226,7,691,966,2897,203,884,75,539,1221,2922,27,166
215,238,4,1038,709,2204,105,967,50,447,643,2212,27,167
195,112,4,896,316,1523,64,378,10,402,805,1659,27,168
1309,138,6,610,401,2464,203,493,10,405,1479,2590,27,169
1729,157,3,637,686,3212,224,806,23,507,1808,3368,27,170
512,193,5,808,631,2149,139,694,10,472,869,2184,27,171
1602,221,6,779,548,3156,229,679,19,385,1722,3034,27,172
1030,278,5,599,528,2440,214,494,91,411,1201,2411,27,173
247,330,10,761,561,1909,97,747,118,426,616,2004,27,174
187,137,1,594,293,1212,65,339,25,376,578,1383,27,175
1300,127,0,618,400,2445,211,481,13,361,1480,2546,27,176
1826,158,0,645,462,3091,235,624,9,412,1909,3189,27,177
1802,157,2,645,502,3108,271,690,13,434,1811,3219,27,178
1646,176,5,716,561,3104,248,668,25,451,1752,3144,27,179
1000,237,13,702,654,2606,230,593,67,503,1184,2577,27,180
254,212,14,870,487,1837,98,616,67,415,714,1910,27,181
172,118,1,705,279,1275,69,342,13,377,587,1388,27,182
1231,126,0,719,660,2736,201,704,7,427,1530,2869,27,183
1611,172,1,708,525,3017,219,628,14,464,1738,3063,27,184
1241,196,4,718,804,2963,192,889,29,580,1342,3032,27,185
284,1281,16,1310,1163,4054,46,2191,49,745,808,3839,27,186
588,213,11,727,609,2148,165,670,49,432,906,2222,27,187
224,214,5,869,359,1671,89,608,54,403,713,1867,27,188
174,103,2,649,255,1183,49,295,8,360,587,1299,27,189
1239,135,2,599,398,2373,220,495,7,356,1378,2456,27,190
1632,161,15,623,457,2888,226,593,19,428,1752,3018,27,191
1621,147,5,622,496,2891,229,633,15,396,1710,2983,27,192
1534,173,4,654,502,2867,203,632,16,428,1629,2908,27,193
974,184,4,555,578,2295,217,572,67,403,1069,2328,27,194
211,246,10,966,914,2347,82,975,98,492,800,2447,27,195
204,135,1,641,289,1270,61,347,16,371,534,1329,27,196
1333,129,3,540,352,2357,226,415,14,356,1450,2461,27,197
1669,137,12,575,477,2870,229,627,20,369,1721,2966,27,198
1690,129,2,548,375,2744,198,513,6,370,1789,2876,27,199
1594,185,3,683,506,2971,192,665,14,388,1778,3037,27,200
957,266,6,690,867,2786,204,774,190,417,1179,2764,27,201
264,241,6,906,905,2322,77,949,99,483,659,2267,27,202
178,114,7,910,326,1535,60,338,15,421,758,1592,27,203
1235,131,3,563,512,2444,229,608,21,323,1444,2625,27,204
1777,143,1,672,586,3179,220,715,13,418,1815,3181,27,205
1674,163,1,733,667,3238,229,795,14,436,1825,3299,27,206
1545,165,3,727,489,2929,232,625,22,426,1754,3059,27,207
991,226,12,669,596,2494,200,543,115,467,1181,2506,27,208
280,261,6,984,582,2113,74,635,151,553,714,2127,27,209
193,114,5,723,327,1362,67,414,27,406,579,1493,27,210
1265,108,12,595,646,2626,179,612,155,379,1410,2735,27,211
1717,164,2,674,461,3018,222,695,10,400,1722,3049,27,212
1692,142,3,674,465,2976,210,580,6,408,1756,2960,27,213
1482,164,0,625,522,2793,215,585,16,382,1610,2808,27,214
1053,228,10,729,812,2832,212,905,91,628,1159,2995,27,215
327,160,9,1018,391,1905,62,615,73,438,767,1955,27,216
222,117,4,890,243,1476,78,326,10,413,795,1622,27,217
1196,120,4,552,432,2304,210,528,12,321,1266,2337,27,218
1635,133,1,634,523,2926,200,642,9,424,1746,3021,27,219
1564,127,2,691,492,2876,207,600,23,405,1650,2885,27,220
1306,118,4,580,445,2453,181,455,9,351,1448,2444,27,221
752,221,10,528,612,2123,169,572,111,328,912,2092,27,222
213,219,9,812,699,1952,75,681,50,422,735,1963,27,223
188,122,0,877,333,1520,67,381,8,419,765,1640,27,224
1128,114,3,565,405,2215,223,417,8,347,1293,2288,27,225
1568,138,1,619,463,2789,217,569,6,398,1703,2893,27,226
1513,156,2,664,488,2823,196,557,20,429,1662,2864,27,227
1347,159,12,602,518,2638,191,547,56,412,1439,2645,27,228
851,216,7,663,502,2239,207,515,52,447,1039,2260,27,229
210,205,11,799,476,1701,85,502,104,459,672,1822,27,230
146,98,13,686,278,1221,48,323,16,359,622,1368,27,231
1126,104,4,491,370,2095,192,455,12,355,1221,2235,27,232
1603,183,2,600,576,2964,211,638,14,435,1752,3050,27,233
1523,127,2,626,563,2841,239,607,9,405,1706,2966,27,234
1341,149,2,700,491,2683,232,576,15,409,1616,2848,27,235
883,201,3,630,594,2311,215,602,58,456,1152,2483,27,236
277,224,4,1017,554,2076,79,751,81,483,805,2199,27,237
177,106,4,713,286,1286,63,385,32,322,578,1380,27,238
1270,128,7,517,680,2602,211,703,15,392,1329,2650,27,239
1724,135,1,549,672,3081,216,762,10,414,1796,3198,27,240
1660,138,1,552,638,2989,237,678,5,354,1663,2937,27,241
1457,140,1,558,522,2678,227,556,19,378,1549,2729,27,242
856,166,7,667,683,2379,196,572,90,542,982,2382,27,243
255,159,7,1038,467,1926,86,661,56,473,690,1966,27,244
168,164,0,962,327,1621,63,400,10,413,841,1727,27,245
174,97,2,586,303,1162,63,320,9,331,636,1359,27,246
1697,150,3,545,442,2837,250,478,11,333,1795,2867,27,247
1769,163,6,563,502,3003,244,559,6,385,1880,3074,27,248
1686,155,7,622,516,2986,227,578,21,427,1783,3036,27,249
1026,174,7,551,555,2313,227,544,46,359,1194,2370,27,250
269,191,5,905,812,2182,100,715,244,505,753,2317,27,251
167,115,6,706,303,1297,56,329,15,404,587,1391,27,252
1404,119,3,589,451,2566,215,489,13,366,1516,2599,27,253
1864,156,6,520,629,3175,220,694,8,345,1927,3194,27,254
1814,165,4,570,587,3140,232,736,18,374,1845,3205,27,255
1763,164,0,610,589,3126,252,727,6,423,1744,3152,27,256
1054,246,6,618,825,2749,221,742,68,402,1258,2691,27,257
268,261,8,1050,680,2267,107,817,103,553,749,2329,27,258
179,108,0,1108,306,1701,62,381,12,423,1019,1897,27,259
1411,113,1,563,441,2529,234,513,8,370,1495,2620,27,260
1868,145,5,544,507,3069,262,600,15,411,1918,3206,27,261
1789,137,5,577,520,3028,247,625,17,363,1846,3098,27,262
1749,159,2,643,646,3199,228,681,15,433,1816,3173,27,263
1134,241,15,623,618,2631,233,587,64,465,1321,2670,27,264
246,224,14,1069,550,2103,81,723,114,546,749,2213,27,265
161,134,2,752,329,1378,66,419,6,376,690,1557,27,266
1383,112,3,540,445,2483,239,417,16,402,1499,2573,27,267
1839,162,2,585,608,3196,249,685,19,439,1848,3240,27,268
1777,160,2,601,729,3269,248,847,19,385,1878,3377,27,269
1657,199,2,630,625,3113,230,672,24,443,1785,3154,27,270
1036,226,6,552,782,2602,238,726,61,426,1184,2635,27,271
274,259,7,1248,812,2600,101,1063,88,566,925,2743,27,272
194,102,2,914,338,1550,74,439,7,408,810,1738,27,273
1360,116,8,609,410,2503,241,477,14,369,1518,2619,27,274
1742,137,3,542,447,2871,237,520,15,372,1772,2916,27,275
1781,168,11,594,543,3097,228,612,20,396,1902,3158,27,276
1550,162,8,725,557,3002,225,611,12,459,1748,3055,27,277
1037,202,21,629,596,2485,230,566,67,522,1161,2546,27,278
323,274,23,938,591,2149,133,690,86,526,807,2242,27,279
224,141,13,885,344,1607,81,404,37,464,779,1765,27,280
1407,125,10,601,489,2632,249,474,14,360,1539,2636,27,281
1894,141,11,590,568,3204,235,640,20,411,1970,3276,27,282
1859,147,8,660,572,3246,286,616,29,446,1859,3236,27,283
1639,203,8,735,624,3209,236,759,11,508,1685,3199,27,284
970,231,27,761,633,2622,233,590,71,546,1226,2666,27,285
507,248,22,1119,666,2562,120,916,85,627,900,2648,27,286
406,164,19,882,494,1965,88,595,55,643,713,2094,27,287
630,128,2,714,403,1877,166,375,11,451,948,1951,27,288
1836,171,2,632,633,3274,260,725,9,397,1951,3342,27,289
1843,127,5,667,552,3194,264,649,11,434,1923,3281,27,290
1642,174,2,676,756,3250,235,796,16,422,1845,3314,27,291
1047,251,7,782,626,2713,213,672,61,515,1379,2840,27,292
311,246,5,975,682,2219,82,803,94,536,860,2375,27,293
206,102,4,836,412,1560,66,604,15,449,612,1746,27,294
1361,137,2,567,548,2615,239,583,10,357,1561,2750,27,295
1872,139,4,609,577,3201,248,653,15,390,1988,3294,27,296
1844,170,2,658,674,3348,250,772,20,434,1920,3396,27,297
1700,166,3,703,614,3186,246,712,9,471,1789,3227,27,298
1106,212,11,711,602,2642,198,585,71,530,1327,2711,27,299
304,274,9,901,615,2103,97,636,96,566,769,2164,27,300
866,128,2,1163,410,2569,105,553,11,1082,877,2628,27,301
1391,129,2,566,445,2533,207,451,21,389,1549,2617,27,302
1856,174,2,678,1213,3923,238,1336,18,449,1928,3969,27,303
1897,157,4,672,606,3336,251,666,16,444,1972,3349,27,304
1479,189,1,559,654,2882,218,591,22,483,1733,3047,27,305
996,246,6,647,615,2510,200,561,73,476,1231,2541,27,306
255,210,4,1035,763,2267,74,859,81,530,820,2364,27,307
170,115,1,619,303,1208,65,319,11,390,569,1354,27,308
1327,129,6,533,528,2523,240,455,12,394,1508,2609,27,309
1418,149,5,578,442,2592,221,378,18,513,1555,2685,27,310
1545,122,2,512,660,2841,245,612,16,413,1643,2929,27,311
1600,149,1,558,522,2830,227,557,4,406,1675,2869,27,312
1015,194,6,583,771,2569,248,635,71,487,1149,2590,27,313
226,216,13,913,443,1811,93,421,68,515,794,1891,27,314
204,116,0,903,296,1519,41,294,17,395,866,1613,27,315
666,116,5,669,341,1797,145,392,16,449,901,1903,27,316
1847,140,14,541,565,3107,234,611,31,399,1938,3213,27,317
1877,138,3,566,678,3262,242,706,31,401,1957,3337,27,318
1707,134,1,568,521,2931,240,621,15,405,1659,2940,27,319
1115,184,6,601,668,2574,247,576,77,519,1210,2629,27,320
221,220,10,1043,489,1983,73,476,78,443,956,2026,27,321
197,103,2,676,331,1309,68,366,17,393,615,1459,27,322
1386,107,2,493,467,2455,219,457,23,384,1513,2596,27,323
1912,127,5,652,545,3241,268,611,12,495,1950,3336,27,324
1828,122,2,607,531,3090,257,629,8,422,1838,3154,27,325
1671,135,2,563,656,3027,270,705,16,391,1705,3087,27,326
1016,156,9,480,615,2276,217,569,54,424,1161,2425,27,327
226,187,14,866,696,1989,71,702,65,464,747,2049,27,328
162,127,0,746,310,1345,66,301,8,393,706,1474,27,329
1225,111,1,607,420,2364,232,391,13,404,1391,2431,27,330
1362,173,1,650,594,2780,231,601,10,468,1578,2888,27,331
784,173,2,759,488,2206,193,418,14,657,995,2277,27,332
116,115,1,276,152,660,42,147,2,326,259,776,27,333
340,144,8,1082,457,2031,95,486,36,434,1059,2110,27,334
177,129,4,783,339,1432,64,400,46,365,678,1553,27,335
138,84,1,686,279,1188,41,321,3,352,635,1352,27,336
1270,89,9,505,382,2255,212,410,9,320,1388,2339,27,337
1743,122,14,567,668,3114,241,723,12,415,1892,3283,27,338
1751,115,6,615,505,2992,250,649,16,391,1734,3040,27,339
1624,120,7,583,636,2970,184,689,19,379,1666,2937,27,340
975,179,9,578,521,2262,204,507,54,400,1067,2232,27,341
183,176,13,866,741,1979,75,799,77,387,714,2052,27,342
196,113,3,735,418,1465,49,421,13,404,672,1559,27,343
1366,98,5,536,444,2449,216,553,13,365,1446,2593,27,344
1884,134,1,593,542,3154,209,666,9,439,1890,3213,27,345
1816,120,6,572,495,3009,247,611,19,365,1809,3051,27,346
1707,145,13,656,633,3154,220,761,35,414,1739,3169,27,347
1018,217,8,623,650,2516,199,602,83,387,1237,2508,27,348
483,235,13,1034,730,2495,74,848,104,666,812,2504,27,349
156,93,3,688,346,1286,64,403,14,446,546,1473,27,350
1308,96,4,579,445,2432,219,417,14,413,1403,2466,27,351
1782,160,2,630,658,3232,209,662,75,502,1857,3305,27,352
1640,118,2,694,626,3080,228,637,13,469,1799,3146,27,353
1493,171,1,624,652,2941,224,642,20,492,1570,2948,27,354
711,148,18,536,671,2084,191,560,56,360,889,2056,27,355
160,113,13,751,346,1383,63,377,29,384,572,1425,27,356
124,87,2,624,381,1218,56,398,5,247,518,1224,27,357
536,105,6,577,386,1610,155,351,11,364,728,1609,27,358
290,78,3,374,200,945,117,141,7,311,399,975,27,359
41,36,2,192,78,349,25,76,4,136,131,372,27,360
373,79,3,573,322,1350,120,283,13,314,661,1391,27,361
405,118,5,604,326,1458,128,350,22,345,723,1568,27,362
135,98,3,525,334,1095,38,323,27,240,420,1048,27,363
112,71,3,598,278,1062,41,273,50,301,496,1161,27,364
563,121,2,706,435,1827,134,381,8,427,920,1870,27,365
515,314,80,857,396,2162,120,275,301,467,936,2099,27,366
48,112,2,447,287,896,75,113,2,442,331,963,28,1
800,268,4,692,691,2455,413,279,3,712,1400,2807,28,2
1023,326,7,807,845,3008,513,353,9,773,1662,3310,28,3
995,403,1,744,901,3044,505,380,5,761,1715,3366,28,4
686,589,31,835,1078,3219,444,539,28,899,1559,3469,28,5
102,322,22,834,499,1779,160,343,32,726,520,1781,28,6
98,263,19,1243,703,2326,176,372,23,1143,725,2439,28,7
1033,377,14,795,954,3173,534,406,17,826,1645,3428,28,8
1247,312,19,729,689,2996,552,332,22,748,1568,3222,28,9
1315,498,36,903,1027,3779,593,487,34,881,1981,3976,28,10
1256,537,40,888,1159,3880,642,561,34,902,1985,4124,28,11
820,602,23,981,1068,3494,555,443,23,1084,1496,3601,28,12
179,536,27,1503,1000,3245,200,451,40,1328,1310,3329,28,13
107,279,23,1300,815,2524,175,301,43,1307,740,2566,28,14
190,290,4,948,517,1949,164,303,5,807,705,1984,28,15
409,377,6,628,693,2113,285,340,4,629,851,2109,28,16
1183,514,32,988,972,3689,495,603,35,827,1934,3894,28,17
1347,644,38,894,1093,4016,595,666,39,861,2090,4251,28,18
432,609,101,792,914,2848,288,643,47,799,1002,2779,28,19
158,503,36,1428,946,3071,166,500,39,1348,896,2949,28,20
103,296,15,1158,797,2369,196,273,11,1193,612,2285,28,21
1091,351,20,857,888,3207,539,469,28,779,1665,3480,28,22
1447,612,33,940,1157,4189,608,658,30,861,2173,4330,28,23
1379,592,21,925,1066,3983,624,615,31,911,2194,4375,28,24
1300,591,15,923,1072,3901,632,698,19,881,1806,4036,28,25
734,879,43,1081,1188,3925,542,686,53,1177,1687,4145,28,26
156,655,43,1457,1254,3565,225,565,39,1625,1084,3538,28,27
109,280,13,1364,843,2609,198,279,17,1239,777,2510,28,28
1101,383,33,914,975,3406,596,445,40,819,1646,3546,28,29
1481,613,14,895,1197,4200,652,654,16,840,2176,4338,28,30
1425,609,43,921,1101,4099,645,700,55,878,2067,4345,28,31
1332,694,26,967,1120,4139,664,625,26,950,2120,4385,28,32
850,737,39,941,1171,3738,564,654,39,989,1671,3917,28,33
146,662,30,1479,1240,3557,210,525,42,1661,1244,3682,28,34
118,394,4,1370,835,2721,213,297,4,1491,812,2817,28,35
1106,365,8,794,954,3227,575,436,9,744,1595,3359,28,36
1433,638,12,875,1128,4086,617,701,11,854,2110,4293,28,37
1484,634,9,946,1174,4247,659,666,11,963,2118,4417,28,38
1350,670,14,940,1102,4076,666,632,8,899,2033,4238,28,39
838,819,91,910,1181,3839,575,779,42,1014,1670,4080,28,40
163,590,31,1419,1261,3464,197,541,49,1625,1033,3445,28,41
136,344,7,1110,705,2302,196,277,13,1035,726,2247,28,42
1046,376,10,794,974,3200,560,402,9,778,1628,3377,28,43
1388,589,8,873,1145,4003,600,682,10,910,2055,4257,28,44
1393,634,7,993,1219,4246,759,602,9,1038,2142,4550,28,45
1256,556,5,648,853,3318,605,524,15,553,1532,3229,28,46
651,708,67,1082,1090,3598,476,610,41,1056,1509,3692,28,47
143,556,51,1516,1015,3281,191,533,47,1529,1089,3389,28,48
98,403,6,1458,997,2962,193,370,8,1401,912,2884,28,49
378,329,3,1047,632,2389,385,338,4,872,929,2528,28,50
1341,509,10,916,1115,3891,616,651,11,842,1952,4072,28,51
1407,532,21,973,1134,4067,646,630,30,898,2006,4210,28,52
1271,786,16,937,1169,4179,645,715,21,874,2066,4321,28,53
822,735,43,989,1154,3743,590,636,44,996,1651,3917,28,54
178,758,58,1500,1217,3711,205,620,29,1672,1216,3742,28,55
118,343,18,1393,955,2827,232,325,26,1482,847,2912,28,56
1065,327,14,845,1057,3308,585,502,11,865,1593,3556,28,57
1486,554,5,912,1117,4074,620,594,6,879,2126,4225,28,58
1394,544,5,965,1001,3909,656,617,7,935,2051,4266,28,59
1354,685,15,981,1173,4208,664,664,21,949,2182,4480,28,60
911,766,55,997,1347,4076,612,734,50,1116,1661,4173,28,61
162,693,40,1218,1093,3206,206,540,45,1233,1119,3143,28,62
132,368,15,1643,1056,3214,264,298,23,1798,974,3357,28,63
1031,412,7,856,1090,3396,624,458,11,867,1664,3624,28,64
1440,629,7,930,1194,4200,774,684,10,905,2193,4566,28,65
1428,715,3,997,1159,4302,682,677,5,937,2228,4529,28,66
1324,918,17,1023,1259,4541,663,921,29,964,2280,4857,28,67
852,816,61,1083,1293,4105,598,774,48,1095,1818,4333,28,68
202,601,33,1512,929,3277,245,476,34,1489,1034,3278,28,69
156,339,6,1596,990,3087,217,317,10,1541,1024,3109,28,70
1021,592,13,933,1051,3610,590,601,19,869,1777,3856,28,71
1425,874,13,1085,1297,4694,685,848,22,1000,2328,4883,28,72
1389,686,9,1181,1264,4529,666,827,19,1102,2186,4800,28,73
1218,829,11,1255,1367,4680,640,836,41,1090,2100,4707,28,74
823,923,70,1172,1270,4258,550,712,82,1169,1929,4442,28,75
349,928,41,2259,1530,5107,323,783,47,2436,1481,5070,28,76
134,458,5,1705,1120,3422,233,465,8,1735,1047,3488,28,77
1109,479,2,1050,1122,3762,620,567,4,1018,1760,3969,28,78
1490,644,21,1038,1290,4483,665,799,12,1024,2179,4679,28,79
1444,797,1,1118,1371,4731,681,913,10,1097,2190,4891,28,80
1395,814,5,1105,1306,4625,667,872,22,1105,2251,4917,28,81
930,904,44,1315,1439,4632,662,867,59,1253,1999,4840,28,82
126,816,45,1321,1176,3484,168,697,38,1346,1306,3555,28,83
187,473,0,2295,1349,4304,317,508,4,2300,1476,4605,28,84
1030,559,2,1178,1229,3998,589,641,8,917,1902,4057,28,85
1423,671,3,1309,1469,4875,709,777,9,1123,2302,4920,28,86
1367,647,3,1236,1179,4432,649,713,9,1039,2146,4556,28,87
1250,755,8,1183,1286,4482,673,721,16,1113,2259,4782,28,88
841,898,44,1537,1382,4702,601,758,44,1341,2057,4801,28,89
205,784,46,2695,1683,5413,269,701,38,2689,1634,5331,28,90
179,382,3,1771,1034,3369,284,368,7,1710,958,3327,28,91
958,413,5,1150,961,3487,530,545,10,937,1690,3712,28,92
1444,620,9,1164,1201,4438,632,659,10,964,2288,4553,28,93
1417,586,4,1178,1160,4345,665,719,8,966,2252,4610,28,94
1307,872,19,1215,1315,4728,681,874,33,1086,2369,5043,28,95
765,839,41,1522,1258,4425,545,800,47,1389,1849,4630,28,96
317,825,77,2176,1352,4747,247,773,34,2441,1302,4797,28,97
453,466,20,1871,1112,3922,290,395,13,2321,1000,4019,28,98
1065,465,30,958,1020,3538,627,504,56,839,1673,3699,28,99
1391,595,16,1089,1273,4364,710,663,21,975,2060,4429,28,100
1372,687,13,1125,1250,4447,729,701,21,1044,2209,4704,28,101
1242,743,20,1103,1230,4338,685,746,26,1056,2027,4540,28,102
878,876,35,1192,1282,4263,612,769,48,1230,1856,4515,28,103
252,884,43,1911,1511,4601,258,746,48,2225,1534,4811,28,104
165,462,3,1893,1118,3641,307,467,6,1923,1084,3787,28,105
931,483,4,1019,1069,3506,601,590,11,971,1528,3701,28,106
1285,650,4,994,1094,4027,550,734,7,978,1924,4193,28,107
1225,709,6,1067,1165,4172,657,712,5,953,1927,4254,28,108
1125,724,7,1086,1195,4137,594,789,12,1081,1865,4341,28,109
722,801,44,1046,1287,3900,571,702,44,1116,1690,4123,28,110
192,965,30,1685,1326,4198,224,716,47,1856,1447,4290,28,111
136,360,5,1471,948,2920,207,292,7,1450,907,2863,28,112
1009,410,3,829,1050,3301,572,507,7,876,1661,3623,28,113
1376,562,18,1039,1207,4202,695,636,26,1054,2071,4482,28,114
1350,777,30,1051,1191,4399,692,743,30,1019,2203,4687,28,115
1257,769,20,1109,1234,4389,702,729,19,1053,1986,4489,28,116
859,844,37,1145,1319,4204,620,789,41,1163,1827,4440,28,117
202,695,48,1763,1162,3870,281,740,89,1881,1238,4229,28,118
117,451,18,1779,1042,3407,216,572,19,1749,885,3441,28,119
1036,472,21,965,1078,3572,606,557,24,885,1692,3764,28,120
1422,535,5,943,1049,3954,701,583,4,957,2089,4334,28,121
1345,671,21,1073,1143,4253,689,733,17,1061,2121,4621,28,122
1248,764,17,1091,1204,4324,678,715,17,1047,2077,4534,28,123
867,978,38,1091,1267,4241,587,797,47,1192,1863,4486,28,124
183,651,23,1553,930,3340,213,521,31,1406,1201,3372,28,125
136,415,8,1320,888,2767,233,326,11,1483,807,2860,28,126
1074,463,9,840,1029,3415,594,522,11,902,1685,3714,28,127
1409,758,17,1015,1183,4382,676,699,19,1077,2194,4665,28,128
1345,831,7,1077,1190,4450,684,756,14,1044,2159,4657,28,129
1239,630,6,1002,1119,3996,670,666,14,915,1948,4213,28,130
816,821,35,1013,1166,3851,574,671,29,1063,1683,4020,28,131
203,637,24,1684,1180,3728,222,475,33,1773,1234,3737,28,132
136,332,2,1348,906,2724,229,296,7,1512,709,2753,28,133
1006,513,18,924,1004,3465,586,545,14,862,1789,3796,28,134
1390,634,22,982,1185,4213,696,590,22,982,2160,4450,28,135
1384,688,12,1043,1182,4309,694,699,11,1033,2155,4592,28,136
1258,802,23,1099,1277,4459,686,766,23,1036,2178,4689,28,137
782,1030,36,1092,1104,4044,547,784,46,1141,1797,4315,28,138
149,636,20,1467,906,3178,216,516,32,1312,1042,3118,28,139
178,374,3,1829,1042,3426,279,388,3,1849,920,3439,28,140
1053,441,2,894,1093,3483,610,527,10,857,1759,3763,28,141
1414,743,13,1005,1198,4373,748,761,11,1051,2171,4742,28,142
1301,635,27,1021,1191,4175,663,706,29,988,2128,4514,28,143
1200,657,29,934,1148,3968,642,605,41,951,2047,4286,28,144
697,927,32,1032,1107,3795,518,776,39,1130,1711,4174,28,145
159,624,31,1771,1055,3640,254,555,44,1874,975,3702,28,146
118,469,1,1679,938,3205,206,374,12,1768,931,3291,28,147
162,287,3,827,524,1803,128,311,11,798,704,1952,28,148
1311,638,2,939,1143,4033,660,595,7,1054,2061,4377,28,149
1321,606,4,1102,1031,4064,634,607,7,1032,2158,4438,28,150
1337,706,4,995,1181,4223,682,719,9,1023,2017,4450,28,151
783,955,49,1080,1220,4087,584,787,35,1207,1859,4472,28,152
158,796,22,1660,1207,3843,274,679,36,1813,1138,3940,28,153
124,394,4,1632,931,3085,262,338,8,1617,884,3109,28,154
1116,439,2,927,1036,3520,641,515,5,950,1729,3840,28,155
1351,664,7,1136,1255,4413,679,711,12,1167,2189,4758,28,156
1405,662,4,1154,1194,4419,740,704,6,1224,2236,4910,28,157
1301,840,1,1057,1267,4466,696,821,13,1086,2107,4723,28,158
887,1045,52,1085,1326,4395,597,949,49,1218,1927,4740,28,159
207,1037,37,2271,1621,5173,296,1254,72,1964,1737,5323,28,160
157,433,18,1865,1113,3586,258,516,24,1879,1130,3807,28,161
1083,447,7,998,1061,3596,618,551,5,994,1662,3830,28,162
1423,643,5,1027,1268,4366,721,735,5,1066,2179,4706,28,163
1360,659,4,1122,1196,4341,697,753,13,1075,2120,4658,28,164
1323,835,1,1068,1208,4435,740,760,11,1098,2197,4806,28,165
848,923,40,1152,1195,4158,633,791,53,1152,1775,4404,28,166
188,911,45,1781,1204,4129,319,643,37,1925,1301,4225,28,167
128,356,5,1651,964,3104,247,389,9,1684,900,3229,28,168
1005,487,5,983,1059,3539,598,566,9,962,1710,3845,28,169
1362,736,5,1046,1154,4303,625,726,17,1141,1991,4500,28,170
309,549,8,1248,934,3048,287,569,19,1271,1220,3366,28,171
1090,775,20,1051,1096,4032,598,770,33,960,1936,4297,28,172
748,1006,22,1125,1012,3913,538,773,33,1095,1680,4119,28,173
181,817,27,1761,1048,3834,289,797,81,1676,1009,3852,28,174
131,339,9,1556,863,2898,239,406,6,1557,827,3035,28,175
1092,471,1,982,1024,3570,659,512,5,1056,1584,3816,28,176
1349,624,0,1106,1061,4140,702,696,6,1070,2087,4561,28,177
1383,912,2,1122,1105,4524,727,757,7,1101,2264,4856,28,178
1290,778,1,1096,1264,4429,706,736,10,1097,2025,4574,28,179
858,1005,34,1157,1266,4320,615,711,50,1195,1824,4395,28,180
205,717,28,1918,1129,3997,275,688,48,1988,1085,4084,28,181
134,346,2,1644,932,3058,240,398,7,1634,849,3128,28,182
979,413,0,985,1072,3449,644,546,3,938,1581,3712,28,183
1194,596,2,1054,1107,3953,639,589,6,1089,1907,4230,28,184
929,713,3,1217,1214,4076,636,716,22,1243,1660,4277,28,185
142,1172,10,1499,1032,3855,233,1127,12,1265,1038,3675,28,186
416,966,19,1271,906,3578,376,635,27,1149,1488,3675,28,187
148,578,21,1979,1036,3762,269,494,24,1982,985,3754,28,188
113,328,1,1599,816,2857,222,323,5,1674,854,3078,28,189
1034,494,0,869,998,3395,636,574,4,917,1567,3698,28,190
1324,679,5,1058,1103,4169,682,738,2,1153,1997,4572,28,191
1314,672,4,1117,1138,4245,675,709,8,1122,2069,4583,28,192
1234,806,28,1136,1309,4513,682,824,25,1163,2044,4738,28,193
761,793,25,992,1102,3673,564,656,46,1059,1541,3866,28,194
182,681,27,1840,1231,3961,339,620,35,1829,1136,3959,28,195
147,345,6,1767,897,3162,287,359,11,1746,775,3178,28,196
1028,367,7,953,977,3332,643,420,14,892,1547,3516,28,197
1275,606,2,972,1077,3932,625,632,9,1019,1935,4220,28,198
1263,561,4,1064,1171,4063,683,558,1,1045,1996,4283,28,199
1211,653,7,1024,1256,4151,672,701,12,1054,1859,4298,28,200
682,965,43,1055,1141,3886,589,821,73,1144,1609,4236,28,201
148,640,31,2076,1209,4104,255,553,55,2206,1054,4123,28,202
116,369,2,1726,1029,3242,237,374,16,1826,855,3308,28,203
964,404,15,1024,944,3351,599,529,16,1327,1388,3859,28,204
1295,658,8,1024,1174,4159,683,738,15,1032,2007,4475,28,205
1313,715,9,1208,1353,4598,686,680,12,1154,2414,4946,28,206
1221,717,2,1057,1255,4252,682,690,14,1005,1994,4385,28,207
776,992,37,1139,1275,4219,595,811,55,1176,1787,4424,28,208
165,790,66,1859,1304,4184,302,720,73,2041,1176,4312,28,209
120,440,9,1569,991,3129,233,379,7,1719,863,3201,28,210
908,450,7,971,1066,3402,605,501,14,954,1591,3665,28,211
1251,602,8,1042,1115,4018,642,644,10,933,2050,4279,28,212
1276,596,4,1037,1073,3986,669,653,17,926,1942,4207,28,213
1113,797,3,1113,1188,4214,625,733,6,1092,2000,4456,28,214
719,994,67,1067,1071,3918,598,921,37,1007,1550,4113,28,215
162,555,42,1629,1154,3542,228,447,48,1698,1088,3509,28,216
101,352,5,1575,876,2909,252,356,16,1594,815,3033,28,217
837,355,0,820,931,2943,559,462,1,789,1369,3180,28,218
1138,535,5,945,1085,3708,582,650,5,995,1810,4042,28,219
1148,567,9,999,1054,3777,590,615,18,978,1871,4072,28,220
956,565,5,900,997,3423,549,504,4,884,1680,3621,28,221
492,767,56,798,899,3012,426,644,23,822,1306,3221,28,222
132,663,47,1610,1179,3631,226,570,44,1889,1020,3749,28,223
112,360,2,1460,889,2823,248,363,4,1534,789,2938,28,224
797,319,2,800,872,2790,561,409,6,814,1315,3105,28,225
1107,554,2,906,1032,3601,564,574,4,932,1800,3874,28,226
1057,578,4,877,1043,3559,604,554,4,920,1812,3894,28,227
1041,603,6,1021,1070,3741,597,578,9,933,1636,3753,28,228
635,790,60,1013,1100,3598,555,635,47,1083,1410,3730,28,229
136,581,34,1556,1156,3463,218,473,50,1774,1053,3568,28,230
109,315,1,1379,836,2640,218,304,6,1460,814,2802,28,231
812,362,1,796,836,2807,574,382,5,806,1341,3108,28,232
1086,483,2,886,1060,3517,580,553,4,954,1765,3856,28,233
1064,607,1,932,1049,3653,610,638,6,931,1701,3886,28,234
947,551,1,902,1108,3509,612,614,6,859,1701,3792,28,235
618,923,73,987,1093,3694,519,771,42,983,1613,3928,28,236
169,647,37,1706,1078,3637,255,603,32,1787,1131,3808,28,237
112,320,4,1549,902,2887,266,347,18,1671,788,3090,28,238
1014,361,4,838,942,3159,617,469,5,815,1536,3442,28,239
1283,535,17,847,1063,3745,641,621,13,807,1934,4016,28,240
1232,532,7,886,1071,3728,664,589,10,935,1924,4122,28,241
1074,493,3,955,1019,3544,630,505,10,917,1777,3839,28,242
683,538,37,1081,1077,3416,603,545,46,1088,1390,3672,28,243
124,557,54,1571,1227,3533,247,531,49,1826,890,3543,28,244
115,463,6,1736,1000,3320,224,405,10,1894,991,3524,28,245
136,281,1,839,488,1745,154,332,12,773,655,1926,28,246
1306,490,9,862,1031,3698,632,553,15,920,1979,4099,28,247
1369,538,15,931,1114,3967,695,594,18,894,2046,4247,28,248
1261,647,10,929,1190,4037,687,656,10,880,2048,4281,28,249
831,735,33,915,1164,3678,597,625,38,1017,1638,3915,28,250
180,725,54,1663,1087,3709,273,565,52,1881,1115,3886,28,251
109,330,5,1703,990,3137,260,365,10,1986,762,3383,28,252
1082,476,3,794,946,3301,597,526,12,761,1786,3682,28,253
1446,718,5,946,1060,4175,688,739,10,960,2183,4580,28,254
1420,663,16,950,1149,4198,709,667,17,977,2088,4458,28,255
1318,721,2,957,1208,4206,705,799,7,919,2094,4524,28,256
834,758,49,983,1192,3816,639,689,38,1089,1760,4215,28,257
165,912,52,1843,1411,4383,244,712,60,2060,1452,4528,28,258
132,372,4,1805,974,3287,240,377,15,1859,997,3488,28,259
1119,453,1,871,1094,3538,667,510,5,820,1757,3759,28,260
1474,622,3,883,1237,4219,719,694,8,913,2339,4673,28,261
1471,588,3,967,1183,4212,694,709,6,885,2122,4416,28,262
1371,686,4,1099,1236,4396,748,837,3,1008,2009,4605,28,263
889,824,43,980,1243,3979,632,735,49,1036,1842,4294,28,264
896,1530,67,3705,2286,8484,630,2521,235,3081,3241,9708,28,265
631,775,3,2925,1441,5775,481,1543,50,2523,2229,6826,28,266
1128,446,0,946,1025,3545,784,522,3,843,1705,3857,28,267
1472,687,4,887,1149,4199,672,712,14,914,2297,4609,28,268
1494,598,2,1022,1200,4316,686,659,11,988,2254,4598,28,269
1292,705,2,1014,1185,4198,723,729,7,969,2100,4528,28,270
864,886,34,954,1202,3940,602,741,32,1105,1793,4273,28,271
162,838,32,1792,1312,4136,218,720,51,2053,1256,4298,28,272
112,301,10,1545,841,2809,244,347,7,1606,799,3003,28,273
1193,360,1,806,1007,3367,643,530,6,843,1735,3757,28,274
1500,615,7,1022,1128,4272,731,680,8,968,2251,4638,28,275
1424,576,2,1050,1170,4222,713,674,6,999,2158,4550,28,276
1272,674,10,1025,1346,4327,717,655,22,988,2219,4601,28,277
849,724,32,1059,1227,3891,674,706,41,1159,1795,4375,28,278
186,890,64,1721,1220,4081,264,732,47,1803,1343,4189,28,279
157,381,3,1815,944,3300,240,376,7,1838,1047,3508,28,280
1105,419,3,972,1036,3535,616,509,5,922,1808,3860,28,281
1494,713,4,890,1166,4267,708,739,4,941,2370,4762,28,282
1494,633,8,1095,1223,4453,711,719,5,1094,2185,4714,28,283
1224,672,5,1191,1211,4303,690,736,12,1082,1949,4469,28,284
717,702,43,1091,1275,3828,544,733,28,1216,1697,4218,28,285
221,678,31,2035,1387,4352,255,639,42,2391,1274,4601,28,286
224,466,6,1883,1083,3662,252,374,10,2059,1141,3836,28,287
414,366,2,1001,835,2618,311,429,9,956,1203,2908,28,288
1435,563,8,1012,1321,4339,744,727,10,1066,2217,4764,28,289
1417,680,2,1142,1224,4465,746,750,4,1055,2301,4856,28,290
1306,642,2,1178,1307,4435,701,802,9,1074,2117,4703,28,291
876,849,57,1238,1284,4304,635,757,52,1165,1928,4537,28,292
191,885,52,1890,1331,4349,232,680,68,2199,1402,4581,28,293
111,348,6,1970,1124,3559,225,474,13,2142,947,3801,28,294
1104,397,10,981,1081,3573,648,539,7,894,1791,3879,28,295
1473,565,1,993,1261,4293,740,700,4,971,2183,4598,28,296
1445,658,4,1084,1232,4423,695,709,7,1058,2299,4768,28,297
1377,710,4,1061,1303,4455,678,731,7,984,2265,4665,28,298
887,846,30,1129,1361,4253,596,690,52,1074,2061,4473,28,299
199,642,71,1946,1342,4200,247,703,65,2187,1257,4459,28,300
445,412,2,1866,1104,3829,321,526,6,2242,1126,4221,28,301
1076,419,0,985,1021,3501,645,544,2,909,1746,3846,28,302
1409,577,15,1040,1747,4788,703,1269,10,1014,2213,5209,28,303
1455,695,3,1096,1248,4497,677,718,2,1010,2349,4756,28,304
1249,1291,2,971,1251,4764,702,1143,6,1067,2751,5669,28,305
856,731,35,1049,1183,3854,572,708,46,1095,1796,4217,28,306
172,680,86,1705,1308,3951,213,766,37,1905,1186,4107,28,307
144,291,19,1669,939,3062,276,302,20,1816,814,3228,28,308
1054,450,13,887,978,3382,592,472,13,910,1728,3715,28,309
1170,514,40,1109,1133,3966,628,525,54,1167,1887,4261,28,310
1169,522,5,903,1063,3662,636,540,10,943,1911,4040,28,311
1309,577,31,947,1170,4034,672,566,31,980,2168,4417,28,312
839,831,45,1086,1335,4136,634,633,40,1162,1870,4339,28,313
181,703,41,2093,1762,4780,281,529,47,2649,1321,4827,28,314
117,364,3,1935,1287,3706,246,301,8,2201,1082,3838,28,315
449,302,1,1083,742,2577,312,371,4,1038,1099,2824,28,316
1537,526,3,935,1214,4215,702,616,6,991,2279,4594,28,317
1502,574,1,1036,1230,4343,716,704,10,1033,2358,4821,28,318
1413,626,26,1028,1209,4302,725,684,38,1037,2238,4722,28,319
947,698,31,1068,1262,4006,654,660,35,1138,1779,4266,28,320
176,663,65,1910,1549,4363,258,620,38,2210,1319,4445,28,321
120,319,12,1771,1016,3238,259,311,7,1967,841,3385,28,322
1148,385,4,799,1086,3422,637,497,6,853,1756,3749,28,323
1507,552,3,969,1240,4271,702,653,2,975,2313,4645,28,324
1514,649,4,924,1240,4331,681,636,8,947,2363,4635,28,325
1397,599,2,919,1231,4148,710,700,6,912,2232,4560,28,326
839,709,31,984,1141,3704,627,689,28,969,1680,3993,28,327
139,656,41,1647,1238,3721,221,569,48,1711,1223,3772,28,328
108,294,3,1492,859,2756,239,278,7,1422,879,2825,28,329
927,337,1,885,1031,3181,598,380,8,897,1545,3428,28,330
955,461,0,983,1131,3530,587,435,6,1021,1706,3755,28,331
495,383,0,1047,868,2793,427,320,1,1066,1035,2849,28,332
86,103,0,367,200,756,80,121,5,331,260,797,28,333
165,330,9,907,569,1980,226,308,20,880,842,2276,28,334
105,383,33,1271,794,2586,188,369,29,1269,856,2711,28,335
69,240,2,1141,665,2117,173,340,3,1070,825,2411,28,336
1009,296,1,864,984,3154,640,487,4,864,1578,3573,28,337
1458,543,0,977,1139,4117,683,690,3,1008,2188,4572,28,338
1504,642,3,1027,1246,4422,678,649,4,1027,2381,4739,28,339
1360,684,2,1017,1291,4354,645,710,3,975,2315,4648,28,340
890,599,49,1064,1264,3866,610,612,48,1131,1743,4144,28,341
819,1120,80,3478,2391,7888,562,2603,225,2482,3132,9004,28,342
614,704,23,2823,1744,5908,481,1620,55,2377,2429,6962,28,343
1207,379,7,934,1138,3665,670,543,13,863,1849,3938,28,344
1564,723,16,1140,1269,4712,752,698,15,1074,2418,4957,28,345
1483,742,10,1025,1164,4424,702,721,20,972,2348,4763,28,346
1394,544,7,1191,1325,4461,703,797,9,1193,2204,4906,28,347
878,795,98,1113,1325,4209,606,796,78,1109,1977,4566,28,348
227,703,74,1945,1365,4314,233,830,82,1947,1307,4399,28,349
137,301,17,1519,932,2906,240,360,18,1514,869,3001,28,350
1129,451,12,916,1057,3565,650,500,13,872,1808,3843,28,351
1387,646,7,1008,1292,4340,665,721,13,997,2263,4659,28,352
1332,584,12,1069,1186,4183,681,637,14,1051,2086,4469,28,353
1093,665,10,1047,1333,4148,653,674,16,1009,1959,4311,28,354
566,534,28,930,1005,3063,483,414,20,884,1179,2980,28,355
98,346,19,1052,804,2319,166,253,13,978,776,2186,28,356
102,192,16,951,522,1783,121,204,10,745,638,1718,28,357
296,228,3,758,682,1967,288,201,3,665,752,1909,28,358
122,128,5,522,356,1133,196,97,8,487,342,1130,28,359
30,66,1,135,97,329,31,62,2,147,129,371,28,360
121,287,32,494,477,1411,182,227,30,485,575,1499,28,361
124,223,13,558,475,1393,210,146,8,570,439,1373,28,362
56,182,13,511,389,1151,104,129,11,454,378,1076,28,363
37,192,3,506,480,1218,84,109,179,483,311,1166,28,364
302,289,8,714,662,1975,331,288,9,738,881,2247,28,365
309,425,270,1005,757,2766,296,475,218,1094,987,3070,28,366
31,42,5,136,93,307,14,76,9,125,117,341,29,1
366,79,1,208,311,965,200,145,6,201,397,949,29,2
498,65,0,197,384,1144,228,158,4,209,496,1095,29,3
476,76,2,198,353,1105,217,132,6,167,490,1012,29,4
376,116,6,228,328,1054,111,183,17,240,396,947,29,5
56,97,8,195,135,491,28,121,16,161,157,483,29,6
54,70,1,233,129,487,25,138,7,136,188,494,29,7
444,90,1,165,279,979,190,163,3,173,441,970,29,8
528,75,1,184,268,1056,262,110,3,212,454,1041,29,9
584,109,3,216,379,1291,289,176,9,203,533,1210,29,10
563,112,4,216,431,1326,256,198,10,178,521,1163,29,11
333,124,4,197,321,979,144,148,17,173,387,869,29,12
64,99,6,466,242,877,45,186,11,214,360,816,29,13
67,93,1,226,139,526,22,109,6,208,212,557,29,14
78,64,6,226,148,522,60,95,11,179,166,511,29,15
170,56,3,180,179,588,126,95,3,140,169,533,29,16
523,89,2,212,356,1182,206,176,1,191,528,1102,29,17
574,85,1,222,392,1274,235,204,7,206,514,1166,29,18
253,120,6,297,244,920,116,251,25,188,296,876,29,19
110,105,8,313,235,771,39,189,23,208,239,698,29,20
41,59,1,209,171,481,15,120,1,140,192,468,29,21
460,81,1,192,288,1022,200,147,6,174,442,969,29,22
628,102,0,230,432,1392,309,192,1,212,602,1316,29,23
626,106,1,228,387,1348,263,186,6,230,581,1266,29,24
566,113,1,231,436,1347,272,193,6,221,527,1219,29,25
436,163,9,227,397,1232,154,200,22,218,480,1074,29,26
79,134,10,404,281,908,61,208,21,262,307,859,29,27
30,59,0,245,136,470,20,108,4,187,181,500,29,28
467,82,9,181,281,1020,203,137,13,194,480,1027,29,29
633,93,0,194,368,1288,277,152,4,201,586,1220,29,30
637,79,2,218,414,1350,260,176,10,181,610,1237,29,31
543,97,3,261,430,1334,270,152,9,203,540,1174,29,32
385,119,1,232,368,1105,166,152,24,174,407,923,29,33
71,97,5,276,183,632,36,124,23,185,196,564,29,34
53,41,0,215,128,437,23,107,1,154,211,496,29,35
507,81,2,207,300,1097,205,151,3,176,525,1060,29,36
650,89,11,193,405,1348,310,221,8,160,550,1249,29,37
670,99,23,277,428,1497,306,206,25,233,595,1365,29,38
643,89,15,242,401,1390,320,186,13,207,545,1271,29,39
406,124,3,258,336,1127,169,180,19,188,413,969,29,40
78,118,4,325,295,820,36,203,23,200,312,774,29,41
47,90,5,241,193,576,25,139,15,179,213,571,29,42
440,98,1,211,287,1037,212,147,3,176,474,1012,29,43
578,94,6,190,411,1279,265,199,11,199,546,1220,29,44
641,122,0,229,416,1408,261,171,10,235,616,1293,29,45
583,112,1,199,404,1299,257,181,6,209,534,1187,29,46
383,151,10,213,373,1130,174,196,31,232,350,983,29,47
70,128,6,390,223,817,41,216,13,181,288,739,29,48
57,70,1,320,186,634,20,187,3,180,230,620,29,49
134,77,2,273,163,649,63,132,5,208,254,662,29,50
607,74,0,219,398,1298,275,196,2,194,567,1234,29,51
640,87,2,217,401,1347,289,158,10,199,624,1280,29,52
594,96,1,268,426,1385,253,191,5,219,550,1218,29,53
466,143,2,247,323,1181,138,180,22,218,436,994,29,54
96,99,4,337,227,763,27,147,25,225,266,690,29,55
52,81,1,250,153,537,20,138,1,159,241,559,29,56
524,76,2,213,321,1136,189,170,5,168,507,1039,29,57
649,89,1,242,409,1390,274,238,4,219,602,1337,29,58
666,78,3,241,395,1383,263,185,6,206,582,1242,29,59
704,149,3,266,383,1505,227,216,4,322,609,1378,29,60
420,176,4,271,416,1287,151,241,12,215,472,1091,29,61
58,185,7,282,269,801,21,185,21,236,265,728,29,62
104,102,3,298,210,717,31,142,14,210,312,709,29,63
514,89,1,252,282,1138,189,174,3,205,514,1085,29,64
688,100,1,261,408,1458,281,270,4,213,669,1437,29,65
796,117,1,297,433,1644,270,253,3,232,726,1484,29,66
710,146,1,275,448,1580,304,263,7,274,600,1448,29,67
473,186,5,372,382,1418,202,244,24,295,470,1235,29,68
121,132,3,377,263,896,46,240,15,230,288,819,29,69
66,98,4,310,183,661,30,152,8,223,251,664,29,70
520,80,1,275,304,1180,214,224,5,197,558,1198,29,71
718,131,1,362,441,1653,295,308,3,244,755,1605,29,72
719,119,1,398,468,1705,291,292,11,234,747,1575,29,73
645,121,4,372,497,1639,250,345,22,240,656,1513,29,74
494,152,6,342,393,1387,149,267,27,220,531,1194,29,75
144,205,3,568,287,1207,32,294,46,311,424,1107,29,76
97,97,3,386,262,845,39,222,5,251,295,812,29,77
522,87,0,289,324,1222,218,223,2,228,562,1233,29,78
691,112,4,321,442,1570,277,289,8,257,693,1524,29,79
773,121,1,381,489,1765,274,351,4,278,701,1608,29,80
680,106,2,333,454,1575,238,316,8,266,609,1437,29,81
488,155,15,420,485,1563,173,338,49,297,549,1406,29,82
79,143,2,368,265,857,34,267,19,180,335,835,29,83
163,127,10,516,212,1028,27,266,14,240,469,1016,29,84
552,104,1,414,354,1425,188,255,21,241,606,1311,29,85
751,128,3,385,535,1802,285,330,3,279,757,1654,29,86
676,112,1,401,451,1641,280,253,2,260,690,1485,29,87
580,132,3,388,425,1528,224,286,6,239,708,1463,29,88
442,173,3,501,436,1555,163,310,24,308,589,1394,29,89
180,144,9,624,362,1319,48,359,25,269,527,1228,29,90
96,81,0,406,188,771,22,204,1,193,376,796,29,91
507,107,2,401,338,1355,202,272,6,202,591,1273,29,92
661,108,5,362,470,1606,281,273,9,238,716,1517,29,93
680,102,1,358,419,1560,263,277,4,221,728,1493,29,94
702,140,2,429,443,1716,251,354,8,281,694,1588,29,95
514,164,7,410,415,1510,161,302,35,259,576,1333,29,96
167,125,8,430,217,947,35,276,23,214,366,914,29,97
175,63,11,429,187,865,37,214,17,265,332,865,29,98
548,126,1,286,298,1259,213,209,6,249,547,1224,29,99
737,131,0,268,395,1531,269,286,19,250,616,1440,29,100
703,128,4,352,419,1606,288,324,5,234,668,1519,29,101
688,178,1,304,439,1610,273,303,8,248,589,1421,29,102
464,162,8,401,407,1442,189,269,23,255,494,1230,29,103
173,161,8,419,321,1082,47,327,29,245,358,1006,29,104
78,75,3,348,182,686,26,167,9,221,248,671,29,105
500,107,3,276,369,1255,188,288,6,218,483,1183,29,106
679,124,2,311,482,1598,286,272,8,270,649,1485,29,107
758,121,3,308,440,1630,302,227,7,257,646,1439,29,108
625,145,4,319,433,1526,279,255,5,250,618,1407,29,109
468,160,4,370,403,1405,188,210,29,273,497,1197,29,110
103,149,2,603,305,1162,35,375,26,228,355,1019,29,111
78,105,2,318,166,669,20,172,7,206,258,663,29,112
539,118,6,300,301,1264,201,157,13,230,567,1168,29,113
631,103,2,283,432,1451,279,244,8,221,614,1366,29,114
683,129,5,296,452,1565,254,266,9,260,639,1428,29,115
636,142,2,328,478,1586,266,296,5,269,626,1462,29,116
458,185,7,308,385,1343,170,280,16,231,489,1186,29,117
127,118,4,340,202,791,35,196,29,201,242,703,29,118
76,95,2,302,199,674,27,220,13,225,275,760,29,119
510,105,1,253,309,1178,203,177,5,188,514,1087,29,120
642,115,1,297,415,1470,294,228,5,223,635,1385,29,121
663,115,1,280,413,1472,270,236,5,247,619,1377,29,122
633,140,5,261,429,1468,292,230,7,232,577,1338,29,123
421,150,7,312,415,1305,175,250,20,249,473,1167,29,124
83,126,2,347,214,772,31,222,15,209,272,749,29,125
61,79,4,272,165,581,25,169,7,174,227,602,29,126
543,94,1,286,303,1227,237,200,7,217,547,1208,29,127
676,130,4,280,507,1597,312,290,11,246,665,1524,29,128
732,167,0,285,513,1697,291,326,6,256,646,1525,29,129
650,143,0,310,443,1546,279,245,4,230,622,1380,29,130
440,151,5,279,338,1213,157,211,26,221,469,1084,29,131
140,118,8,389,233,888,56,197,22,232,279,786,29,132
105,73,1,266,134,579,25,135,6,216,252,634,29,133
518,112,1,252,356,1239,240,204,12,212,515,1183,29,134
690,104,0,265,406,1465,317,200,7,204,700,1428,29,135
707,126,1,287,414,1535,278,234,9,255,674,1450,29,136
618,133,10,325,494,1580,265,255,12,302,613,1447,29,137
475,130,5,319,371,1300,176,249,13,265,489,1192,29,138
96,124,6,321,211,758,27,222,21,216,280,766,29,139
123,83,1,350,168,725,34,209,7,253,309,812,29,140
559,101,2,329,333,1324,228,245,8,241,545,1267,29,141
705,120,1,306,484,1616,297,282,7,239,697,1522,29,142
705,147,0,371,446,1669,308,226,8,245,673,1460,29,143
591,150,2,313,420,1476,277,200,8,271,554,1310,29,144
337,158,3,341,418,1257,156,307,24,271,372,1130,29,145
106,147,6,465,218,942,33,317,17,237,274,878,29,146
119,131,2,410,167,829,35,212,7,217,313,784,29,147
77,59,1,258,142,537,42,129,13,207,226,617,29,148
606,118,3,255,355,1337,276,176,15,220,575,1262,29,149
625,114,4,268,388,1399,285,195,11,232,647,1370,29,150
700,139,2,335,404,1580,279,260,5,247,615,1406,29,151
477,150,6,391,432,1456,214,248,16,246,483,1207,29,152
102,143,2,380,284,911,53,227,17,252,342,891,29,153
133,75,1,261,164,634,40,142,6,201,239,628,29,154
534,105,6,291,350,1286,225,238,11,219,546,1239,29,155
649,108,4,269,444,1474,338,243,8,224,602,1415,29,156
645,127,2,274,440,1488,294,210,6,236,628,1374,29,157
623,152,1,338,495,1609,310,330,6,255,593,1494,29,158
442,176,3,335,467,1423,174,347,32,237,427,1217,29,159
123,197,13,577,385,1295,39,545,43,204,361,1192,29,160
72,94,4,424,195,789,19,230,11,234,315,809,29,161
561,111,10,287,374,1343,235,204,13,226,583,1261,29,162
733,118,4,303,445,1603,307,251,7,264,684,1513,29,163
717,147,3,327,490,1684,289,305,13,245,693,1545,29,164
656,132,2,326,489,1605,312,277,6,239,657,1491,29,165
481,184,5,355,431,1456,177,265,42,267,519,1270,29,166
109,204,4,364,264,945,39,261,34,208,325,867,29,167
89,97,0,336,140,662,33,155,6,183,306,683,29,168
548,149,1,319,314,1331,231,201,6,237,631,1306,29,169
646,111,3,339,572,1671,309,321,10,272,593,1505,29,170
229,148,4,397,268,1046,90,254,11,247,345,947,29,171
615,144,7,405,411,1582,265,282,24,255,633,1459,29,172
460,201,6,356,351,1374,170,245,12,273,483,1183,29,173
107,187,12,404,300,1010,44,303,43,302,301,993,29,174
65,97,4,298,188,652,27,172,18,211,214,642,29,175
511,120,2,296,318,1247,209,188,9,243,572,1221,29,176
660,131,4,289,480,1564,314,244,8,276,667,1509,29,177
707,130,1,313,497,1648,338,260,5,297,674,1574,29,178
681,172,2,374,478,1707,311,270,13,266,693,1553,29,179
471,209,6,381,375,1442,191,250,27,300,508,1276,29,180
105,203,9,233,263,813,41,203,23,163,322,752,29,181
61,80,0,278,147,566,29,136,4,206,230,605,29,182
570,106,5,253,374,1308,249,225,15,250,534,1273,29,183
625,129,3,293,430,1480,277,202,7,252,649,1387,29,184
502,151,1,339,426,1419,188,290,24,293,483,1278,29,185
130,466,4,469,324,1393,30,613,13,268,310,1234,29,186
240,142,6,400,325,1113,118,247,17,262,330,974,29,187
86,158,5,350,186,785,41,219,14,225,301,800,29,188
60,82,9,286,158,595,19,155,7,179,254,614,29,189
529,103,2,290,301,1225,237,222,8,282,491,1240,29,190
610,126,2,284,367,1389,284,184,9,269,552,1298,29,191
605,132,8,285,407,1437,274,233,13,262,560,1342,29,192
540,146,2,301,406,1395,223,246,11,229,591,1300,29,193
421,189,4,280,324,1218,173,284,18,227,381,1083,29,194
114,207,5,376,301,1003,39,292,34,243,332,940,29,195
77,84,2,308,191,662,30,155,11,242,225,663,29,196
561,98,2,260,306,1227,223,197,7,258,489,1174,29,197
627,124,4,272,399,1426,271,209,8,250,607,1345,29,198
623,99,7,298,360,1387,279,173,10,223,625,1310,29,199
590,130,1,304,374,1399,249,227,5,266,561,1308,29,200
410,188,11,335,485,1429,151,303,64,249,472,1239,29,201
101,173,9,346,314,943,49,300,23,275,258,905,29,202
91,97,1,403,187,779,39,182,5,250,284,760,29,203
550,101,0,265,288,1204,217,176,4,229,562,1188,29,204
651,179,0,309,428,1567,319,214,6,250,669,1458,29,205
606,146,2,337,530,1621,296,281,9,288,632,1506,29,206
593,192,1,364,429,1579,298,231,5,276,623,1433,29,207
442,248,9,434,357,1490,165,279,39,304,536,1323,29,208
88,204,13,411,347,1063,62,291,64,284,342,1043,29,209
91,94,5,295,211,696,36,178,11,272,231,728,29,210
502,89,2,283,355,1231,196,218,20,236,587,1257,29,211
680,121,10,287,386,1484,297,233,11,233,681,1455,29,212
700,147,7,263,401,1518,270,211,12,229,669,1391,29,213
613,138,8,294,430,1483,238,227,11,262,584,1322,29,214
450,176,11,364,373,1374,155,313,18,241,475,1202,29,215
98,135,8,488,218,947,31,231,26,247,296,831,29,216
95,106,4,375,169,749,35,178,8,251,307,779,29,217
511,116,2,327,311,1267,191,213,9,241,520,1174,29,218
644,132,3,335,430,1544,280,269,7,265,624,1445,29,219
614,132,2,268,421,1437,257,231,10,261,604,1363,29,220
530,123,1,300,374,1328,215,204,11,239,615,1284,29,221
329,158,5,275,340,1107,135,207,39,222,352,955,29,222
95,146,6,403,295,945,48,278,19,244,312,901,29,223
55,96,2,319,165,637,31,144,9,197,277,658,29,224
477,117,2,239,321,1156,193,172,6,217,478,1066,29,225
602,140,2,286,427,1457,309,224,9,267,633,1442,29,226
576,125,5,280,423,1409,270,238,9,228,589,1334,29,227
509,146,3,322,390,1370,250,209,17,262,550,1288,29,228
370,171,11,324,348,1224,148,235,34,268,430,1115,29,229
85,166,5,390,274,920,65,209,18,272,274,838,29,230
55,90,2,264,146,557,26,169,7,185,204,591,29,231
464,92,3,247,299,1105,197,191,11,198,494,1091,29,232
622,137,3,318,445,1525,252,294,10,250,594,1400,29,233
606,136,1,303,502,1548,254,239,14,239,629,1375,29,234
587,119,0,293,412,1411,235,239,3,223,591,1291,29,235
405,166,6,279,351,1207,153,250,30,251,426,1110,29,236
98,146,5,379,299,927,45,290,31,261,266,893,29,237
63,98,2,258,188,609,34,159,16,220,194,623,29,238
497,89,5,212,344,1147,199,202,13,207,476,1097,29,239
618,137,3,270,463,1491,276,279,7,248,614,1424,29,240
610,113,2,250,456,1431,262,248,8,249,568,1335,29,241
576,134,2,286,407,1405,235,198,11,251,552,1247,29,242
310,181,3,324,364,1182,138,231,29,248,356,1002,29,243
94,161,10,402,249,916,42,262,24,227,297,852,29,244
73,120,10,429,184,816,31,232,15,199,332,809,29,245
76,106,3,272,171,628,35,153,7,224,236,655,29,246
614,111,2,257,355,1339,266,194,6,223,573,1262,29,247
634,147,1,290,386,1458,271,224,6,256,633,1390,29,248
647,140,7,250,472,1516,275,198,17,207,640,1337,29,249
424,189,7,292,393,1305,168,215,32,249,475,1139,29,250
110,138,9,357,286,900,50,257,42,249,273,871,29,251
84,99,1,300,184,668,40,210,5,227,284,766,29,252
565,95,22,259,314,1255,219,207,27,194,537,1184,29,253
761,102,4,319,446,1632,300,270,9,295,708,1582,29,254
698,121,3,341,482,1645,306,285,8,269,678,1546,29,255
675,125,3,309,463,1575,299,290,12,224,644,1469,29,256
530,184,8,285,425,1432,180,249,40,254,525,1248,29,257
85,165,6,428,306,990,45,265,31,251,294,886,29,258
67,84,4,303,194,652,37,203,9,197,263,709,29,259
523,102,2,281,385,1293,258,181,11,220,572,1242,29,260
713,114,6,327,450,1610,302,231,15,258,710,1516,29,261
689,104,7,276,516,1592,297,274,8,263,618,1460,29,262
738,131,1,310,541,1721,266,290,6,268,692,1522,29,263
498,198,8,368,380,1452,182,252,25,284,563,1306,29,264
143,148,5,473,289,1058,51,324,36,244,364,1019,29,265
78,102,1,259,199,639,31,157,6,229,227,650,29,266
578,96,7,262,361,1304,225,237,19,236,566,1283,29,267
771,116,2,299,473,1661,323,252,9,243,756,1583,29,268
812,105,0,334,465,1716,307,275,8,270,708,1568,29,269
720,124,2,337,478,1661,260,347,10,241,649,1507,29,270
478,168,6,294,507,1453,168,345,25,258,499,1295,29,271
103,191,9,487,281,1071,42,335,40,252,284,953,29,272
87,80,1,308,176,652,33,159,6,197,254,649,29,273
539,96,9,224,332,1200,205,184,14,225,577,1205,29,274
731,125,3,238,372,1469,298,211,4,218,669,1400,29,275
721,148,4,313,428,1614,281,237,4,265,721,1508,29,276
645,184,2,307,460,1598,261,251,8,253,622,1395,29,277
456,169,6,361,372,1364,141,214,37,287,535,1214,29,278
111,151,10,472,299,1043,47,290,27,254,333,951,29,279
110,76,1,288,173,648,49,137,10,192,267,655,29,280
593,112,16,326,352,1399,269,207,20,274,608,1378,29,281
781,124,12,332,452,1701,334,243,19,289,777,1662,29,282
767,121,1,354,426,1669,287,251,5,282,719,1544,29,283
703,135,5,342,502,1687,273,312,5,263,708,1561,29,284
451,176,11,395,443,1476,172,295,44,306,506,1323,29,285
200,181,11,521,341,1254,33,371,26,268,430,1128,29,286
211,86,1,368,291,957,39,284,14,353,353,1043,29,287
282,73,2,330,233,920,76,209,8,297,410,1000,29,288
880,94,1,326,458,1759,288,305,6,308,821,1728,29,289
843,115,3,369,474,1804,309,237,8,284,766,1604,29,290
750,133,3,305,506,1697,285,311,8,234,673,1511,29,291
496,172,6,379,419,1472,162,273,32,270,500,1237,29,292
131,160,10,416,295,1012,40,277,51,234,293,895,29,293
60,74,4,320,199,657,28,187,15,201,247,678,29,294
529,95,2,315,340,1281,214,209,9,253,547,1232,29,295
735,129,3,314,454,1635,322,262,7,299,720,1610,29,296
719,136,1,329,443,1628,326,272,8,258,666,1530,29,297
701,155,3,342,535,1736,315,309,6,262,676,1568,29,298
482,439,10,959,1141,3031,274,322,28,1073,1159,2856,29,299
163,178,9,1410,1035,2795,157,283,37,1702,502,2681,29,300
883,99,1,408,262,1653,66,231,16,558,617,1488,29,301
577,94,1,336,353,1361,202,212,4,229,600,1247,29,302
742,119,3,297,611,1772,318,396,11,280,648,1653,29,303
747,128,2,329,495,1701,292,243,4,291,712,1542,29,304
605,126,6,292,489,1518,238,250,11,253,604,1356,29,305
423,181,6,308,374,1292,145,252,27,258,453,1135,29,306
105,191,5,424,310,1035,44,312,40,218,282,896,29,307
87,68,1,245,183,584,34,164,6,209,250,663,29,308
552,92,3,255,346,1248,228,164,8,239,581,1220,29,309
593,95,3,261,335,1287,231,180,9,307,507,1234,29,310
578,95,2,255,431,1361,240,218,6,236,582,1282,29,311
637,125,5,283,391,1441,259,222,12,236,623,1352,29,312
410,152,8,322,473,1365,159,220,22,268,516,1185,29,313
102,135,9,377,251,874,44,210,25,228,330,837,29,314
88,74,1,334,202,699,26,185,8,214,297,730,29,315
197,95,3,288,189,772,87,163,8,227,277,762,29,316
726,121,5,254,413,1519,292,222,8,257,698,1477,29,317
717,116,6,268,455,1562,304,245,9,240,702,1500,29,318
669,149,3,283,442,1546,304,227,7,246,656,1440,29,319
469,149,6,380,412,1416,193,212,26,318,499,1248,29,320
108,158,15,381,306,968,60,189,37,266,332,884,29,321
81,88,5,279,192,645,29,161,9,167,236,602,29,322
591,107,6,261,345,1310,198,204,19,241,587,1249,29,323
768,116,14,249,441,1588,299,216,11,270,717,1513,29,324
729,121,6,316,467,1639,287,230,9,263,742,1531,29,325
692,153,3,298,512,1658,311,262,10,295,693,1571,29,326
462,148,10,300,425,1345,195,256,29,283,474,1237,29,327
69,147,8,394,367,985,43,291,26,256,272,888,29,328
56,83,2,283,208,632,25,152,3,208,242,630,29,329
524,87,2,263,328,1204,187,162,12,237,511,1109,29,330
553,125,3,326,380,1387,189,216,6,291,549,1251,29,331
398,123,17,424,347,1309,183,192,27,367,367,1136,29,332
70,66,7,126,104,373,20,68,7,135,139,369,29,333
171,114,6,364,223,878,79,195,18,203,404,899,29,334
62,118,13,314,215,722,33,193,14,222,261,723,29,335
54,59,1,253,192,559,34,170,9,236,217,666,29,336
541,68,3,232,310,1154,215,202,12,224,537,1190,29,337
728,142,4,255,391,1520,275,269,9,276,702,1531,29,338
724,112,3,267,436,1542,287,220,7,276,673,1463,29,339
640,137,2,271,470,1520,278,256,7,224,668,1433,29,340
450,148,9,276,390,1273,188,231,29,263,509,1220,29,341
75,167,5,414,415,1076,59,324,18,301,281,983,29,342
84,89,4,345,242,764,27,235,12,241,314,829,29,343
642,114,2,272,348,1378,200,238,10,286,694,1428,29,344
881,156,6,320,446,1809,293,346,11,283,825,1758,29,345
845,103,1,346,410,1705,288,299,9,277,718,1591,29,346
782,144,2,347,524,1799,302,291,18,291,732,1634,29,347
524,191,4,372,466,1557,176,293,43,296,540,1348,29,348
140,170,10,393,332,1045,39,321,37,256,297,950,29,349
64,85,1,262,198,610,19,185,6,210,233,653,29,350
559,78,2,273,301,1213,210,180,6,235,550,1181,29,351
700,133,6,309,454,1602,292,211,17,215,741,1476,29,352
673,89,4,369,452,1587,266,230,10,296,658,1460,29,353
612,101,1,297,457,1468,236,222,4,238,567,1267,29,354
417,140,4,255,347,1163,127,187,23,251,379,967,29,355
64,91,4,330,245,734,25,169,19,195,241,649,29,356
67,55,2,268,191,583,26,141,4,149,223,543,29,357
286,69,5,330,264,954,132,137,13,223,316,821,29,358
158,65,2,225,142,592,81,58,3,184,177,503,29,359
34,46,1,103,73,257,11,65,2,97,93,268,29,360
178,109,3,223,194,707,94,164,11,188,285,742,29,361
211,122,6,309,222,870,102,161,22,198,334,817,29,362
71,89,10,276,193,639,32,144,29,205,198,608,29,363
75,100,3,224,184,586,20,145,14,194,257,630,29,364
330,101,13,281,287,1012,137,158,24,249,414,982,29,365
304,157,56,336,254,1107,150,144,115,260,380,1049,29,366
61,287,8,428,508,1292,121,179,12,551,342,1205,30,1
364,797,26,1301,5110,7598,4285,254,27,2036,853,7455,30,2
426,1054,8,1417,5970,8875,5212,254,10,2490,1012,8978,30,3
435,1170,12,1558,5934,9109,5223,286,16,2538,1090,9153,30,4
314,1042,66,1399,3406,6227,2807,477,27,1978,1110,6399,30,5
79,405,48,651,537,1720,183,328,21,790,447,1769,30,6
86,340,13,618,795,1852,142,225,21,896,528,1812,30,7
486,1179,20,1515,5679,8879,4984,311,24,2325,1116,8760,30,8
558,1005,11,2242,6179,9995,6513,218,12,2511,845,10099,30,9
596,1623,16,1914,7653,11802,6802,284,16,3323,1366,11791,30,10
545,1607,9,1801,7449,11411,6291,621,11,3176,1273,11372,30,11
467,1070,76,1793,3840,7246,3429,441,53,2284,1287,7494,30,12
129,1019,117,1027,3765,6057,280,515,57,1731,1181,3764,30,13
78,435,10,885,862,2270,172,313,16,1089,712,2302,30,14
179,580,6,952,1036,2753,594,292,7,1273,653,2819,30,15
266,903,33,970,2326,4498,1930,279,27,1530,805,4571,30,16
505,1742,21,1552,6643,10463,5494,272,22,3381,1328,10497,30,17
585,1912,25,1897,7823,12242,6758,533,19,3399,1532,12241,30,18
286,1254,90,1306,2149,5085,1754,567,41,1741,1223,5326,30,19
128,774,90,988,998,2978,266,443,39,1274,935,2957,30,20
70,471,15,757,780,2093,146,196,21,1008,651,2022,30,21
543,1406,20,1452,6058,9479,5232,263,13,2664,1272,9444,30,22
614,1866,18,1760,8628,12886,7802,322,14,3438,1499,13075,30,23
596,2000,8,1822,8511,12937,7353,473,12,3517,1476,12831,30,24
552,1988,35,1861,7563,11999,6627,512,28,3301,1581,12049,30,25
440,1536,182,1820,3974,7952,3465,579,86,2480,1590,8200,30,26
113,910,145,1047,1167,3382,302,565,41,1342,1069,3319,30,27
80,468,19,729,713,2009,148,215,25,952,586,1926,30,28
462,1431,14,1544,5995,9446,5316,224,15,2585,1251,9391,30,29
597,1848,29,1735,8597,12806,7770,333,30,3472,1508,13113,30,30
608,1935,17,1889,8220,12669,7217,384,18,3509,1533,12661,30,31
582,1882,24,1798,7459,11745,6576,442,22,3579,1405,12024,30,32
418,1401,184,1710,3921,7634,3490,695,44,2301,1418,7948,30,33
96,593,101,884,1016,2690,282,429,47,1143,769,2670,30,34
91,399,8,634,805,1937,188,205,19,903,583,1898,30,35
515,1344,37,1632,6072,9600,5464,299,36,2512,1221,9532,30,36
595,1895,44,1813,8590,12937,7761,385,49,3285,1531,13011,30,37
626,1932,18,1907,8154,12637,7315,381,23,3401,1471,12591,30,38
582,1778,27,1988,7536,11911,6825,415,27,3250,1571,12088,30,39
443,1317,124,1791,3890,7565,3552,635,57,2350,1305,7899,30,40
116,917,123,1117,1246,3519,260,618,54,1516,1047,3495,30,41
83,453,14,759,834,2143,152,307,22,856,711,2048,30,42
457,1541,29,1608,5947,9582,5247,301,26,2540,1383,9497,30,43
565,1761,48,1752,7616,11742,6703,404,50,3200,1538,11895,30,44
679,1700,32,2029,8295,12735,7170,506,32,3589,1597,12894,30,45
555,1871,24,1808,7653,11911,6741,411,33,3312,1527,12024,30,46
389,1145,139,1745,3653,7071,3215,558,57,2149,1257,7236,30,47
135,729,97,1063,1179,3203,292,547,52,1386,996,3273,30,48
94,582,19,860,973,2528,171,343,17,1124,755,2410,30,49
264,605,21,1091,1511,3492,966,291,21,1302,768,3348,30,50
570,1726,16,1896,8209,12417,7507,353,15,3250,1296,12421,30,51
584,1949,36,1985,8164,12718,7406,333,42,3579,1505,12865,30,52
577,1907,25,1880,7469,11858,6768,477,30,3257,1553,12085,30,53
434,1302,152,1743,4035,7666,3573,618,86,2198,1412,7887,30,54
147,937,112,993,1284,3473,326,619,41,1391,995,3372,30,55
105,421,14,768,944,2252,201,264,15,1022,616,2118,30,56
605,1403,16,1675,6096,9795,5527,331,19,2585,1306,9768,30,57
615,1810,23,1968,8539,12955,7879,365,24,3348,1470,13086,30,58
600,1889,54,1944,8038,12525,7318,324,56,3407,1456,12561,30,59
586,1936,30,2018,7600,12170,6977,440,21,3395,1551,12384,30,60
393,1535,150,1856,4224,8158,3675,844,61,2446,1586,8612,30,61
92,965,100,974,1039,3170,245,631,52,1236,1203,3367,30,62
118,563,33,919,1069,2702,235,325,32,1264,734,2590,30,63
513,1429,27,1652,6102,9723,5519,280,22,2631,1348,9800,30,64
607,1881,16,1932,8657,13093,7837,359,17,3439,1491,13143,30,65
579,2062,14,2003,8224,12882,7561,419,11,3387,1591,12969,30,66
572,2299,25,2115,7643,12654,6924,560,28,3543,1874,12929,30,67
446,1607,155,1993,4230,8431,3564,706,53,2504,1551,8378,30,68
124,666,99,998,968,2855,245,511,69,1249,733,2807,30,69
157,491,27,811,943,2429,213,305,26,1145,725,2414,30,70
511,1485,35,1738,5874,9643,5199,342,36,2741,1317,9635,30,71
636,2118,29,1940,8541,13264,7348,481,25,3836,1723,13413,30,72
613,2131,15,2162,8255,13176,7178,524,18,3951,1717,13388,30,73
559,2180,20,2239,7588,12586,6675,532,40,3645,1839,12731,30,74
435,1434,97,1946,4230,8142,3417,670,73,2686,1619,8465,30,75
201,1548,131,1403,1649,4932,476,817,87,2110,1581,5071,30,76
120,667,7,995,1305,3094,213,366,11,1414,776,2780,30,77
553,1613,20,1894,6180,10260,5473,363,14,2920,1493,10263,30,78
647,2162,14,2056,8803,13682,7807,476,8,3706,1716,13713,30,79
651,2499,26,2088,8308,13572,7362,522,24,3831,1991,13730,30,80
596,2270,58,2116,7826,12866,6783,564,36,3758,1914,13055,30,81
439,1581,140,2107,4474,8741,3596,741,70,2780,1743,8930,30,82
124,1054,119,1062,1445,3804,291,759,48,1422,1285,3805,30,83
119,819,12,1367,1937,4254,304,408,13,1961,1028,3714,30,84
545,1635,11,2016,6300,10507,5021,469,25,3208,1731,10454,30,85
647,2064,13,2144,8471,13339,7179,534,8,3739,1870,13330,30,86
620,1954,20,2215,7705,12514,6769,553,15,3398,1666,12401,30,87
631,1996,32,2129,6947,11735,5799,582,31,3562,1779,11753,30,88
449,1654,150,2404,4217,8874,2871,934,54,3063,2019,8941,30,89
175,1361,126,1860,2331,5853,387,713,50,2658,1298,5106,30,90
183,660,21,1277,1418,3559,295,447,23,1737,988,3490,30,91
489,1492,37,2018,5712,9748,4689,454,32,2846,1434,9455,30,92
644,1880,45,2185,8750,13504,7498,556,35,3882,1647,13618,30,93
630,2105,38,2054,8243,13070,7083,594,36,3368,1985,13066,30,94
650,2277,23,2245,8235,13430,6964,749,26,3973,1975,13687,30,95
463,1654,127,2320,4698,9262,3625,832,56,3025,1860,9398,30,96
203,1006,155,1589,1665,4618,387,777,62,2051,1343,4620,30,97
203,813,21,1448,1329,3814,324,342,21,1572,955,3214,30,98
488,1609,21,1867,5861,9846,5294,356,33,2800,1347,9830,30,99
628,2036,22,2264,8490,13440,7547,512,23,3715,1684,13481,30,100
623,2229,74,2217,8141,13284,7272,470,68,3733,1846,13389,30,101
609,2165,33,2349,7868,13024,7128,487,24,3631,1815,13085,30,102
466,1591,123,2056,4676,8912,3694,793,62,2728,1794,9071,30,103
180,1357,183,1385,1782,4887,495,1010,89,1932,1427,4953,30,104
153,750,15,1238,1369,3525,257,364,21,1669,977,3288,30,105
495,1828,13,1965,6312,10613,5730,490,6,3032,1532,10790,30,106
631,2496,50,2210,8510,13897,7765,489,55,3947,1776,14032,30,107
617,2743,21,2396,8362,14139,7866,535,18,3983,1917,14319,30,108
664,2611,15,2387,7715,13392,7022,600,15,3899,1934,13470,30,109
484,1737,116,2364,4706,9407,4097,764,40,3001,1494,9396,30,110
167,1314,171,1407,1742,4801,469,864,66,2019,1501,4919,30,111
111,621,10,1055,1152,2949,224,300,12,1460,786,2782,30,112
497,1467,11,1700,5976,9651,5335,379,9,2603,1300,9626,30,113
631,1988,23,2073,8737,13452,6776,496,21,3413,1635,12341,30,114
646,2406,67,2248,8305,13672,7642,718,39,3823,1836,14058,30,115
645,2621,33,2596,8215,14110,7382,713,25,3801,2235,14156,30,116
461,1810,200,2089,4524,9084,3723,917,50,2847,1949,9486,30,117
205,1255,142,1267,1301,4170,371,659,83,1757,1358,4228,30,118
142,868,30,993,1322,3355,232,471,25,1593,1046,3367,30,119
514,1678,27,1909,6099,10227,5545,459,24,2800,1447,10275,30,120
663,2023,30,2129,8582,13427,7748,482,28,3720,1631,13609,30,121
656,2176,15,2303,8468,13618,7388,485,17,3789,1835,13514,30,122
653,2207,34,2337,7893,13124,7066,576,28,3611,1619,12900,30,123
429,1688,76,2156,4294,8643,3731,772,50,2679,1771,9003,30,124
159,985,72,1483,1849,4548,367,595,39,2107,1291,4399,30,125
108,566,12,910,961,2557,207,295,17,1312,865,2696,30,126
594,1594,16,1799,6019,10022,5342,378,13,2862,1396,9991,30,127
642,2147,25,2120,8671,13605,7721,577,31,3773,1662,13764,30,128
696,2184,39,2298,8233,13450,7566,566,43,3650,1728,13553,30,129
624,2265,42,2309,7599,12839,6719,534,36,3662,1796,12747,30,130
471,1318,103,2095,4247,8234,3664,567,38,2336,1518,8123,30,131
175,891,106,1591,1738,4501,393,524,53,1996,1278,4244,30,132
117,644,26,1146,1344,3277,261,333,26,1358,759,2737,30,133
544,1674,23,2065,6394,10700,5719,443,22,3049,1503,10736,30,134
642,1884,14,2255,8745,13540,7900,426,15,3798,1562,13701,30,135
676,2243,26,2263,8370,13578,7522,538,22,3921,1655,13658,30,136
590,2380,16,2321,7800,13107,6971,598,17,3856,1854,13296,30,137
456,1511,129,2201,4537,8834,3779,736,43,2691,1630,8879,30,138
150,911,105,1320,1157,3643,422,596,67,1366,967,3418,30,139
90,711,15,986,1189,2991,233,320,12,1365,786,2716,30,140
604,1691,31,1913,6492,10731,5691,449,31,3039,1550,10760,30,141
671,2206,49,2296,8955,14177,8116,500,37,3709,1780,14142,30,142
717,2180,31,2469,8443,13840,7650,480,30,3812,1964,13936,30,143
637,2129,42,2226,7319,12353,6702,496,40,3427,1704,12369,30,144
468,1448,117,2388,3600,8021,3296,798,41,2634,1455,8224,30,145
191,972,94,1216,1281,3754,357,694,55,1601,1154,3861,30,146
149,818,25,1128,1149,3269,207,529,26,1542,945,3249,30,147
143,552,10,1039,1032,2776,307,358,14,1181,702,2562,30,148
576,2027,14,2107,8137,12861,7216,479,16,3347,1651,12709,30,149
640,1973,47,2214,8300,13174,7643,536,41,3596,1563,13379,30,150
711,2354,32,2162,7622,12881,7156,633,36,3581,1837,13243,30,151
502,1375,116,2293,4242,8528,4009,617,71,2496,1941,9134,30,152
158,1211,140,1104,1098,3711,320,769,46,1457,1220,3812,30,153
132,687,31,995,965,2810,177,366,39,1247,800,2629,30,154
689,1516,25,1949,6426,10605,5816,416,29,2846,1398,10505,30,155
736,2128,24,2228,8638,13754,7720,578,19,3487,1694,13498,30,156
758,2225,22,2266,8212,13483,7318,613,19,3870,1821,13641,30,157
754,2221,25,2221,7603,12824,6896,687,34,3563,1810,12990,30,158
515,1488,176,2181,4419,8779,3648,943,59,2679,1748,9077,30,159
234,2785,235,1953,4118,9325,470,1148,73,4216,2555,8462,30,160
141,774,16,1262,1205,3398,189,490,21,1470,1084,3254,30,161
679,1631,17,1980,6452,10759,5903,403,19,2841,1720,10886,30,162
783,2172,17,2229,8605,13806,7780,469,18,3689,1811,13767,30,163
751,2108,33,2250,8176,13318,7472,547,30,3676,1725,13450,30,164
664,2343,22,2197,7342,12568,6823,586,13,3514,1892,12828,30,165
495,1379,115,2160,4176,8325,3691,716,67,2514,1420,8408,30,166
173,938,129,1160,1336,3736,349,698,50,1530,1030,3657,30,167
142,632,11,1009,942,2736,205,339,15,1288,742,2589,30,168
558,1501,6,1765,6091,9921,5581,361,4,2748,1470,10164,30,169
720,2120,34,2208,8162,13244,7540,595,42,3446,1666,13289,30,170
316,920,8,1552,2022,4818,1276,539,13,1886,1144,4858,30,171
698,2110,8,2143,7154,12113,6568,592,11,3260,1838,12269,30,172
539,1451,154,1918,3883,7945,3511,728,53,2280,1436,8008,30,173
132,957,123,1103,1037,3352,350,674,46,1327,900,3297,30,174
117,550,16,931,898,2512,223,316,15,1082,675,2311,30,175
596,1622,8,1838,6101,10165,5479,380,10,2660,1468,9997,30,176
782,2150,26,2107,8422,13487,7751,471,30,3383,1679,13314,30,177
755,2259,35,2110,7755,12914,7276,489,37,3324,1784,12910,30,178
681,2248,30,2099,7384,12442,6665,753,28,3423,1822,12691,30,179
534,1373,113,2048,4028,8096,3382,765,28,2667,1613,8455,30,180
151,1028,160,1163,1325,3827,350,722,50,1612,1102,3836,30,181
148,569,9,997,853,2576,210,441,17,1641,885,3194,30,182
723,1329,7,1719,5840,9618,5170,423,7,2468,1566,9634,30,183
747,1800,16,1957,7518,12038,6532,558,15,3392,1544,12041,30,184
628,1532,43,2478,5680,10361,5072,732,36,3053,1516,10409,30,185
190,4462,28,1289,1314,7283,291,3404,36,1646,1915,7292,30,186
408,1153,79,1836,2280,5756,1559,805,34,2031,1291,5720,30,187
168,958,118,1073,1016,3333,286,658,78,1415,947,3384,30,188
144,616,11,871,880,2522,215,346,9,1172,699,2441,30,189
574,1468,14,1794,6014,9864,5339,389,15,2672,1266,9681,30,190
789,2137,27,2315,8085,13353,7043,562,25,3575,1806,13011,30,191
801,2032,20,2274,7881,13008,6735,618,21,3383,1776,12533,30,192
764,2174,23,2408,7153,12522,6337,611,25,3558,1831,12362,30,193
445,1366,105,1943,3959,7818,3432,641,52,2309,1373,7807,30,194
152,958,141,1202,1228,3681,367,753,53,1669,1157,3999,30,195
142,673,22,1029,900,2766,214,434,27,1260,830,2765,30,196
698,1392,21,1792,6025,9928,5461,403,18,2587,1313,9782,30,197
776,1888,27,1970,7796,12457,7115,515,25,3092,1598,12345,30,198
739,1840,6,2024,7564,12173,6931,413,5,3316,1573,12238,30,199
754,2200,12,2018,7118,12102,6424,617,14,3316,1866,12237,30,200
524,1407,138,1951,3866,7886,3319,726,73,2370,1420,7908,30,201
156,958,132,1186,1334,3766,347,761,46,1647,1081,3882,30,202
141,662,16,1137,1028,2984,236,388,12,1340,848,2824,30,203
574,1441,8,1770,5779,9572,5196,470,9,2669,1384,9728,30,204
738,2014,9,2059,8105,12925,7025,545,8,3636,1735,12949,30,205
707,1970,4,2342,7733,12756,6650,584,4,3777,1801,12816,30,206
667,2121,8,2260,6944,12000,6093,700,10,3491,1834,12128,30,207
555,1337,126,2180,3864,8062,3374,701,60,2488,1398,8021,30,208
189,994,129,1222,1374,3908,342,703,101,1591,1222,3959,30,209
135,644,6,1080,1018,2883,212,434,35,1307,845,2833,30,210
592,1260,21,1786,5806,9465,5004,457,31,2599,1452,9543,30,211
693,1932,39,1978,7837,12479,6726,443,44,3474,1689,12376,30,212
708,1942,33,1956,6895,11534,5429,497,28,3744,1568,11266,30,213
587,1873,18,1965,6694,11137,5925,600,15,3093,1574,11207,30,214
511,1345,128,1827,3656,7467,3182,724,59,2126,1377,7468,30,215
191,742,158,1230,1096,3417,332,546,40,1540,1043,3501,30,216
147,554,8,952,997,2658,241,311,12,1296,750,2610,30,217
517,1304,12,1787,5242,8862,4718,436,12,2369,1291,8826,30,218
631,1586,8,1984,7183,11392,6403,435,8,3121,1379,11346,30,219
611,1636,15,2008,6980,11250,6119,419,12,3041,1446,11037,30,220
514,1400,11,1774,5964,9663,5215,423,14,2766,1308,9726,30,221
396,1053,116,1532,3007,6104,2372,547,61,1788,1097,5865,30,222
138,831,108,1080,1158,3315,341,607,53,1532,926,3459,30,223
125,614,14,899,924,2576,205,313,14,1116,772,2420,30,224
531,1230,20,1610,5092,8483,4546,331,19,2382,1204,8482,30,225
600,1609,12,1866,6961,11048,6151,407,10,2950,1496,11014,30,226
579,1702,17,1870,6617,10785,5777,451,14,3063,1539,10844,30,227
531,1705,24,1881,6021,10162,5366,470,17,2926,1535,10314,30,228
387,1304,105,1775,3370,6941,3011,631,38,2163,1291,7134,30,229
150,963,131,1023,1143,3410,307,624,62,1517,1053,3563,30,230
113,558,21,877,953,2522,203,317,26,1142,787,2475,30,231
497,1234,22,1628,5175,8556,4424,360,22,2289,1272,8367,30,232
603,1575,13,1830,7067,11088,6173,484,13,3125,1435,11230,30,233
546,1635,27,1932,6583,10723,5656,506,31,3152,1553,10898,30,234
503,1820,13,1952,5819,10107,5203,570,18,2973,1516,10280,30,235
413,1355,127,1839,3412,7146,2840,677,48,2257,1378,7200,30,236
155,952,99,1082,1082,3370,342,639,43,1324,1097,3445,30,237
113,540,16,950,969,2588,193,269,18,1314,693,2487,30,238
486,1233,20,1620,5634,8993,4794,350,16,2630,1220,9010,30,239
619,1683,12,1940,7672,11926,6833,408,13,3210,1463,11927,30,240
632,1651,18,1976,7031,11308,6320,462,25,2994,1476,11277,30,241
548,1409,8,2031,6564,10560,5600,428,6,2953,1423,10410,30,242
404,1132,119,2113,3195,6963,2777,694,55,2175,1282,6983,30,243
142,832,115,1198,1194,3481,305,633,34,1554,1001,3527,30,244
149,733,25,1052,1183,3142,238,488,27,1304,1007,3064,30,245
120,544,39,947,915,2565,245,304,39,1115,633,2336,30,246
553,1675,52,1930,8065,12275,7389,306,37,3199,1384,12315,30,247
615,1904,29,2056,8127,12731,7406,386,20,3310,1544,12666,30,248
588,2000,45,2063,7708,12404,6974,495,28,3349,1813,12659,30,249
466,1421,163,1954,4145,8149,3680,705,44,2429,1386,8244,30,250
140,954,168,1215,1270,3747,431,737,61,1680,979,3888,30,251
111,578,22,1025,1071,2807,213,246,20,1353,721,2553,30,252
528,1667,44,1835,6598,10672,5925,343,36,2800,1531,10635,30,253
644,2162,43,2224,9010,14083,8288,508,39,3620,1696,14151,30,254
713,2179,17,2124,8854,13887,7742,532,18,3749,1810,13851,30,255
674,2293,13,2271,8140,13391,7208,539,21,3679,1964,13411,30,256
541,1698,162,2180,4582,9163,3848,883,66,2648,1677,9122,30,257
149,1090,194,1299,1514,4246,378,862,73,1663,1100,4076,30,258
137,661,25,1080,1138,3041,273,336,29,1348,806,2792,30,259
571,1815,5,1834,6831,11056,6014,364,5,2956,1616,10955,30,260
748,2120,12,2227,9449,14556,8512,386,11,3721,1785,14415,30,261
675,2293,23,2139,8600,13730,7056,493,22,4253,1760,13584,30,262
735,2642,16,2312,8014,13719,7430,674,27,3709,1884,13724,30,263
534,1582,154,2223,4586,9079,3961,817,71,2776,1681,9306,30,264
198,1024,178,1302,1398,4100,347,809,52,1724,1206,4138,30,265
131,557,30,1009,1101,2828,226,339,33,1328,781,2707,30,266
591,1531,17,1810,6542,10491,5896,394,18,2852,1443,10603,30,267
753,2151,18,2198,9363,14483,8304,495,14,3807,1908,14528,30,268
763,2023,21,2119,8772,13698,7528,442,17,3929,1728,13644,30,269
716,2161,21,2158,7992,13048,6762,588,24,3853,1812,13039,30,270
595,1489,132,2060,4369,8645,3754,711,44,2614,1624,8747,30,271
192,1210,187,1366,1575,4530,460,812,111,1799,1264,4446,30,272
116,550,24,1020,1063,2773,253,317,30,1349,829,2778,30,273
565,1632,15,1904,6752,10868,5987,336,19,3050,1525,10917,30,274
714,1998,5,2158,9227,14102,8192,411,9,4021,1669,14302,30,275
707,2071,9,2273,8813,13873,7714,442,10,3993,1688,13847,30,276
662,2318,21,2128,7703,12832,6590,659,20,3806,1915,12990,30,277
569,1540,137,2214,4388,8848,3816,734,61,2799,1707,9117,30,278
188,1454,129,1313,1830,4914,374,801,87,1966,1862,5090,30,279
148,670,14,1121,1255,3208,357,318,23,1606,779,3083,30,280
626,1790,10,1981,6834,11241,5999,365,11,3061,1708,11144,30,281
706,2356,10,2329,9509,14910,8609,522,14,3861,1830,14836,30,282
761,2342,20,2370,9225,14718,8089,480,28,3986,1809,14392,30,283
721,2349,25,2433,8148,13676,7406,689,19,3746,1924,13784,30,284
571,1529,162,2310,4343,8915,3637,738,47,2857,1777,9056,30,285
190,1196,169,1704,1924,5183,439,873,64,2067,1208,4651,30,286
216,789,37,1515,1698,4255,310,465,40,1775,963,3553,30,287
354,1134,14,1609,3236,6347,2461,375,11,2286,1151,6284,30,288
665,2324,51,2199,9577,14816,8395,626,42,4017,1967,15047,30,289
754,2447,34,2312,9301,14848,8029,476,32,4464,1986,14987,30,290
625,2608,15,2370,8397,14015,7403,701,24,4126,1954,14208,30,291
524,1748,237,2276,4934,9719,4021,911,69,2970,1804,9775,30,292
192,1307,213,1342,1667,4721,423,1000,69,2078,1282,4852,30,293
128,750,20,1164,1368,3430,340,358,30,1698,883,3309,30,294
603,2036,32,2011,7068,11750,6346,363,27,3248,1684,11668,30,295
700,2648,30,2312,9787,15477,9063,432,31,4213,1994,15733,30,296
680,2702,35,2358,9464,15239,8642,673,26,4290,1976,15607,30,297
666,2911,34,2518,8769,14898,8060,678,24,4258,2031,15051,30,298
571,1913,161,2405,5223,10273,4640,726,43,3287,1845,10541,30,299
201,2279,191,1659,1856,6186,640,904,70,2235,2040,5889,30,300
233,745,23,1192,1396,3589,471,389,25,1739,936,3560,30,301
634,1697,44,1938,7029,11342,6013,355,42,3333,1597,11340,30,302
722,6773,50,2635,8726,18906,8141,726,41,4389,6687,19984,30,303
808,2564,15,2529,9583,15499,8253,530,21,4409,2070,15283,30,304
664,1972,32,2461,7867,12996,6837,1319,30,3620,1508,13314,30,305
522,1542,150,2131,4491,8836,3633,804,65,2864,1679,9045,30,306
141,1187,169,1245,1735,4477,420,791,75,1716,1294,4296,30,307
139,587,4,1075,1224,3029,281,326,8,1470,812,2897,30,308
618,1496,6,2011,6835,10966,6103,354,12,2931,1480,10880,30,309
566,1593,67,2308,6689,11223,5988,563,61,3273,1480,11365,30,310
610,1619,39,2103,7028,11399,5935,394,34,3376,1496,11235,30,311
669,2146,8,2324,8127,13274,7279,498,10,3685,1776,13248,30,312
513,1439,136,2181,4637,8906,3959,731,41,2644,1664,9039,30,313
159,1014,102,1364,1457,4096,382,610,33,1935,1248,4208,30,314
142,583,17,961,1090,2793,323,289,18,1333,790,2753,30,315
347,1210,23,1683,4211,7474,3320,322,14,2596,1097,7349,30,316
711,2193,9,2307,9702,14922,8692,368,10,3828,1848,14746,30,317
735,2271,13,2330,9650,14999,8458,514,13,4099,1922,15006,30,318
714,2176,8,2371,8777,14046,7642,501,10,3946,1851,13950,30,319
566,1477,126,2308,4830,9307,4047,723,56,2783,1686,9295,30,320
158,922,136,1156,1440,3812,358,565,56,1593,1079,3651,30,321
112,535,12,958,1112,2729,232,299,16,1261,708,2516,30,322
624,1650,12,2055,6989,11330,6147,355,16,3128,1628,11274,30,323
703,2271,19,2411,9779,15183,8794,361,12,4359,1892,15418,30,324
736,2160,35,2442,9393,14766,8268,452,29,4310,1875,14934,30,325
718,2300,25,2527,8765,14335,7784,766,19,3987,1864,14420,30,326
582,1389,136,2267,4497,8871,4091,737,51,2491,1393,8763,30,327
148,837,142,1104,1492,3723,327,595,52,1457,1049,3480,30,328
105,508,9,896,1079,2597,181,262,12,1138,701,2294,30,329
549,1309,24,2012,6024,9918,5246,353,19,2855,1232,9705,30,330
526,1431,10,2114,6557,10638,5421,348,3,3206,1383,10361,30,331
410,878,15,2421,2962,6686,2893,352,18,2216,1080,6559,30,332
78,214,31,479,416,1218,120,231,27,527,351,1256,30,333
220,690,48,958,1393,3309,746,334,28,1417,845,3370,30,334
106,562,60,794,1039,2561,266,401,36,1144,729,2576,30,335
80,452,30,731,825,2118,185,299,27,989,634,2134,30,336
591,1415,15,1755,6418,10194,5775,310,16,2823,1402,10326,30,337
654,1999,15,2096,9354,14118,8249,497,11,3780,1685,14222,30,338
726,2228,14,2333,8937,14238,7920,446,14,4074,1913,14367,30,339
677,2632,22,2423,8859,14613,7064,546,21,4064,2398,14093,30,340
576,1653,172,2143,4759,9303,4036,642,42,2633,1692,9045,30,341
144,1183,138,1315,1726,4506,359,821,47,1845,1358,4430,30,342
117,695,9,1057,1412,3290,267,403,13,1524,919,3126,30,343
566,1822,18,1887,6838,11131,6061,458,16,3030,1490,11055,30,344
761,2501,22,2333,9860,15477,8720,549,27,4265,1899,15460,30,345
779,2509,14,2275,8926,14503,8136,512,7,4148,1874,14677,30,346
715,2800,34,2626,8727,14902,7615,742,34,4441,2267,15099,30,347
583,1799,137,2561,4841,9921,4093,767,48,3178,1964,10050,30,348
163,1511,174,1398,1695,4941,395,1245,72,1785,1469,4966,30,349
140,572,21,1013,1071,2817,270,321,25,1297,692,2605,30,350
527,1591,54,1968,6535,10675,5708,286,54,2982,1489,10519,30,351
610,2035,39,2367,8844,13895,7541,410,45,4217,2429,14642,30,352
656,1973,18,2314,7993,12954,7002,475,20,3932,1758,13187,30,353
618,2042,13,2273,7195,12141,6185,518,17,3866,1709,12295,30,354
746,1737,129,2722,5947,11281,4483,864,51,3061,2064,10523,30,355
174,960,107,1270,1644,4155,433,588,42,1777,1243,4083,30,356
118,636,6,985,1272,3017,289,421,12,1317,855,2894,30,357
513,1051,15,2318,4274,8171,3282,399,11,2538,1507,7737,30,358
352,554,10,1626,1652,4194,1596,280,11,1428,803,4118,30,359
88,298,7,391,568,1352,124,234,11,575,441,1385,30,360
395,1022,7,1449,2961,5834,1989,511,8,1988,1324,5820,30,361
486,1212,60,1917,3216,6891,2129,566,32,2289,1633,6649,30,362
189,819,74,1181,1228,3491,360,638,41,1498,1188,3725,30,363
149,660,36,1267,1372,3484,313,388,47,1550,930,3228,30,364
458,1070,16,1925,3656,7125,2785,474,13,2525,1484,7281,30,365
300,746,471,1801,2105,5423,2024,657,223,1637,1100,5641,30,366
109,211,8,601,473,1402,105,168,7,531,376,1187,31,1
545,684,7,1417,5289,7942,4848,244,10,1813,896,7811,31,2
603,859,8,1536,6075,9081,5509,251,10,2156,1112,9038,31,3
640,919,5,1706,5874,9144,5392,288,6,2245,1148,9079,31,4
442,939,74,1501,3376,6332,2964,407,28,1675,1285,6359,31,5
149,364,43,697,470,1723,184,257,19,799,520,1779,31,6
98,296,11,703,568,1676,125,261,17,824,542,1769,31,7
594,859,6,1381,5569,8409,5187,255,9,1956,1129,8536,31,8
800,892,6,2148,6373,10219,6565,210,6,2416,938,10135,31,9
826,1438,19,1903,7357,11543,6758,384,13,2926,1386,11467,31,10
780,1392,6,1863,6953,10994,6315,419,12,2844,1413,11003,31,11
492,572,28,1370,2473,4935,2139,240,13,1376,734,4502,31,12
146,456,30,715,2622,3969,183,256,17,710,670,1836,31,13
96,207,4,473,450,1230,92,113,8,484,416,1113,31,14
167,292,6,627,533,1625,373,148,14,518,342,1395,31,15
322,576,12,892,1931,3733,1772,207,12,1215,624,3830,31,16
647,1374,11,1479,6538,10049,5421,344,14,2946,1330,10055,31,17
746,1613,13,1881,7167,11420,6475,378,19,3031,1432,11335,31,18
315,1163,78,1323,2060,4939,1684,454,43,1523,1028,4732,31,19
120,696,71,892,948,2727,189,430,31,1092,962,2704,31,20
87,326,13,760,605,1791,158,217,14,791,621,1801,31,21
607,993,13,1402,5684,8699,5238,228,21,2296,1085,8868,31,22
846,1439,13,1699,8092,12089,7510,317,11,2955,1440,12233,31,23
847,1596,9,1880,7723,12055,7216,388,17,2975,1658,12254,31,24
764,1710,17,1770,6798,11059,6388,371,16,2889,1587,11251,31,25
521,1332,113,1803,3740,7509,3444,594,57,2048,1525,7668,31,26
135,837,77,1025,1135,3209,242,526,46,1264,1201,3279,31,27
68,383,6,806,604,1867,124,192,12,790,621,1739,31,28
638,1131,4,1481,5786,9040,5436,311,8,2175,1161,9091,31,29
901,1536,8,1745,8058,12248,7634,326,10,2966,1549,12485,31,30
834,1588,12,1782,7737,11953,7052,329,10,3124,1569,12084,31,31
840,1570,20,1824,7013,11267,6566,394,16,3007,1470,11453,31,32
529,1368,79,1624,3660,7260,3424,594,44,1894,1420,7376,31,33
153,681,70,1080,1012,2996,240,476,37,1253,1043,3049,31,34
125,336,4,838,757,2060,153,220,8,985,647,2013,31,35
652,1068,17,1481,5751,8969,5329,266,12,2253,1190,9050,31,36
869,1433,8,1778,7926,12014,7537,298,9,3031,1538,12413,31,37
831,1547,14,1859,7540,11791,6831,305,18,3296,1537,11987,31,38
778,1585,5,1789,7040,11197,6502,413,7,2858,1547,11327,31,39
496,1107,108,1713,3678,7102,3444,556,29,1981,1310,7320,31,40
118,712,80,902,1026,2838,223,431,33,1058,884,2629,31,41
87,307,7,619,524,1544,143,210,23,611,483,1470,31,42
557,1080,12,1487,5710,8846,5089,289,12,2233,1192,8815,31,43
783,1355,13,1701,7104,10956,6518,326,9,2687,1454,10994,31,44
811,1387,9,1862,7582,11651,5933,497,12,3536,1478,11456,31,45
811,1521,19,1847,6787,10985,6389,362,12,2855,1495,11113,31,46
497,1073,62,1762,3542,6936,3156,470,49,2002,1189,6866,31,47
124,556,59,1019,822,2580,166,343,48,1008,897,2462,31,48
110,366,7,935,724,2142,108,224,13,754,632,1731,31,49
262,483,6,1159,1279,3189,866,251,9,1120,823,3069,31,50
797,1359,16,1756,7868,11796,7322,286,18,2968,1441,12035,31,51
806,1589,12,1854,7757,12018,7275,357,13,3016,1636,12297,31,52
807,1722,16,1904,7212,11661,6684,445,13,2973,1628,11743,31,53
557,1167,75,1733,3882,7414,3495,600,62,1916,1351,7424,31,54
158,901,105,962,1195,3321,259,589,72,1220,1076,3216,31,55
132,344,10,924,765,2175,155,246,13,1025,656,2095,31,56
757,1164,4,1582,5867,9374,5568,303,6,2196,1232,9305,31,57
867,1539,9,1968,8235,12618,7811,318,9,3050,1542,12730,31,58
824,1548,8,1955,7741,12076,7177,324,12,2938,1526,11977,31,59
817,1726,6,1914,7081,11544,6548,440,12,3081,1607,11688,31,60
536,1463,85,1790,3833,7707,3580,653,50,1936,1518,7737,31,61
158,1005,96,1033,948,3240,227,617,31,1058,1105,3038,31,62
108,477,9,969,862,2425,163,295,12,1177,869,2516,31,63
687,1181,8,1572,5873,9321,5435,289,10,2415,1288,9437,31,64
857,1488,21,1829,8017,12212,7422,367,22,3083,1613,12507,31,65
847,1707,7,1995,7878,12434,7453,400,12,3001,1635,12501,31,66
838,1824,13,2042,7095,11812,6711,484,13,3105,1631,11944,31,67
599,1206,90,1933,4068,7896,3573,555,31,2192,1543,7894,31,68
176,614,45,1121,812,2768,247,448,21,1092,860,2668,31,69
140,396,9,846,901,2292,201,278,17,1055,823,2374,31,70
622,1127,17,1585,5636,8987,5154,363,17,2247,1306,9087,31,71
929,1673,8,2051,8144,12805,7165,432,11,3469,1799,12876,31,72
926,1760,9,2200,7735,12630,7108,477,8,3402,1842,12837,31,73
851,1851,18,2217,7169,12106,6413,507,15,3357,1948,12240,31,74
565,1268,71,2033,3929,7866,3361,573,40,2149,1610,7733,31,75
298,1662,86,1500,1580,5126,446,769,43,2058,1918,5234,31,76
169,599,12,1057,1125,2962,195,373,19,1232,928,2747,31,77
625,1268,3,1735,5878,9509,5258,331,6,2603,1423,9621,31,78
892,1773,16,2048,8247,12976,7618,426,13,3204,1758,13019,31,79
904,2081,5,2175,7954,13119,7349,594,5,3333,2064,13345,31,80
803,2039,5,2181,7457,12485,6665,500,13,3286,1960,12424,31,81
556,1452,99,2194,4300,8601,3602,688,40,2330,1780,8440,31,82
143,800,80,1095,1225,3343,275,611,25,1213,1231,3355,31,83
163,679,10,1553,1774,4179,236,413,13,1796,1189,3647,31,84
662,1293,19,2071,6120,10165,5167,378,21,2899,1506,9971,31,85
886,1683,24,2249,7881,12723,7143,405,34,3584,1872,13038,31,86
819,1632,48,2106,7140,11745,6549,413,55,2953,1752,11722,31,87
769,1748,21,2227,6428,11193,5686,497,19,3043,1833,11078,31,88
547,1321,95,2304,3598,7865,2833,778,39,2544,1820,8014,31,89
221,1148,60,1946,2327,5702,295,710,27,2040,1574,4646,31,90
157,509,18,1314,1225,3223,211,337,24,1260,1160,2992,31,91
596,1214,8,1897,5406,9121,4700,372,8,2553,1442,9075,31,92
869,1519,9,2153,8088,12638,7245,359,13,3314,1798,12729,31,93
822,1647,15,2135,7517,12136,6926,368,24,2818,1814,11950,31,94
884,1909,9,2438,7664,12904,6816,513,11,3291,2082,12713,31,95
625,1258,78,2234,4195,8390,3604,688,33,2527,1629,8481,31,96
196,854,77,1600,1370,4097,351,650,49,1703,1216,3969,31,97
232,505,5,1398,1042,3182,220,343,9,1480,867,2919,31,98
678,1261,8,1876,5541,9364,5236,352,19,2443,1393,9443,31,99
870,1549,13,1978,7982,12392,7470,428,10,3211,1710,12829,31,100
885,1814,13,2146,7664,12522,7273,397,10,3260,1979,12919,31,101
845,1879,18,2137,7369,12248,6618,506,13,3191,1815,12143,31,102
640,1278,67,1945,4023,7953,3689,620,34,2394,1534,8271,31,103
201,1130,105,1636,1416,4488,423,727,27,1773,1383,4333,31,104
108,562,6,1148,1073,2897,240,289,8,1419,943,2899,31,105
716,1413,13,1741,5997,9880,5569,333,16,2593,1410,9921,31,106
950,2114,16,2164,8379,13623,7751,521,19,3425,1993,13709,31,107
805,2651,11,2253,7774,13494,7502,594,12,3452,1984,13544,31,108
877,2521,13,2208,7430,13049,6938,574,16,3313,2068,12909,31,109
585,1457,102,2095,4552,8791,3936,669,41,2431,1488,8565,31,110
184,1020,88,1272,1461,4025,375,709,34,1654,1340,4112,31,111
145,437,27,1005,909,2523,197,273,19,1075,773,2337,31,112
643,1208,19,1634,5725,9229,5252,331,16,2517,1267,9383,31,113
878,1571,21,1998,8205,12673,7340,452,24,3487,1663,12966,31,114
912,1977,18,1970,7823,12700,7151,639,10,3359,1791,12950,31,115
861,2159,18,2399,7527,12964,6898,672,18,3222,2065,12875,31,116
604,1510,96,1865,4061,8136,3515,753,47,2222,1690,8227,31,117
253,991,100,1197,1143,3684,263,581,63,1317,1272,3496,31,118
131,693,6,1017,987,2834,162,475,30,1389,911,2967,31,119
716,1141,3,1645,5675,9180,5297,365,8,2418,1276,9364,31,120
964,1639,16,2042,7888,12549,7577,464,15,3102,1561,12719,31,121
936,1845,9,2124,7754,12668,7360,429,17,3177,1880,12863,31,122
854,1946,33,2123,7152,12108,6814,522,28,3129,1828,12321,31,123
581,1323,50,1993,3975,7922,3580,614,44,2216,1708,8162,31,124
198,922,73,1637,1933,4763,410,463,38,2597,1226,4734,31,125
144,432,8,987,787,2358,160,358,14,946,762,2240,31,126
670,1067,11,1625,5563,8936,5362,337,12,2346,1176,9233,31,127
853,1526,17,2056,8029,12481,7446,437,16,3285,1633,12817,31,128
931,1745,16,2171,7600,12463,7190,518,18,3233,1755,12714,31,129
840,1963,16,1987,6919,11725,6408,567,9,2970,1748,11702,31,130
552,1095,44,1947,3754,7392,3380,476,31,1991,1421,7299,31,131
183,581,49,1652,1921,4386,421,424,26,2008,1011,3890,31,132
130,428,4,1360,1038,2960,180,301,7,998,658,2144,31,133
676,1259,20,1746,5782,9483,5504,328,29,2463,1339,9663,31,134
890,1539,17,2102,8358,12906,7626,383,11,3195,1575,12790,31,135
926,1702,9,2151,7676,12464,7141,502,9,3320,1752,12724,31,136
863,2226,11,2102,7042,12244,6559,522,9,3006,1905,12001,31,137
569,1167,88,1995,3973,7792,3369,616,29,2220,1551,7785,31,138
146,733,95,1150,1006,3130,332,551,33,1278,915,3109,31,139
126,491,9,1124,905,2655,222,335,10,1414,775,2756,31,140
754,1210,6,1723,5799,9492,5353,451,7,2492,1381,9684,31,141
897,1737,14,2111,8116,12875,7677,503,11,3123,1627,12941,31,142
963,1782,10,2195,7799,12749,7291,439,10,3297,1808,12845,31,143
801,1739,5,2051,6659,11255,6242,421,7,2914,1613,11197,31,144
556,1140,69,2160,3186,7111,3053,559,35,2077,1383,7107,31,145
172,751,71,1317,953,3264,307,564,24,1442,1036,3373,31,146
141,612,11,1323,878,2965,195,407,16,1262,971,2851,31,147
186,429,5,1005,825,2450,197,248,9,975,731,2160,31,148
860,1415,19,1992,7447,11733,7078,365,23,2861,1652,11979,31,149
968,1525,4,2103,7678,12278,7314,457,7,3204,1697,12679,31,150
941,1876,12,1972,7039,11840,6710,495,19,2988,1732,11944,31,151
637,1162,97,1967,4027,7890,3640,585,47,2119,1493,7884,31,152
196,855,114,1178,1032,3375,347,630,39,1343,1085,3444,31,153
147,526,9,924,861,2467,167,371,16,1124,791,2469,31,154
845,1230,3,1866,6133,10077,5838,469,3,2452,1415,10177,31,155
1135,1718,11,2117,8572,13553,7970,528,10,3433,1943,13884,31,156
1080,1797,9,2280,7881,13047,7333,483,12,3315,1865,13008,31,157
1041,1862,16,2155,7245,12319,6836,704,11,3093,1929,12573,31,158
687,1290,95,2177,4093,8342,3583,791,31,2460,1595,8460,31,159
248,2600,209,1850,2913,7820,391,1246,40,3392,2335,7404,31,160
144,766,11,1154,873,2948,194,374,13,1260,1055,2896,31,161
891,1515,10,1711,6295,10422,5882,442,10,2543,1770,10647,31,162
1127,1863,15,2089,8471,13565,8017,536,7,3257,2031,13848,31,163
1165,2024,22,2180,7978,13369,7402,728,17,3389,2145,13681,31,164
1028,2256,38,2221,7232,12775,6904,550,26,3286,2218,12984,31,165
713,1128,105,2141,4040,8127,3608,814,41,2240,1528,8231,31,166
184,784,84,1203,1096,3351,329,624,60,1408,1096,3517,31,167
162,485,15,1023,771,2456,177,395,16,1093,817,2498,31,168
751,1215,13,1712,5945,9636,5575,406,14,2374,1389,9758,31,169
1105,1737,20,2359,7928,13149,7600,563,27,3249,1863,13302,31,170
401,815,23,1537,1561,4337,1178,500,23,1635,1083,4419,31,171
1024,1953,16,2141,6808,11942,6470,594,32,2971,1897,11964,31,172
649,1166,112,1950,3871,7748,3514,721,37,2095,1443,7810,31,173
191,933,77,1192,981,3374,317,956,72,1112,987,3444,31,174
176,403,14,896,658,2147,195,301,21,961,665,2143,31,175
824,1166,5,1581,5996,9572,5386,375,9,2432,1451,9653,31,176
1091,1752,26,1967,8212,13048,7652,527,24,3327,1873,13403,31,177
1138,1928,10,2214,7712,13002,6921,529,17,3512,2073,13052,31,178
1011,1966,10,2141,7135,12263,6685,610,13,3110,2093,12511,31,179
734,1210,107,2041,4031,8123,3622,671,51,2365,1595,8304,31,180
193,826,90,1314,1011,3434,300,606,27,1487,1040,3460,31,181
148,481,12,1161,778,2580,185,355,8,1136,737,2421,31,182
810,1125,34,1675,5946,9590,5285,496,35,2479,1440,9735,31,183
979,1480,15,2031,7411,11916,6670,507,9,3005,1705,11896,31,184
846,1236,11,2669,5491,10253,5156,746,15,2621,1646,10184,31,185
230,3888,14,1668,1328,7128,256,2421,13,1816,1686,6192,31,186
453,867,63,2073,2276,5732,1702,664,36,1826,1247,5475,31,187
242,680,70,1402,939,3333,269,628,29,1255,1014,3195,31,188
146,425,3,975,701,2250,176,319,4,990,715,2204,31,189
848,1186,12,1620,5947,9613,5339,430,20,2392,1374,9555,31,190
1152,1708,5,2194,7878,12937,7111,513,7,3331,1855,12817,31,191
1076,1744,27,2236,7548,12631,6871,508,36,3192,1968,12575,31,192
1065,1866,11,2258,7139,12339,6386,597,11,3290,2011,12295,31,193
615,1079,119,1823,3771,7407,3380,586,40,2040,1530,7576,31,194
204,836,111,1162,1279,3592,247,705,46,1510,1121,3629,31,195
189,476,18,1121,723,2527,200,353,12,1215,787,2567,31,196
822,1031,9,1647,5850,9359,5401,379,16,2181,1437,9414,31,197
1086,1447,20,1895,7575,12023,7028,516,20,2831,1788,12183,31,198
1084,1431,7,2098,7461,12081,7025,408,6,2981,1767,12187,31,199
1021,1843,9,2058,7060,11991,6368,670,12,3102,1864,12016,31,200
674,1077,74,1947,3821,7593,3336,713,77,2037,1409,7572,31,201
185,725,92,1338,1136,3476,312,667,23,1404,1062,3468,31,202
150,497,22,1104,832,2605,162,346,21,1264,835,2628,31,203
830,1093,19,1670,5720,9332,5210,448,27,2188,1433,9306,31,204
1076,1621,21,2161,8004,12883,7149,605,28,3249,1825,12856,31,205
947,1559,19,2222,7537,12284,6752,571,27,3156,1862,12368,31,206
966,1747,11,2176,6922,11822,6061,650,12,3112,1979,11814,31,207
758,1047,98,1961,3790,7654,3283,676,76,2181,1403,7619,31,208
203,904,117,1244,1250,3718,248,818,93,1450,1169,3778,31,209
137,525,4,1084,787,2537,160,361,5,1142,831,2499,31,210
807,977,14,1770,5706,9274,5157,412,21,2240,1448,9278,31,211
1043,1538,9,1943,7533,12066,6897,486,16,3054,1913,12366,31,212
1006,1597,3,2013,6968,11587,6504,499,6,2898,1764,11671,31,213
901,1611,16,2060,6470,11058,5992,632,25,2776,1781,11206,31,214
675,1028,78,1884,3429,7094,3320,710,41,1861,1302,7234,31,215
223,563,89,1150,1011,3036,217,506,35,1198,941,2897,31,216
143,399,11,944,770,2267,169,288,27,1067,738,2289,31,217
700,984,12,1498,5210,8404,4875,392,13,2103,1214,8597,31,218
923,1221,9,1965,7063,11181,6646,441,11,2903,1458,11459,31,219
902,1330,5,1986,6725,10948,6109,460,5,2828,1535,10937,31,220
765,1143,3,1754,5949,9614,5373,532,6,2426,1315,9652,31,221
414,847,71,1476,2832,5640,2540,551,54,1501,1043,5689,31,222
201,670,66,1188,1010,3135,280,587,21,1277,974,3139,31,223
155,401,2,964,786,2308,183,279,7,982,749,2200,31,224
669,888,4,1486,4974,8021,4743,331,6,2076,1106,8262,31,225
829,1325,7,1769,6713,10643,6345,407,5,2631,1474,10862,31,226
875,1480,18,1985,6438,10796,6034,446,22,2643,1632,10777,31,227
795,1497,10,1930,5869,10101,5475,548,9,2532,1607,10171,31,228
515,1070,104,1733,3388,6810,2987,667,19,1939,1285,6897,31,229
156,743,94,1116,1100,3209,272,621,30,1285,1207,3415,31,230
142,371,6,864,715,2098,168,301,13,932,685,2099,31,231
661,920,7,1582,5060,8230,4695,504,9,2077,1183,8468,31,232
797,1303,8,1849,6992,10949,6605,482,7,2650,1616,11360,31,233
857,1522,8,1941,6808,11136,6148,489,12,2730,1674,11053,31,234
755,1483,12,1843,5993,10086,5437,506,10,2640,1682,10275,31,235
486,1150,80,1821,3508,7045,3096,661,31,1876,1326,6990,31,236
173,842,116,1101,1082,3314,286,601,29,1242,972,3130,31,237
138,347,4,908,747,2144,181,316,36,1010,632,2175,31,238
601,1062,8,1584,5372,8627,4919,399,12,2161,1266,8757,31,239
906,1466,16,1960,7419,11767,6940,465,13,2872,1567,11857,31,240
847,1397,12,1872,6875,11003,6409,409,16,2769,1601,11204,31,241
760,1236,20,2049,6104,10169,5652,408,19,2763,1465,10307,31,242
470,888,70,2214,2834,6476,2826,618,39,1863,1147,6493,31,243
203,704,74,1289,1065,3335,317,667,38,1327,1031,3380,31,244
144,516,2,1121,1033,2816,196,436,5,1204,942,2783,31,245
134,404,3,1032,752,2325,167,363,12,1024,649,2215,31,246
784,1316,11,1829,7319,11259,6985,324,10,2795,1388,11502,31,247
819,1462,12,1953,7493,11739,7213,338,18,2975,1585,12129,31,248
793,1648,7,1866,6952,11266,6632,476,14,2804,1663,11589,31,249
570,1104,103,1836,3710,7323,3557,606,54,2015,1279,7511,31,250
158,759,91,1141,1023,3172,295,629,36,1336,1025,3321,31,251
115,418,7,928,876,2344,168,294,16,1134,750,2362,31,252
686,1236,13,1506,5983,9424,5589,407,13,2378,1468,9855,31,253
936,1707,6,2038,8191,12878,7704,470,7,3091,1871,13143,31,254
967,1760,16,1964,7830,12537,7237,502,19,3269,1819,12846,31,255
871,1979,11,2049,7308,12218,6808,526,9,3305,1897,12545,31,256
600,1411,129,1872,4119,8131,3701,766,43,2182,1627,8319,31,257
219,749,101,1264,1155,3488,357,683,67,1502,1193,3802,31,258
136,470,4,1218,892,2720,206,333,10,1172,895,2616,31,259
671,1438,10,1695,5865,9679,5567,336,15,2425,1572,9915,31,260
916,1667,10,1884,8378,12855,7825,406,14,3128,1740,13113,31,261
949,1862,23,2104,7771,12709,7542,406,20,3223,1830,13021,31,262
849,2061,32,2179,7202,12323,6817,647,27,3285,1899,12675,31,263
603,1181,88,2034,3916,7822,3644,603,40,2235,1483,8005,31,264
182,756,106,1303,1100,3447,292,615,82,1353,1143,3485,31,265
123,366,10,978,796,2273,194,263,10,1125,770,2362,31,266
670,1224,10,1662,6026,9592,5634,380,6,2408,1343,9771,31,267
902,1581,4,2009,8660,13156,7827,405,6,3312,1758,13308,31,268
931,1793,6,2017,7985,12732,7429,459,5,3313,1797,13003,31,269
770,1712,4,2120,7192,11798,6745,474,13,3247,1835,12314,31,270
576,1203,70,1951,3956,7756,3625,637,41,2060,1426,7789,31,271
212,887,150,1357,1316,3922,401,713,75,1529,1435,4153,31,272
111,389,3,984,817,2304,192,248,8,1209,805,2462,31,273
684,1212,6,1843,5882,9627,5645,310,10,2486,1315,9766,31,274
942,1527,24,2108,8186,12787,7825,385,18,3216,1627,13071,31,275
883,1771,22,2130,7879,12685,7369,411,22,3405,1769,12976,31,276
807,1889,9,2050,6991,11746,6513,483,7,3212,1760,11975,31,277
574,1337,90,2098,3936,8035,3603,632,37,2227,1613,8112,31,278
211,926,68,1388,1338,3931,302,656,34,1570,1560,4122,31,279
154,430,6,1193,1033,2816,220,272,12,1425,943,2872,31,280
687,1321,28,1815,6112,9963,5773,368,39,2610,1427,10217,31,281
995,1800,30,2349,8601,13775,7949,378,33,3880,1802,14042,31,282
923,1915,6,2212,8110,13166,7578,481,8,3430,1833,13330,31,283
862,1996,16,2191,7268,12333,6953,507,16,3113,1970,12559,31,284
626,1274,83,2160,3871,8014,3416,783,40,2487,1595,8321,31,285
232,866,105,1751,1754,4708,331,743,38,1704,1347,4163,31,286
291,533,8,1786,1545,4163,234,460,14,1668,1028,3404,31,287
460,810,8,1461,2683,5422,2092,306,8,1817,1136,5359,31,288
975,1880,7,2099,8248,13209,7890,398,6,3456,1769,13519,31,289
952,1968,21,2163,8251,13355,7796,437,24,3504,1989,13750,31,290
909,2098,12,2177,7483,12679,6941,596,10,3512,1886,12945,31,291
545,1336,100,2120,4254,8355,3706,653,79,2526,1587,8551,31,292
192,950,110,1445,1309,4006,336,750,43,1665,1344,4138,31,293
170,482,6,1264,1035,2957,227,442,11,1348,1013,3041,31,294
665,1621,13,1760,6568,10627,5857,378,12,2864,1600,10711,31,295
935,2197,24,2152,8697,14005,8398,372,18,3616,1938,14342,31,296
912,2340,7,2285,8599,14143,8064,480,10,3764,2047,14365,31,297
835,2363,10,2228,7836,13272,7378,575,6,3647,2021,13627,31,298
587,1636,120,2230,4815,9388,4311,748,47,2705,1751,9562,31,299
193,1896,155,1708,1568,5520,565,932,50,2004,2099,5650,31,300
475,461,12,1504,1283,3735,372,439,16,2062,978,3867,31,301
693,1339,7,1802,6121,9962,5640,400,8,2862,1407,10317,31,302
936,5857,7,2636,8105,17541,7662,748,11,4041,6429,18891,31,303
971,2145,3,2282,8325,13726,7798,471,5,3726,2011,14011,31,304
829,1487,30,2141,7132,11619,6521,805,34,3236,1536,12132,31,305
495,1199,104,1934,4005,7737,3570,643,49,2295,1450,8007,31,306
160,983,120,1136,1478,3877,287,630,50,1614,1228,3809,31,307
156,360,6,978,897,2397,196,244,8,1255,723,2426,31,308
700,1178,6,1714,6029,9627,5879,321,5,2484,1337,10026,31,309
798,1140,19,2135,5972,10064,5829,437,20,2768,1422,10476,31,310
810,1267,5,1848,6277,10207,5917,301,10,2764,1459,10451,31,311
769,1665,10,1959,7316,11719,6713,483,11,3175,1741,12123,31,312
531,1092,80,1880,3933,7516,3283,606,31,2460,1430,7810,31,313
182,719,104,1364,1312,3681,340,514,34,1654,1181,3723,31,314
180,319,8,1192,938,2637,226,266,12,1242,951,2697,31,315
382,858,0,1515,3871,6626,3201,281,7,2149,1070,6708,31,316
949,1519,8,1930,8455,12861,8102,352,11,3143,1783,13391,31,317
995,1757,28,2148,8248,13176,7965,356,34,3352,1955,13662,31,318
911,1639,14,2192,7620,12376,7130,437,21,3397,1745,12730,31,319
608,1221,86,1968,4200,8083,3921,587,27,2383,1564,8482,31,320
163,736,119,1270,1212,3500,336,663,30,1548,1218,3795,31,321
152,400,8,1029,898,2487,208,305,8,1161,885,2567,31,322
727,1201,4,1779,6209,9920,5880,341,6,2655,1490,10372,31,323
1005,1612,17,2268,8618,13520,8171,339,19,3419,1870,13818,31,324
1035,1718,7,2164,8468,13392,7850,402,17,3480,1863,13612,31,325
943,1782,20,2148,7659,12552,7092,462,19,3298,1890,12761,31,326
628,967,83,2094,3994,7766,3701,492,43,2125,1231,7592,31,327
185,693,114,1210,1192,3394,283,507,44,1620,1180,3634,31,328
157,390,7,1103,832,2489,168,218,8,1293,791,2478,31,329
630,955,16,1853,5508,8962,5042,275,18,2393,1169,8897,31,330
642,999,14,1962,5893,9510,5314,364,13,2645,1292,9628,31,331
469,600,12,2446,2572,6099,2861,408,15,1809,926,6019,31,332
103,232,5,537,475,1352,91,138,7,462,461,1159,31,333
221,476,35,1068,1169,2969,669,358,26,1196,806,3055,31,334
138,361,48,760,766,2073,206,350,31,1032,716,2335,31,335
87,271,4,683,620,1665,161,281,14,949,687,2092,31,336
662,1060,4,1472,5685,8883,5001,328,7,2552,1198,9086,31,337
871,1507,15,1925,8092,12410,7693,400,16,3208,1636,12953,31,338
921,1767,16,2086,7762,12552,7235,370,26,3608,1842,13081,31,339
848,2291,15,2305,8681,14140,6779,517,12,3465,2943,13716,31,340
532,1359,101,2139,3993,8124,3496,677,37,2373,1773,8356,31,341
152,989,77,1244,1384,3846,300,763,41,1514,1321,3939,31,342
135,446,6,952,1047,2586,171,336,10,1433,949,2899,31,343
673,1345,9,1649,5879,9555,5427,349,11,2553,1423,9763,31,344
934,1881,4,2128,8316,13263,7788,403,6,3546,1755,13498,31,345
903,1939,5,2160,8004,13011,7429,430,11,3408,1861,13139,31,346
916,1897,8,2137,7044,12002,6509,445,7,3681,1874,12516,31,347
539,1318,95,2020,3915,7887,3590,579,52,2379,1651,8251,31,348
307,1497,168,1370,1421,4763,261,1140,38,1865,1513,4817,31,349
155,399,11,973,884,2422,145,213,17,1263,645,2283,31,350
637,1167,13,1774,5729,9320,5200,307,13,2514,1290,9324,31,351
854,1519,13,2173,7960,12519,7106,387,22,3350,1763,12628,31,352
809,1576,5,2116,7212,11718,6504,335,7,3247,1586,11679,31,353
711,1505,20,2051,6284,10571,5653,542,22,2943,1673,10833,31,354
11,8,6,16,10,51,13,7,4,15,12,51,31,355
3,2,2,3,8,18,2,3,2,3,7,17,31,356
0,1,0,0,1,2,0,1,0,0,1,2,31,357
1,0,3,4,7,15,0,0,4,4,7,15,31,358
0,0,0,5,0,5,0,0,0,4,1,5,31,359
0,0,0,1,0,1,0,0,0,0,0,0,31,360
0,2,6,2,4,14,0,2,5,1,4,12,31,361
3,2,3,0,2,10,2,4,5,0,2,13,31,362
27,0,0,5,0,32,21,0,2,7,0,30,31,363
9,1,7,40,0,57,6,1,11,42,0,60,31,364
292,447,13,913,1850,3515,1324,191,13,1028,617,3173,31,365
283,425,350,1397,1577,4032,1502,412,145,1234,727,4020,31,366
40,26,0,260,233,559,32,38,0,266,157,493,32,1
140,100,7,410,1121,1778,910,76,7,446,277,1716,32,2
177,103,2,406,1417,2105,1207,75,3,517,325,2127,32,3
172,117,14,408,1314,2025,1063,89,15,526,247,1940,32,4
141,103,10,354,920,1528,711,83,12,421,202,1429,32,5
39,44,2,226,272,583,68,64,12,346,109,599,32,6
44,38,6,267,236,591,60,85,12,227,133,517,32,7
154,111,3,371,1067,1706,965,80,5,490,255,1795,32,8
219,123,5,618,1387,2352,1466,61,7,494,235,2263,32,9
212,149,5,418,1720,2504,1519,110,6,573,285,2493,32,10
218,140,5,405,1400,2168,1298,93,6,455,306,2158,32,11
140,96,6,387,852,1481,755,82,10,403,207,1457,32,12
37,47,3,327,412,826,79,48,12,357,199,695,32,13
16,37,0,248,288,589,29,45,0,271,119,464,32,14
39,36,0,213,267,555,89,48,1,239,87,464,32,15
104,76,6,240,440,866,333,60,8,230,188,819,32,16
201,168,2,330,1331,2032,1166,99,6,443,273,1987,32,17
191,218,31,449,1488,2377,1442,200,35,487,325,2489,32,18
171,131,3,493,742,1540,446,137,7,452,219,1261,32,19
87,103,6,510,477,1183,141,82,12,478,178,891,32,20
30,40,2,251,215,538,49,55,4,270,87,465,32,21
161,122,3,345,1141,1772,1023,75,4,389,245,1736,32,22
219,157,10,486,1760,2632,1639,110,13,538,311,2611,32,23
226,155,0,431,1793,2605,1681,86,1,504,297,2569,32,24
205,166,3,433,1430,2237,1325,111,2,504,288,2230,32,25
120,131,3,445,921,1620,770,80,4,496,230,1580,32,26
33,46,3,292,425,799,73,36,9,497,157,772,32,27
25,37,5,191,223,481,35,52,3,274,101,465,32,28
149,153,7,377,1249,1935,1142,111,8,417,225,1903,32,29
228,162,6,429,1842,2667,1711,85,5,520,309,2630,32,30
231,182,9,495,1768,2685,1753,111,10,536,257,2667,32,31
199,147,5,480,1531,2362,1435,105,7,523,290,2360,32,32
146,134,5,478,895,1658,799,90,7,501,200,1597,32,33
39,63,1,300,475,878,67,83,9,460,171,790,32,34
29,29,15,212,222,507,41,37,12,293,110,493,32,35
164,115,11,307,1222,1819,1174,76,8,384,241,1883,32,36
233,149,1,410,1781,2574,1680,87,2,521,287,2577,32,37
227,167,1,452,1809,2656,1756,95,3,576,239,2669,32,38
214,146,2,460,1388,2210,1332,112,3,534,282,2263,32,39
148,98,4,370,932,1552,805,81,4,401,210,1501,32,40
62,60,5,268,383,778,57,67,11,396,169,700,32,41
40,30,0,247,218,535,35,45,0,221,107,408,32,42
174,107,0,358,1157,1796,1094,93,1,378,263,1829,32,43
263,136,10,439,1577,2425,1509,100,11,502,328,2450,32,44
226,150,14,534,1758,2682,1367,81,10,676,256,2390,32,45
249,158,1,507,1566,2481,1389,92,1,1025,548,3055,32,46
150,121,7,508,868,1654,791,101,6,474,226,1598,32,47
40,63,7,409,628,1147,55,76,15,630,192,968,32,48
46,44,4,307,402,803,49,80,8,433,155,725,32,49
101,83,0,382,456,1022,141,85,1,506,165,898,32,50
227,142,6,449,1575,2399,1473,99,6,519,278,2375,32,51
245,164,3,514,1755,2681,1639,99,4,650,350,2742,32,52
215,170,3,493,1473,2354,1382,107,6,538,290,2323,32,53
160,106,1,534,934,1735,830,97,5,518,217,1667,32,54
43,66,3,373,533,1018,83,79,12,613,232,1019,32,55
35,32,1,250,261,579,45,40,1,348,141,575,32,56
191,131,0,373,1245,1940,1194,87,2,392,240,1915,32,57
224,164,11,482,1791,2672,1673,102,16,588,312,2691,32,58
203,163,1,506,1873,2746,1760,105,4,561,286,2716,32,59
218,134,17,555,1546,2470,1543,99,17,530,266,2455,32,60
148,179,9,454,907,1697,850,92,8,480,249,1679,32,61
45,108,12,278,509,952,51,70,17,476,205,819,32,62
55,61,6,241,359,722,64,82,9,407,217,779,32,63
170,137,7,420,1319,2053,1169,150,8,418,224,1969,32,64
287,177,3,507,1973,2947,1803,155,5,671,320,2954,32,65
260,193,3,530,2139,3125,1788,137,2,762,333,3022,32,66
227,197,5,549,1480,2458,1362,151,7,549,300,2369,32,67
170,166,2,538,1133,2009,899,89,11,583,253,1835,32,68
61,108,3,422,633,1227,108,90,9,772,184,1163,32,69
45,49,10,333,459,896,44,74,14,425,210,767,32,70
181,177,1,520,1460,2339,1264,121,2,569,305,2261,32,71
274,236,7,605,2086,3208,1781,161,8,871,380,3201,32,72
244,215,3,675,2254,3391,1820,179,12,895,401,3307,32,73
238,195,4,709,1900,3046,1426,148,5,958,397,2934,32,74
161,224,3,535,1243,2166,841,108,10,742,333,2034,32,75
95,133,2,1612,914,2756,251,95,12,1050,290,1698,32,76
30,64,2,348,512,956,50,78,5,479,186,798,32,77
181,135,6,565,1418,2305,1165,102,6,679,284,2236,32,78
235,182,1,516,1997,2931,1778,149,3,731,337,2998,32,79
227,192,3,735,2111,3268,1823,143,4,861,432,3263,32,80
247,190,5,639,1789,2870,1500,196,7,717,373,2793,32,81
227,150,2,635,1335,2349,924,109,6,723,355,2117,32,82
48,145,4,586,777,1560,150,92,15,868,313,1438,32,83
44,82,3,522,779,1430,74,116,3,695,287,1175,32,84
224,176,10,696,1696,2802,1121,150,17,970,408,2666,32,85
238,177,4,839,2283,3541,1664,174,6,1077,396,3317,32,86
240,177,2,830,2159,3408,1581,159,3,1219,395,3357,32,87
259,156,11,733,1979,3138,1324,165,12,1033,411,2945,32,88
195,230,36,841,1608,2910,712,148,34,1191,449,2534,32,89
61,128,14,794,1171,2168,93,113,20,1056,403,1685,32,90
52,62,0,487,617,1218,60,108,0,611,227,1006,32,91
179,149,1,572,1490,2391,1002,137,2,793,311,2245,32,92
253,147,5,745,2390,3540,1711,160,7,1037,399,3314,32,93
272,158,3,691,2409,3533,1786,127,7,1129,366,3415,32,94
315,186,3,692,2061,3257,1397,179,3,982,405,2966,32,95
159,193,6,790,1496,2644,844,166,26,1057,374,2467,32,96
94,157,8,760,1048,2067,122,95,7,1151,282,1657,32,97
62,67,2,417,414,962,58,92,1,554,138,843,32,98
208,143,9,502,1434,2296,1274,117,20,616,245,2272,32,99
217,260,3,540,1992,3012,1725,117,5,688,354,2889,32,100
256,246,1,571,2062,3136,1794,145,2,778,335,3054,32,101
282,212,11,656,1828,2989,1584,177,14,726,357,2858,32,102
196,214,3,590,1250,2253,1025,141,13,699,287,2165,32,103
64,162,10,697,894,1827,131,94,22,858,372,1477,32,104
74,93,4,444,609,1224,57,96,1,588,224,966,32,105
204,154,7,577,1473,2415,1225,130,6,715,271,2347,32,106
235,235,27,659,1966,3122,1671,96,28,864,397,3056,32,107
278,246,3,667,2439,3633,1873,142,4,894,546,3459,32,108
272,227,15,655,1800,2969,1664,133,20,834,369,3020,32,109
161,200,22,712,1188,2283,952,128,32,756,278,2146,32,110
79,244,5,484,1155,1967,162,154,15,1047,569,1947,32,111
55,62,1,393,457,968,63,101,2,488,172,826,32,112
194,128,3,433,1361,2119,1139,136,4,634,274,2187,32,113
305,224,21,563,2096,3209,1764,181,21,814,370,3150,32,114
241,233,4,629,1981,3088,1779,150,8,743,331,3011,32,115
267,237,15,615,1723,2857,1474,174,15,727,391,2781,32,116
201,176,4,586,1197,2164,856,87,12,758,390,2103,32,117
49,132,5,513,666,1365,92,120,38,823,272,1345,32,118
105,66,4,358,534,1067,57,129,8,542,202,938,32,119
170,182,1,485,1449,2287,1280,110,2,592,266,2250,32,120
222,212,8,553,1951,2946,1840,103,8,670,360,2981,32,121
233,187,12,766,2022,3220,1869,136,11,787,308,3111,32,122
213,221,19,582,1704,2739,1482,118,22,652,380,2654,32,123
159,149,10,643,1105,2066,912,118,17,607,267,1921,32,124
57,65,2,373,508,1005,60,116,6,428,181,791,32,125
49,49,3,376,472,949,52,91,2,453,153,751,32,126
182,158,6,474,1494,2314,1233,118,8,537,321,2217,32,127
255,199,14,785,2108,3361,1870,167,17,978,349,3381,32,128
264,221,2,689,2002,3178,1873,194,4,841,350,3262,32,129
233,181,2,587,1656,2659,1479,143,3,836,331,2792,32,130
189,147,5,596,1065,2002,843,74,19,694,299,1929,32,131
39,79,3,390,592,1103,86,121,13,613,241,1074,32,132
39,60,4,298,384,785,70,56,7,443,173,749,32,133
187,180,5,521,1360,2253,1170,125,9,643,280,2227,32,134
240,177,11,644,2196,3268,1786,95,9,856,368,3114,32,135
253,212,7,723,2154,3349,1982,100,8,820,366,3276,32,136
231,176,14,759,1834,3014,1621,130,16,793,361,2921,32,137
195,142,2,706,1265,2310,921,96,8,801,341,2167,32,138
46,92,2,457,791,1388,130,98,6,729,333,1296,32,139
78,86,1,375,562,1102,80,101,5,559,203,948,32,140
216,154,7,541,1509,2427,1170,113,10,597,351,2241,32,141
287,213,7,690,2068,3265,1847,178,9,819,327,3180,32,142
302,212,8,589,2058,3169,1867,122,4,728,321,3042,32,143
242,149,6,569,1664,2630,1463,92,7,705,285,2552,32,144
136,147,2,708,948,1941,773,121,7,611,267,1779,32,145
70,311,5,519,735,1640,81,157,5,718,286,1247,32,146
60,782,0,588,674,2104,61,324,1,794,540,1720,32,147
47,82,0,401,541,1071,117,74,1,515,160,867,32,148
203,132,14,601,1772,2722,1529,95,12,685,284,2605,32,149
232,160,15,651,2067,3125,1732,120,14,747,323,2936,32,150
249,159,4,623,1656,2691,1481,128,9,774,324,2716,32,151
166,156,9,561,1115,2007,878,104,11,661,249,1903,32,152
82,143,5,552,779,1561,109,114,13,888,373,1497,32,153
59,47,1,431,470,1008,53,83,2,501,210,849,32,154
195,156,2,514,1665,2532,1398,108,5,626,286,2423,32,155
208,207,2,607,2132,3156,1891,108,3,776,348,3126,32,156
256,177,9,733,2367,3542,2007,140,5,890,367,3409,32,157
314,180,4,667,1786,2951,1543,203,4,687,348,2785,32,158
224,169,8,634,1253,2288,856,169,13,710,294,2042,32,159
119,163,4,551,752,1589,151,229,8,820,277,1485,32,160
112,352,3,385,623,1475,58,190,4,667,390,1309,32,161
211,146,7,559,1598,2521,1346,129,6,652,321,2454,32,162
258,209,4,773,2212,3456,1964,161,8,866,362,3361,32,163
252,248,4,673,2315,3492,1969,125,2,853,383,3332,32,164
247,173,3,649,1872,2944,1612,153,1,801,381,2948,32,165
219,153,4,689,1402,2467,952,159,6,788,278,2183,32,166
61,112,2,491,763,1429,104,123,7,771,248,1253,32,167
87,59,9,355,507,1017,60,92,6,554,186,898,32,168
198,144,3,574,1490,2409,1199,111,7,716,266,2299,32,169
232,235,20,739,1809,3035,1668,155,34,801,346,3004,32,170
122,144,2,503,655,1426,190,150,9,699,196,1244,32,171
207,226,2,636,1709,2780,1328,149,7,725,385,2594,32,172
172,128,3,547,1241,2091,817,122,7,851,300,2097,32,173
70,205,24,535,700,1534,156,162,5,785,285,1393,32,174
79,99,3,360,442,983,61,104,4,457,198,824,32,175
198,172,4,530,1519,2423,1179,158,4,786,394,2521,32,176
232,199,5,665,2180,3281,1849,153,10,847,332,3191,32,177
252,201,2,707,2321,3483,1838,139,4,983,344,3308,32,178
250,228,3,725,2036,3242,1602,151,4,899,420,3076,32,179
134,201,7,652,1490,2484,978,102,13,829,299,2221,32,180
71,130,35,690,1261,2187,147,96,38,1252,295,1828,32,181
46,120,2,407,678,1253,85,79,1,774,202,1141,32,182
172,156,1,618,1711,2658,1199,111,3,888,261,2462,32,183
192,166,17,622,1938,2935,1562,106,21,812,271,2772,32,184
189,707,5,1020,1276,3197,1309,254,4,911,490,2968,32,185
61,2027,4,470,855,3417,171,1585,5,742,815,3318,32,186
110,154,3,698,1170,2135,476,107,11,952,233,1779,32,187
61,85,3,499,743,1391,97,76,7,713,215,1108,32,188
55,71,3,287,443,859,65,88,2,496,161,812,32,189
189,186,4,534,1505,2418,1216,118,1,627,275,2237,32,190
243,191,5,636,1867,2942,1561,124,4,695,316,2700,32,191
201,185,3,684,1972,3045,1581,139,4,824,319,2867,32,192
243,203,5,616,1673,2740,1305,125,10,734,377,2551,32,193
174,145,6,576,1199,2100,835,106,11,756,294,2002,32,194
56,127,16,546,976,1721,139,84,13,770,310,1316,32,195
35,68,6,355,419,883,82,74,10,366,202,734,32,196
178,123,4,484,1584,2373,1180,81,4,607,326,2198,32,197
199,169,9,638,2073,3088,1712,120,11,722,345,2910,32,198
259,162,2,620,2105,3148,1667,102,3,875,360,3007,32,199
209,242,1,620,1917,2989,1424,145,5,772,565,2911,32,200
163,145,17,573,1340,2238,805,145,6,688,283,1927,32,201
88,103,3,543,1075,1812,83,83,6,1015,391,1578,32,202
50,119,3,509,746,1427,65,67,3,828,290,1253,32,203
171,292,1,594,1638,2696,1239,114,3,737,478,2571,32,204
241,179,5,722,2233,3380,1636,107,7,889,484,3123,32,205
239,189,3,897,1740,3068,1332,107,3,1059,418,2919,32,206
235,177,2,679,1885,2978,1447,110,4,834,368,2763,32,207
174,182,4,613,1454,2427,858,134,8,799,330,2129,32,208
54,92,17,556,985,1704,97,108,22,806,400,1433,32,209
45,79,3,480,719,1326,76,102,6,760,386,1330,32,210
178,172,5,656,1595,2606,1164,136,5,715,337,2357,32,211
238,165,3,560,2172,3138,1686,164,5,751,436,3042,32,212
236,155,0,659,2160,3210,1653,134,3,878,418,3086,32,213
233,173,10,617,1757,2790,1448,155,13,778,333,2727,32,214
155,161,5,610,1199,2130,815,118,12,659,253,1857,32,215
55,138,8,407,624,1232,95,83,14,623,309,1124,32,216
51,75,1,330,509,966,75,67,2,411,171,726,32,217
162,157,15,593,1397,2324,1018,148,7,716,212,2101,32,218
268,186,3,614,1951,3022,1614,135,7,721,315,2792,32,219
185,168,7,647,1839,2846,1541,113,12,764,281,2711,32,220
198,181,1,601,1627,2608,1271,119,7,696,344,2437,32,221
132,191,6,451,891,1671,641,118,10,538,227,1534,32,222
38,98,4,467,795,1402,87,87,7,664,239,1084,32,223
31,85,2,298,538,954,56,71,2,421,181,731,32,224
151,148,5,439,1270,2013,1020,70,5,545,232,1872,32,225
189,158,0,498,1774,2619,1585,81,1,592,300,2559,32,226
179,175,14,529,1738,2635,1492,125,19,640,247,2523,32,227
194,280,3,511,1526,2514,1220,154,4,627,471,2476,32,228
124,164,8,470,1047,1813,746,110,9,583,222,1670,32,229
30,95,3,399,622,1149,80,108,8,609,233,1038,32,230
37,51,11,312,370,781,53,86,13,367,135,654,32,231
141,133,17,379,1233,1903,1010,105,16,490,248,1869,32,232
185,167,3,501,1792,2648,1599,134,4,647,274,2658,32,233
173,193,11,515,1715,2607,1450,93,12,652,274,2481,32,234
168,132,7,430,1461,2198,1220,137,7,567,247,2178,32,235
140,164,9,488,967,1768,721,78,12,524,246,1581,32,236
38,131,10,329,638,1146,76,98,27,505,254,960,32,237
27,74,1,286,426,814,45,62,6,374,163,650,32,238
201,120,11,423,1227,1982,1133,94,11,450,246,1934,32,239
215,163,3,510,1810,2701,1676,106,5,568,298,2653,32,240
195,172,3,556,1823,2749,1615,112,6,632,307,2672,32,241
193,144,4,583,1493,2417,1296,91,8,619,277,2291,32,242
145,145,7,594,829,1720,712,100,11,518,246,1587,32,243
62,158,4,540,816,1580,132,128,4,888,237,1389,32,244
69,1010,4,480,632,2195,67,546,6,568,406,1593,32,245
45,89,3,338,431,906,93,74,3,471,155,796,32,246
170,136,21,457,1574,2358,1436,79,11,507,218,2251,32,247
209,155,8,495,1733,2600,1599,117,10,591,255,2572,32,248
223,188,16,533,1598,2558,1467,117,21,585,311,2501,32,249
144,168,15,435,1012,1774,827,101,6,462,274,1670,32,250
63,101,4,416,553,1137,99,72,9,549,198,927,32,251
35,73,2,292,352,754,67,60,3,377,150,657,32,252
166,156,6,405,1391,2124,1309,85,6,464,252,2116,32,253
294,218,3,527,2016,3058,1885,172,6,619,298,2980,32,254
252,178,11,588,2010,3039,1854,118,23,727,290,3012,32,255
228,215,0,568,1684,2695,1586,128,1,644,343,2702,32,256
173,200,1,563,1081,2018,904,132,5,547,254,1842,32,257
58,140,10,448,696,1352,109,75,8,651,201,1044,32,258
45,80,4,324,417,870,75,63,7,391,175,711,32,259
210,146,4,430,1438,2228,1306,90,8,602,265,2271,32,260
241,202,1,570,2186,3200,1975,93,4,686,302,3060,32,261
283,243,2,687,2048,3263,1916,107,6,826,306,3161,32,262
271,225,4,504,1818,2822,1663,129,10,668,289,2759,32,263
175,151,18,503,1164,2011,944,88,17,584,259,1892,32,264
86,162,11,468,709,1436,144,138,18,710,325,1335,32,265
45,82,1,327,440,895,67,122,5,383,216,793,32,266
215,208,16,415,1508,2362,1358,92,22,527,303,2302,32,267
251,208,7,569,2454,3489,1986,96,8,819,358,3267,32,268
262,210,5,600,2089,3166,2017,119,7,712,309,3164,32,269
242,192,8,534,1639,2615,1507,127,9,628,319,2590,32,270
192,218,5,479,1077,1971,871,132,9,579,284,1875,32,271
57,187,6,398,748,1396,99,115,12,701,325,1252,32,272
49,60,0,327,411,847,61,82,1,451,198,793,32,273
220,174,10,537,1355,2296,1277,100,12,551,324,2264,32,274
245,177,3,548,1891,2864,1774,127,7,686,319,2913,32,275
235,191,4,598,1895,2923,1807,125,11,693,296,2932,32,276
240,200,3,662,1580,2685,1436,128,6,752,323,2645,32,277
206,148,32,511,1102,1999,810,118,36,669,283,1916,32,278
68,194,6,517,745,1530,121,148,12,705,287,1273,32,279
71,71,3,400,510,1055,70,98,3,495,242,908,32,280
202,135,4,574,1481,2396,1313,105,4,653,291,2366,32,281
274,174,5,661,2066,3180,1871,150,5,765,344,3135,32,282
275,186,9,649,2020,3139,1861,143,13,804,320,3141,32,283
253,258,5,598,1755,2869,1456,189,9,767,382,2803,32,284
204,187,18,643,1413,2465,870,170,28,887,332,2287,32,285
79,149,4,542,955,1729,131,137,12,990,283,1553,32,286
55,88,0,461,692,1296,97,112,1,785,235,1230,32,287
128,90,3,480,684,1385,186,108,2,557,270,1123,32,288
243,130,4,586,2000,2963,1675,120,3,783,309,2890,32,289
273,169,4,601,2067,3114,1749,115,6,800,362,3032,32,290
259,207,10,667,1866,3009,1584,155,5,758,327,2829,32,291
222,185,8,584,1223,2222,897,226,9,672,401,2205,32,292
164,108,5,566,681,1524,99,95,8,678,274,1154,32,293
47,75,0,433,503,1058,58,134,1,553,224,970,32,294
243,113,5,455,1450,2266,1196,108,5,561,363,2233,32,295
268,190,4,569,1963,2994,1806,116,6,673,355,2956,32,296
250,171,4,710,2083,3218,1857,120,6,765,340,3088,32,297
213,177,3,609,1600,2602,1585,114,8,612,326,2645,32,298
166,119,3,558,1161,2007,824,100,9,586,314,1833,32,299
49,124,9,537,664,1383,110,125,15,691,269,1210,32,300
94,53,0,549,493,1189,87,117,1,648,218,1071,32,301
202,130,20,520,1470,2342,1271,99,8,625,276,2279,32,302
313,185,17,771,2169,3455,1750,168,22,948,374,3262,32,303
261,202,4,656,1919,3042,1833,97,3,738,317,2988,32,304
221,145,3,596,1512,2477,1396,139,4,571,288,2398,32,305
152,144,37,483,1050,1866,855,114,44,569,255,1837,32,306
60,148,5,373,520,1106,78,119,9,523,232,961,32,307
84,53,2,337,341,817,55,62,3,369,160,649,32,308
182,126,2,498,1398,2206,1230,72,5,456,270,2033,32,309
225,134,16,589,1256,2220,1294,79,12,495,258,2138,32,310
187,115,1,476,1376,2155,1275,89,2,503,259,2128,32,311
199,159,5,555,1580,2498,1451,89,8,611,328,2487,32,312
177,129,7,541,1016,1870,856,108,8,534,283,1789,32,313
41,54,9,425,627,1156,69,82,11,653,205,1020,32,314
33,57,1,334,413,838,58,57,2,407,177,701,32,315
105,79,15,315,454,968,185,69,17,428,179,878,32,316
230,149,26,585,1974,2964,1861,97,29,630,284,2901,32,317
221,173,9,673,2054,3130,1955,106,8,808,297,3174,32,318
244,178,2,556,1796,2776,1657,103,4,658,290,2712,32,319
156,155,3,503,1176,1993,1002,101,4,549,296,1952,32,320
36,115,4,395,673,1223,78,80,11,652,213,1034,32,321
51,59,0,314,350,774,61,61,1,397,140,660,32,322
194,132,1,476,1528,2331,1424,101,2,544,286,2357,32,323
233,133,5,585,2091,3047,1951,117,7,701,288,3064,32,324
282,169,19,541,2076,3087,1942,192,21,726,311,3192,32,325
279,149,11,625,1822,2886,1651,129,11,781,328,2900,32,326
238,103,3,491,1032,1867,868,114,13,442,231,1668,32,327
47,69,8,345,523,992,80,104,9,446,202,841,32,328
86,56,3,330,367,842,65,111,5,377,187,745,32,329
201,104,12,541,1286,2144,1105,85,12,699,255,2156,32,330
164,127,17,674,1699,2681,1262,101,20,930,305,2618,32,331
124,75,9,735,756,1699,691,71,13,599,182,1556,32,332
44,26,0,272,248,590,41,48,1,264,164,518,32,333
64,73,2,673,914,1726,269,84,6,964,295,1618,32,334
51,51,4,421,636,1163,69,56,16,807,208,1156,32,335
36,31,7,304,332,710,49,58,10,472,144,733,32,336
160,102,6,467,1302,2037,1169,55,7,528,269,2028,32,337
232,183,4,550,2104,3073,1881,99,6,706,403,3095,32,338
232,194,4,577,2192,3199,1944,118,7,789,344,3202,32,339
208,154,8,557,1827,2754,1658,110,8,657,283,2716,32,340
146,154,6,600,1212,2118,895,98,9,706,330,2038,32,341
87,165,7,474,587,1320,133,169,25,890,390,1607,32,342
51,89,0,413,525,1078,77,109,3,618,334,1141,32,343
208,158,9,547,1511,2433,1356,117,8,642,289,2412,32,344
288,292,2,704,2232,3518,1953,156,5,917,649,3680,32,345
260,185,5,719,2206,3375,1978,136,5,927,322,3368,32,346
259,272,0,790,1853,3174,1550,148,2,990,503,3193,32,347
163,265,8,648,1159,2243,844,199,26,781,342,2192,32,348
106,183,45,673,723,1730,90,241,61,1008,308,1708,32,349
53,52,1,464,396,966,67,76,5,515,181,844,32,350
189,133,2,489,1513,2326,1265,99,3,652,276,2295,32,351
248,311,4,670,2109,3342,1811,119,5,886,591,3412,32,352
206,176,7,661,1949,2999,1737,127,7,825,328,3024,32,353
200,287,1,603,1570,2661,1396,116,6,676,436,2630,32,354
94,107,6,358,590,1155,501,52,7,357,191,1108,32,355
40,55,8,294,379,776,53,46,7,432,137,675,32,356
30,26,4,274,222,556,48,38,5,268,142,501,32,357
49,81,2,342,624,1098,441,57,2,378,146,1024,32,358
52,29,1,222,215,519,164,18,2,194,77,455,32,359
12,33,7,66,58,176,17,24,9,64,51,165,32,360
76,95,14,309,590,1084,402,50,14,454,212,1132,32,361
814,1479,121,1667,3359,7440,2680,839,33,3251,2161,8964,32,362
352,1180,121,1108,1603,4364,635,631,39,2310,1377,4992,32,363
294,1505,54,1132,2844,5829,524,633,1874,2008,1114,6153,32,364
96,124,7,553,1012,1792,554,82,9,877,314,1836,32,365
103,85,9,833,1391,2421,551,61,18,1322,246,2198,32,366
16,73,0,375,486,950,48,17,1,601,144,811,33,1
67,170,1,517,2332,3087,1882,23,1,845,224,2975,33,2
67,191,6,571,2779,3614,2379,19,5,970,170,3543,33,3
76,239,1,628,2447,3391,2067,27,1,985,187,3267,33,4
70,212,7,599,1453,2341,1208,32,0,818,210,2268,33,5
20,91,3,280,567,961,77,57,2,707,162,1005,33,6
11,89,2,234,440,776,33,59,2,578,141,813,33,7
89,189,13,432,2046,2769,1816,37,9,693,171,2726,33,8
112,196,18,961,2741,4028,2551,21,15,821,116,3524,33,9
102,285,14,615,3059,4075,2807,50,10,936,222,4025,33,10
87,268,3,663,2594,3615,2346,49,2,929,236,3562,33,11
71,197,9,626,1111,2014,1054,32,4,592,182,1864,33,12
27,193,14,660,1989,2883,82,23,6,3210,716,4037,33,13
13,108,7,322,547,997,38,19,6,559,161,783,33,14
33,73,4,275,390,775,80,14,4,431,96,625,33,15
98,92,0,162,254,606,282,20,0,246,98,646,33,16
69,272,11,476,2337,3165,1992,74,8,741,215,3030,33,17
93,308,18,560,2763,3742,2572,54,10,963,247,3846,33,18
51,219,12,494,1037,1813,524,53,3,1342,249,2171,33,19
16,106,18,443,750,1333,119,36,5,967,206,1333,33,20
11,68,17,244,449,789,51,28,20,620,112,831,33,21
84,225,3,488,2150,2950,1932,33,1,672,189,2827,33,22
122,340,14,603,3129,4208,3045,24,21,870,234,4194,33,23
114,387,11,713,3139,4364,3061,30,15,985,272,4363,33,24
95,312,11,614,2681,3713,2580,42,8,838,228,3696,33,25
66,238,13,658,1581,2556,1388,59,1,946,243,2637,33,26
13,179,15,500,780,1487,118,58,2,1009,289,1476,33,27
11,103,6,255,458,833,54,31,6,552,146,789,33,28
91,268,0,632,2192,3183,1997,12,0,851,236,3096,33,29
113,311,9,605,3150,4188,2971,22,6,932,233,4164,33,30
105,432,17,711,3052,4317,2981,34,11,995,294,4315,33,31
88,326,3,591,2578,3586,2393,28,1,938,239,3599,33,32
79,228,12,642,1536,2497,1313,27,0,844,221,2405,33,33
29,176,13,480,809,1507,143,37,2,969,279,1430,33,34
11,94,3,311,551,970,56,24,2,629,150,861,33,35
77,264,7,510,2132,2990,1976,35,3,638,195,2847,33,36
122,267,2,612,3115,4118,3020,31,1,874,196,4122,33,37
113,333,2,701,3198,4347,2994,23,2,972,239,4230,33,38
92,337,2,645,2602,3678,2492,47,1,909,210,3659,33,39
74,271,19,718,1606,2688,1331,55,5,954,248,2593,33,40
17,152,19,421,661,1270,78,39,4,818,212,1151,33,41
11,73,5,207,388,684,47,17,6,499,106,675,33,42
83,250,11,504,2194,3042,1884,34,16,742,189,2865,33,43
108,381,4,636,2658,3787,2734,52,6,854,257,3903,33,44
110,436,7,776,3036,4365,2328,72,7,1215,328,3950,33,45
112,368,1,745,2590,3816,2452,59,2,886,338,3737,33,46
61,201,17,829,1415,2523,1270,55,5,915,198,2443,33,47
17,172,23,570,1087,1869,116,90,7,1274,364,1851,33,48
5,117,6,506,1075,1709,77,79,9,1491,271,1927,33,49
41,146,6,516,923,1632,222,31,6,1033,209,1501,33,50
91,279,2,691,3111,4174,2819,32,1,906,243,4001,33,51
91,368,3,782,3232,4476,3042,20,2,1153,272,4489,33,52
91,293,16,677,2907,3984,2608,40,11,1020,201,3880,33,53
55,262,32,762,1666,2777,1356,38,12,1005,237,2648,33,54
18,147,24,514,985,1688,128,45,3,1148,262,1586,33,55
20,153,7,378,602,1160,57,18,11,757,233,1076,33,56
70,268,1,512,2156,3007,2023,25,3,754,181,2986,33,57
83,296,4,750,3143,4276,2922,97,2,900,186,4107,33,58
76,379,9,718,3688,4870,3216,28,7,1041,252,4544,33,59
74,331,3,783,2923,4114,2680,28,2,1017,283,4010,33,60
66,260,10,744,1630,2710,1459,49,1,870,261,2640,33,61
12,136,22,467,1043,1680,126,49,0,1092,218,1485,33,62
10,118,5,331,679,1143,61,18,6,848,204,1137,33,63
72,262,5,637,2329,3305,1933,32,3,925,217,3110,33,64
115,346,19,784,3150,4414,3083,28,12,1232,274,4629,33,65
77,412,9,805,3609,4912,3123,73,5,1124,289,4614,33,66
97,391,10,874,2871,4243,2600,61,4,1026,299,3990,33,67
58,315,17,815,1734,2939,1379,61,2,2974,366,4782,33,68
22,156,16,737,1251,2182,253,59,4,1398,206,1920,33,69
9,191,14,420,1115,1749,88,41,10,1039,279,1457,33,70
84,354,7,753,2866,4064,2082,51,7,1373,314,3827,33,71
96,506,10,982,3623,5217,3081,63,8,1708,457,5317,33,72
117,588,4,1066,3727,5502,3209,70,3,1831,457,5570,33,73
101,512,7,1217,3188,5025,2543,79,8,1649,505,4784,33,74
54,320,23,932,2322,3651,1496,66,2,1577,424,3565,33,75
229,391,23,1200,1478,3321,2356,89,4,1827,548,4824,33,76
10,255,3,471,1122,1861,109,58,4,1224,307,1702,33,77
88,409,2,753,2604,3856,1949,73,3,1176,313,3514,33,78
156,453,7,942,3474,5032,3082,54,8,1481,397,5022,33,79
132,473,4,1082,3733,5424,3106,91,4,1560,467,5228,33,80
132,505,4,989,3136,4766,2586,95,3,1546,448,4678,33,81
96,473,22,1070,2113,3774,1445,103,4,1355,480,3387,33,82
39,266,21,750,1643,2719,154,79,5,1809,510,2557,33,83
23,368,27,1073,1939,3430,187,85,23,2043,511,2849,33,84
114,438,3,1059,3311,4925,1901,72,3,2435,458,4869,33,85
108,485,2,1320,4200,6115,2893,89,0,2376,523,5881,33,86
113,417,9,1538,4467,6544,2997,52,5,2423,469,5946,33,87
121,432,2,1416,3581,5552,2394,75,1,2458,498,5426,33,88
70,439,9,1502,2721,4741,1333,104,2,2341,667,4447,33,89
23,329,26,2074,3722,6174,239,97,2,3468,692,4498,33,90
25,250,4,697,1385,2361,148,71,3,1359,430,2011,33,91
107,676,0,1575,3722,6080,2274,68,0,3038,922,6302,33,92
119,345,2,1239,4353,6058,3073,48,1,2124,338,5584,33,93
123,471,3,1393,4302,6292,3428,57,5,2402,437,6329,33,94
86,472,1,1365,4155,6079,2818,97,2,2411,548,5876,33,95
66,462,24,1306,2663,4521,1485,98,5,2214,505,4307,33,96
60,271,39,1709,1543,3622,1352,87,9,2005,383,3836,33,97
106,239,12,1919,959,3235,490,55,10,1061,253,1869,33,98
81,325,8,696,2408,3518,1926,51,15,1100,238,3330,33,99
106,344,2,736,3311,4499,2988,49,2,1101,363,4503,33,100
123,496,1,959,3675,5254,3217,65,2,1495,406,5185,33,101
97,471,5,935,3231,4739,2610,90,5,1331,443,4479,33,102
72,363,24,1123,1856,3438,1517,67,0,1297,352,3233,33,103
35,301,27,1640,1802,3805,750,83,3,3021,433,4290,33,104
36,683,1,781,1554,3055,140,136,3,1755,618,2652,33,105
103,309,13,867,2597,3889,1998,46,12,1256,318,3630,33,106
109,485,5,938,3469,5006,3074,57,5,1327,413,4876,33,107
113,499,3,1137,3855,5607,3394,80,2,1279,412,5167,33,108
116,531,2,1071,3288,5008,2836,56,1,1456,510,4859,33,109
75,362,19,945,2130,3531,1491,74,8,1263,446,3282,33,110
18,424,27,603,2815,3887,160,71,8,2653,1902,4794,33,111
11,176,15,395,728,1325,60,37,16,827,202,1142,33,112
100,374,33,663,2345,3515,1958,47,37,1095,346,3483,33,113
109,427,12,803,3353,4704,3156,77,10,1235,322,4800,33,114
148,439,1,988,3401,4977,3079,78,4,1381,339,4881,33,115
133,413,3,1019,3315,4883,2777,61,3,1476,365,4682,33,116
87,326,9,799,1935,3156,1466,93,3,1268,333,3163,33,117
26,202,15,790,1085,2118,265,78,6,1384,271,2004,33,118
14,218,1,375,764,1372,101,125,2,818,227,1273,33,119
71,331,5,635,2448,3490,2018,45,9,961,254,3287,33,120
90,384,4,816,3232,4526,2999,35,3,1215,272,4524,33,121
104,566,5,871,3387,4933,3130,56,3,1201,565,4955,33,122
108,398,29,922,2957,4414,2657,70,30,1220,358,4335,33,123
82,257,17,907,1729,2992,1472,73,6,1086,311,2948,33,124
15,189,15,547,890,1656,140,87,2,1044,268,1541,33,125
18,133,3,617,672,1443,259,28,3,887,153,1330,33,126
80,285,14,632,2518,3529,2094,26,17,1016,264,3417,33,127
134,346,11,807,3303,4601,3121,50,15,1205,292,4683,33,128
112,521,4,906,3618,5161,3182,83,11,1399,344,5019,33,129
95,533,21,845,2942,4436,2638,100,19,1176,418,4351,33,130
77,336,18,913,1953,3297,1512,45,0,1305,333,3195,33,131
44,207,20,584,946,1801,292,52,3,1446,333,2126,33,132
34,171,1,427,737,1370,238,59,2,1223,272,1794,33,133
82,318,4,738,2626,3768,2112,89,5,1075,334,3615,33,134
104,376,2,865,3696,5043,3037,56,1,1309,285,4688,33,135
102,476,8,995,3564,5145,3349,89,8,1550,365,5361,33,136
107,452,4,1087,3000,4650,2874,91,4,1365,385,4719,33,137
65,357,10,811,1930,3173,1493,76,0,1139,425,3133,33,138
23,276,15,694,1392,2400,222,52,2,1491,287,2054,33,139
14,171,6,1333,894,2418,502,55,3,1469,237,2266,33,140
104,298,7,689,2692,3790,1944,51,6,1130,310,3441,33,141
118,357,8,931,3699,5113,3123,66,7,1434,409,5039,33,142
111,407,7,972,3316,4813,3083,49,7,1296,337,4772,33,143
109,360,4,829,2703,4005,2480,69,3,1206,288,4046,33,144
68,290,9,1009,1477,2853,1180,96,4,1022,336,2638,33,145
16,275,11,720,1331,2353,158,84,5,1424,394,2065,33,146
12,315,1,715,1308,2351,112,107,2,1676,413,2310,33,147
17,185,0,613,1729,2544,150,48,0,1925,283,2406,33,148
103,368,7,875,3203,4556,2741,84,4,1179,344,4352,33,149
128,363,1,903,3801,5196,3005,51,2,1431,253,4742,33,150
95,503,2,862,2989,4451,2509,86,2,1374,401,4372,33,151
57,482,32,911,1903,3385,1433,125,6,1132,430,3126,33,152
33,379,15,623,1130,2180,162,101,3,1488,491,2245,33,153
20,177,1,360,843,1401,83,47,4,829,215,1178,33,154
88,293,4,702,2652,3739,2091,82,4,1084,260,3521,33,155
112,520,2,991,3742,5367,3230,129,0,1494,361,5214,33,156
104,531,6,1184,4131,5956,3357,68,2,1551,433,5411,33,157
118,437,8,1060,3397,5020,2886,85,7,1520,374,4872,33,158
79,475,22,1116,2019,3711,1494,128,3,1501,497,3623,33,159
34,689,22,879,3087,4711,218,196,12,1672,981,3079,33,160
19,600,5,619,1437,2680,139,135,5,1793,889,2961,33,161
96,384,6,857,2831,4174,2093,49,7,1164,314,3627,33,162
135,505,4,1073,3828,5545,3287,74,4,1679,347,5391,33,163
136,464,14,1036,3795,5445,3231,91,8,1682,454,5466,33,164
102,626,10,1120,3113,4971,2729,92,8,1620,490,4939,33,165
80,412,15,1130,2034,3671,1546,94,8,1292,516,3456,33,166
27,299,11,648,1219,2204,139,77,10,1502,469,2197,33,167
12,171,2,442,765,1392,93,34,6,931,224,1288,33,168
70,439,8,828,2765,4110,2064,84,7,1202,294,3651,33,169
107,422,11,1531,3202,5273,3132,92,11,1603,375,5213,33,170
18,267,13,823,1153,2274,239,112,14,1310,325,2000,33,171
97,432,6,1150,3356,5041,2612,83,3,1633,453,4784,33,172
71,494,7,994,2213,3779,1497,108,6,1375,504,3490,33,173
18,873,31,878,1261,3061,202,581,3,1694,633,3113,33,174
17,172,9,599,1042,1839,92,61,4,1068,216,1441,33,175
91,371,2,785,2668,3917,1980,62,3,1301,423,3769,33,176
113,452,18,1128,3630,5341,3046,53,18,1621,397,5135,33,177
119,467,21,1166,3611,5384,2999,84,19,1723,387,5212,33,178
99,502,16,1126,3390,5133,2661,80,24,1730,412,4907,33,179
67,509,21,1146,2057,3800,1483,85,0,1565,492,3625,33,180
16,245,15,699,1233,2208,199,59,2,1279,340,1879,33,181
19,175,1,440,993,1628,112,66,1,1056,177,1412,33,182
95,330,35,775,2697,3932,1926,81,32,1316,314,3669,33,183
96,365,7,1045,3625,5138,2709,46,3,1476,375,4609,33,184
93,373,7,1719,2532,4724,2387,119,7,1581,325,4419,33,185
52,4647,8,2843,2339,9889,356,4702,4,4825,2248,12135,33,186
91,379,13,1308,2333,4124,928,94,4,2139,497,3662,33,187
24,245,10,846,1453,2578,245,51,2,1775,369,2442,33,188
20,155,0,466,744,1385,84,60,0,860,198,1202,33,189
75,286,9,811,1841,3022,1238,65,8,1072,310,2693,33,190
0,35,4,3,4,46,1,25,6,2,3,37,33,191
77,373,3,751,1936,3140,1062,78,3,1071,350,2564,33,192
65,390,0,837,2069,3361,1476,94,1,1222,345,3138,33,193
58,274,16,845,2012,3205,1231,66,6,1452,400,3155,33,194
16,293,18,728,1424,2479,158,94,4,1676,416,2348,33,195
31,199,0,492,943,1665,94,54,0,1109,227,1484,33,196
103,324,2,941,2914,4284,2151,72,2,1388,264,3877,33,197
110,425,2,1010,3765,5312,3118,70,2,1555,296,5041,33,198
106,378,1,1217,3941,5643,3365,60,1,1670,273,5369,33,199
121,422,0,1172,3262,4977,2666,73,0,1774,406,4919,33,200
69,454,9,957,1999,3488,1349,112,4,1343,559,3367,33,201
22,219,17,730,1284,2272,159,72,1,1452,356,2040,33,202
13,199,3,574,906,1695,104,66,3,1045,242,1460,33,203
116,332,4,866,2902,4220,2069,70,3,1271,323,3736,33,204
113,398,6,1053,3695,5265,3090,71,8,1509,390,5068,33,205
104,560,1,1111,3963,5739,3033,95,0,1934,569,5631,33,206
117,502,1,1093,3346,5059,2559,60,0,1664,572,4855,33,207
105,447,14,1028,2095,3689,1423,105,12,1402,506,3448,33,208
32,313,19,739,1251,2354,138,94,16,1608,429,2285,33,209
29,175,2,613,1000,1819,81,45,1,1219,221,1567,33,210
111,302,1,798,2810,4022,2039,75,1,1437,265,3817,33,211
111,388,1,1067,3681,5248,3008,82,0,1621,377,5088,33,212
128,399,7,1036,4041,5611,3070,100,8,1631,385,5194,33,213
128,332,1,1038,3199,4698,2657,49,1,1672,349,4728,33,214
76,329,9,1004,2196,3614,1400,92,6,1429,385,3312,33,215
45,221,7,830,1270,2373,157,88,3,1722,328,2298,33,216
19,164,8,539,944,1674,75,58,11,976,242,1362,33,217
79,315,16,751,2744,3905,1907,64,14,1286,313,3584,33,218
132,352,18,1064,3552,5118,2858,56,15,1568,361,4858,33,219
98,350,7,1129,3639,5223,2811,53,7,1671,341,4883,33,220
93,345,14,857,2958,4267,2296,92,15,1287,320,4010,33,221
66,291,7,757,1691,2812,1196,87,13,1339,268,2903,33,222
18,259,18,625,1072,1992,122,89,2,1282,392,1887,33,223
20,188,1,442,769,1420,85,50,1,874,261,1271,33,224
86,327,0,668,2443,3524,1851,67,2,1015,291,3226,33,225
112,401,12,762,3166,4453,2709,72,16,1236,314,4347,33,226
114,402,10,925,3327,4778,2761,83,9,1440,324,4617,33,227
84,339,0,871,2778,4072,2251,55,1,1348,307,3962,33,228
66,418,12,731,1752,2979,1273,109,5,1041,437,2865,33,229
17,252,15,510,1178,1972,92,88,0,1264,331,1775,33,230
10,152,3,375,810,1350,54,34,3,781,145,1017,33,231
88,538,0,626,2265,3517,1758,102,0,1017,195,3072,33,232
97,298,1,788,3073,4257,2620,62,1,1138,308,4129,33,233
102,330,7,778,3135,4352,2746,63,11,1139,253,4212,33,234
119,327,10,768,2533,3757,2178,53,8,1013,334,3586,33,235
63,350,4,786,1625,2828,1274,65,0,950,393,2682,33,236
27,248,12,501,928,1716,97,71,5,1035,283,1491,33,237
20,135,1,433,825,1414,79,47,6,1063,202,1397,33,238
66,258,4,663,2290,3281,1907,49,5,834,226,3021,33,239
102,342,11,800,3201,4456,2818,73,6,1118,246,4261,33,240
101,360,7,912,3305,4685,2852,43,9,1304,297,4505,33,241
106,330,13,795,2724,3968,2336,47,7,1045,282,3717,33,242
54,256,13,1002,1345,2670,1156,64,2,1080,283,2585,33,243
22,247,17,593,1223,2102,131,72,1,1376,358,1938,33,244
10,249,0,587,1044,1890,101,51,1,1232,333,1718,33,245
31,140,0,391,712,1274,94,45,0,793,179,1111,33,246
98,354,4,644,3231,4331,2698,45,2,1172,290,4207,33,247
106,398,5,824,3403,4736,3280,42,6,1092,286,4706,33,248
115,354,10,824,2945,4248,2728,53,6,1168,270,4225,33,249
91,264,8,769,1667,2799,1581,57,5,926,224,2793,33,250
17,225,12,623,796,1673,268,86,8,970,252,1584,33,251
30,154,5,622,560,1371,328,50,0,697,173,1248,33,252
94,286,0,632,2492,3504,2179,41,0,849,264,3333,33,253
121,393,1,850,3450,4815,3186,60,0,1251,258,4755,33,254
110,450,12,870,3514,4956,3215,70,7,1307,294,4893,33,255
114,447,15,821,2961,4358,2737,91,15,1132,399,4374,33,256
58,368,30,832,1788,3076,1466,98,2,958,402,2926,33,257
5,254,16,642,980,1897,178,89,5,1091,321,1684,33,258
13,128,1,439,583,1164,101,31,1,780,193,1106,33,259
89,310,0,698,2405,3502,2097,38,0,971,234,3340,33,260
110,431,2,896,3730,5169,3269,45,2,1233,288,4837,33,261
112,453,4,940,3685,5194,3490,81,3,1381,337,5292,33,262
101,408,2,950,2989,4450,2745,170,3,1298,368,4584,33,263
70,480,15,941,1880,3386,1619,170,9,1188,421,3407,33,264
18,213,24,483,932,1670,148,50,3,1002,335,1538,33,265
11,156,8,304,577,1056,76,28,5,687,197,993,33,266
92,286,8,745,2639,3770,2132,34,8,972,233,3379,33,267
121,462,2,905,3836,5326,3280,67,2,1141,407,4897,33,268
118,433,5,971,3579,5106,3463,53,3,1298,342,5159,33,269
105,415,6,958,2951,4435,2733,52,5,1236,389,4415,33,270
102,322,17,906,1887,3234,1399,102,2,1226,348,3077,33,271
11,373,24,725,1163,2296,165,123,6,1645,451,2390,33,272
20,212,3,478,1205,1918,88,31,6,1368,440,1933,33,273
98,293,4,899,2543,3837,2267,29,8,1118,231,3653,33,274
122,330,17,882,3517,4868,3422,50,13,1170,259,4914,33,275
107,567,11,916,3695,5296,3467,50,4,1401,445,5367,33,276
111,417,17,918,3098,4561,2720,57,13,1322,300,4412,33,277
71,318,40,870,1835,3134,1574,146,5,1163,339,3227,33,278
17,280,20,579,1004,1900,176,104,1,1098,381,1760,33,279
16,204,5,421,759,1405,79,57,2,931,255,1324,33,280
95,356,6,656,2679,3792,2213,43,5,1095,286,3642,33,281
136,499,15,1026,3800,5476,3451,49,14,1540,328,5382,33,282
94,512,11,1008,3773,5398,3438,62,9,1490,459,5458,33,283
104,445,8,1087,3235,4879,2684,78,7,1543,513,4825,33,284
66,338,22,1132,1912,3470,1293,103,3,1527,375,3301,33,285
39,382,16,971,1937,3345,372,102,4,2405,523,3406,33,286
52,209,0,738,1175,2174,339,82,1,1906,432,2760,33,287
50,172,0,660,1169,2051,301,37,0,1158,253,1749,33,288
169,420,7,924,3478,4998,3031,54,5,1148,299,4537,33,289
157,414,3,1175,3911,5660,3577,54,0,1563,319,5513,33,290
105,423,10,997,3247,4782,2701,88,5,1509,407,4710,33,291
69,412,18,998,2088,3585,1498,105,10,1392,406,3411,33,292
26,293,22,900,1197,2438,453,110,3,1362,408,2336,33,293
23,243,2,493,966,1727,91,76,4,1103,229,1503,33,294
86,461,1,666,2558,3772,2093,41,1,1089,375,3599,33,295
119,476,4,842,3546,4987,3240,48,2,1200,342,4832,33,296
103,400,15,913,3883,5314,3401,56,16,1419,395,5287,33,297
113,402,3,968,3174,4660,2733,53,1,1459,324,4570,33,298
65,337,13,924,1895,3234,1512,89,1,1178,345,3125,33,299
16,246,18,612,1180,2072,137,75,5,1268,293,1778,33,300
49,198,0,1950,689,2886,362,54,2,1513,318,2249,33,301
106,334,5,817,2786,4048,2322,51,2,1083,276,3734,33,302
173,4871,3,1104,3202,9353,2971,410,2,1620,6141,11144,33,303
113,454,11,1001,3697,5276,3365,96,5,1238,410,5114,33,304
121,239,1,959,2668,3988,2480,63,3,1028,224,3798,33,305
75,388,11,942,1762,3178,1391,75,5,1081,414,2966,33,306
21,434,37,500,2022,3014,140,86,3,1476,881,2586,33,307
6,124,2,459,719,1310,81,30,2,741,172,1026,33,308
96,266,6,814,2528,3710,2156,31,4,1097,228,3516,33,309
80,237,7,995,2362,3681,2426,50,5,884,181,3546,33,310
113,251,8,702,2610,3684,2451,31,5,857,250,3594,33,311
115,307,11,718,2740,3891,2437,37,13,1010,244,3741,33,312
56,252,8,869,1473,2658,1224,82,3,976,284,2569,33,313
15,243,35,530,1181,2004,148,98,6,1271,270,1793,33,314
17,101,5,629,842,1594,75,33,5,1011,177,1301,33,315
35,153,3,564,742,1497,240,37,7,892,179,1355,33,316
103,397,18,703,3482,4703,3176,49,13,956,309,4503,33,317
79,426,29,895,3692,5121,3445,41,21,1167,332,5006,33,318
111,561,9,875,3325,4881,2728,79,7,1134,434,4382,33,319
64,247,14,965,1748,3038,1532,50,4,962,264,2812,33,320
16,257,43,630,1089,2035,166,57,3,1024,336,1586,33,321
16,136,2,408,701,1263,75,26,0,769,141,1011,33,322
80,268,1,660,2498,3507,2263,36,1,863,262,3425,33,323
126,428,2,866,3536,4958,3327,55,2,1038,270,4692,33,324
92,429,2,917,3534,4974,3323,52,6,1227,308,4916,33,325
90,358,15,844,3038,4345,2635,47,11,1147,280,4120,33,326
65,216,31,871,1705,2888,1438,44,10,907,211,2610,33,327
16,215,24,444,891,1590,105,50,3,942,281,1381,33,328
18,115,5,350,704,1192,69,32,4,715,195,1015,33,329
92,266,21,972,2510,3861,1925,24,10,1207,224,3390,33,330
103,238,22,837,2764,3964,2283,43,3,1194,244,3767,33,331
84,204,9,1240,1407,2944,1324,40,7,1248,236,2855,33,332
177,72,1,354,439,1043,295,20,1,483,95,894,33,333
27,189,10,888,1518,2632,495,43,0,1506,287,2331,33,334
19,164,4,491,1021,1699,100,24,2,1062,225,1413,33,335
17,110,5,281,558,971,73,15,4,538,144,774,33,336
89,281,0,608,2392,3370,2010,66,0,911,215,3202,33,337
138,426,6,780,3690,5040,3347,59,4,1153,311,4874,33,338
115,484,8,979,3708,5294,3510,39,8,1237,414,5208,33,339
109,676,7,1376,3440,5608,2533,122,7,1844,626,5132,33,340
77,417,26,849,1744,3113,1498,71,1,1024,346,2940,33,341
20,389,29,510,918,1866,150,140,0,988,359,1637,33,342
18,234,6,381,728,1367,91,46,6,684,200,1027,33,343
112,333,2,646,2506,3599,2115,126,2,872,250,3365,33,344
116,498,8,955,3765,5342,3379,32,9,1233,395,5048,33,345
120,473,15,1028,4269,5905,3695,63,4,1332,373,5467,33,346
137,594,10,889,3301,4931,2761,75,8,1434,494,4772,33,347
70,419,22,914,1904,3329,1502,217,6,1064,359,3148,33,348
52,463,32,647,1196,2390,95,265,7,1092,491,1950,33,349
41,142,23,411,654,1271,103,44,17,689,210,1063,33,350
91,279,8,680,2496,3554,2114,56,8,985,221,3384,33,351
109,465,6,723,3537,4840,3167,64,4,1248,384,4867,33,352
97,334,11,846,3639,4927,3133,71,10,1316,350,4880,33,353
77,376,30,849,2697,4029,2349,80,35,1123,291,3878,33,354
962,1039,106,1675,2767,6549,3885,733,46,2706,2150,9520,33,355
199,785,80,1073,1096,3233,541,497,48,1863,1284,4233,33,356
214,592,31,1224,946,3007,348,398,23,1448,1503,3720,33,357
594,751,29,1184,2163,4721,2625,352,27,1944,1423,6371,33,358
309,423,18,863,1034,2647,1222,247,14,1236,667,3386,33,359
99,214,10,248,413,984,146,207,8,495,395,1251,33,360
358,694,64,952,1753,3821,1515,392,53,1496,1342,4798,33,361
13,26,11,15,5,70,23,27,23,38,9,120,33,362
22,34,6,32,8,102,14,28,20,39,10,111,33,363
17,22,5,7,2,53,27,16,10,19,10,82,33,364
65,245,1,612,1463,2386,691,36,3,1040,231,2001,33,365
69,153,78,1000,1353,2653,902,86,17,968,208,2181,33,366
195,437,6,978,926,2542,224,331,9,888,853,2305,34,1
834,996,12,1742,4795,8379,4006,512,12,2044,1585,8159,34,2
1028,1351,7,1847,5502,9735,4589,542,13,2327,2139,9610,34,3
1003,1287,34,1989,5642,9955,4723,621,21,2421,1931,9717,34,4
753,1291,50,1914,4474,8482,3453,706,40,2132,1958,8289,34,5
235,811,33,1124,977,3180,343,557,49,1245,922,3116,34,6
235,685,3,1544,1431,3898,268,575,17,1749,1232,3841,34,7
1005,1170,24,1772,5449,9420,4602,669,30,2265,1824,9390,34,8
1232,1084,23,2245,5615,10199,5493,560,12,2416,1588,10069,34,9
1342,1744,36,2244,6642,12008,5449,823,42,2974,2405,11693,34,10
1305,2056,16,2256,6512,12145,5389,894,20,2948,2763,12014,34,11
2780,2130,91,4035,5070,14106,4887,1908,121,4562,5728,17206,34,12
720,1967,105,5799,3412,12003,858,2080,166,3837,7261,14202,34,13
463,1291,20,2893,2214,6881,525,1328,52,3320,3006,8231,34,14
767,1684,19,2746,2747,7963,1300,1412,44,3162,3044,8962,34,15
685,1127,47,1551,2510,5920,1917,769,24,1664,1418,5792,34,16
1265,2604,18,2206,6738,12831,4751,918,38,3825,3089,12621,34,17
1419,2915,18,2579,7712,14643,5875,1173,29,3877,3197,14151,34,18
777,2067,88,2381,3461,8774,2392,1303,117,2426,2242,8480,34,19
483,1426,72,2294,2237,6512,502,1101,89,2137,2202,6031,34,20
320,747,17,2037,2060,5181,325,717,10,2191,1657,4900,34,21
1203,2216,21,2221,6452,12113,5137,705,19,3194,2653,11708,34,22
1502,2630,39,2504,7853,14528,6341,845,27,3731,3118,14062,34,23
1435,2780,35,2542,7650,14442,6136,1002,40,3687,3169,14034,34,24
1383,3038,27,2553,7278,14279,5715,1043,16,3750,3292,13816,34,25
1154,2679,125,3032,5591,12581,3984,1493,85,3482,3143,12187,34,26
393,2205,96,2756,2811,8261,538,1330,89,2927,2811,7695,34,27
323,1000,25,2009,1798,5155,363,798,35,2046,1760,5002,34,28
1230,2388,11,2216,6462,12307,5159,763,10,3296,2789,12017,34,29
1515,3066,24,2456,7889,14950,6448,1019,28,3705,3331,14531,34,30
1534,3190,10,2510,7595,14839,6019,1165,8,3836,3353,14381,34,31
1450,2947,11,2501,7568,14477,5909,1219,20,3867,3204,14219,34,32
1119,2857,78,3114,5708,12876,4201,1857,82,3214,3089,12443,34,33
384,1760,85,2735,3015,7979,564,1212,104,2794,2596,7270,34,34
337,1353,12,2380,2235,6317,362,773,14,2533,2197,5879,34,35
1277,2299,9,2210,6473,12268,5259,787,9,3409,2636,12100,34,36
1501,2966,20,2406,7855,14748,6397,1004,27,3675,3343,14446,34,37
1525,3265,7,2555,7571,14923,6044,888,11,3938,3626,14507,34,38
1477,3286,19,2579,7559,14920,5921,1172,35,3777,3495,14400,34,39
1143,2498,71,3187,5814,12713,4238,1446,100,3296,3076,12156,34,40
405,2042,88,2742,2855,8132,550,1539,101,2916,2666,7772,34,41
293,906,24,2053,2045,5321,340,912,47,1932,1881,5112,34,42
1234,2347,36,2223,6350,12190,5019,828,55,3330,2764,11996,34,43
1461,2816,42,2383,7584,14286,5886,1128,39,3586,3164,13803,34,44
1529,3171,54,2463,7718,14935,5955,1429,68,4152,3447,15051,34,45
1409,2902,16,2542,7558,14427,5654,1151,22,3735,3332,13894,34,46
1197,2360,64,3401,5618,12640,3739,1482,97,3578,3094,11990,34,47
413,1616,91,2991,2627,7738,504,1337,90,3061,2623,7615,34,48
380,1283,18,2640,2710,7031,393,994,39,2706,2391,6523,34,49
564,1110,15,2551,2634,6874,998,1010,35,2602,2339,6984,34,50
1572,2504,12,2548,7544,14180,6296,921,19,3802,3269,14307,34,51
1559,2939,17,2672,7820,15007,6246,1038,24,4014,3462,14784,34,52
1500,3056,33,2678,7433,14700,6041,1101,35,3701,3431,14309,34,53
1183,2602,100,3288,6158,13331,4378,1474,121,3629,3210,12812,34,54
458,1806,90,3009,3242,8605,647,1377,80,3440,2849,8393,34,55
440,1190,6,2344,2247,6227,399,884,15,2754,1988,6040,34,56
1219,2509,5,2446,6600,12779,5467,966,6,3276,2906,12621,34,57
1526,2814,15,2639,7930,14924,6694,860,16,3728,3256,14554,34,58
1569,2784,10,2549,7621,14533,6153,971,9,3715,3102,13950,34,59
1451,2977,36,2636,7618,14718,5982,1164,45,3809,3239,14239,34,60
1127,2405,74,3159,5988,12753,4391,1464,94,3472,3090,12511,34,61
443,1880,113,2555,2523,7514,524,1305,85,2446,2705,7065,34,62
349,1259,5,2544,2457,6614,423,859,16,2844,2328,6470,34,63
1291,2537,8,2468,6876,13180,5404,914,13,3437,3160,12928,34,64
1616,2778,7,2724,8036,15161,6271,1013,7,3765,3459,14515,34,65
1685,3247,18,2785,7653,15388,6190,1234,28,3917,3582,14951,34,66
1626,3438,19,3330,8028,16441,6232,1275,47,4139,3622,15315,34,67
1420,2481,92,3753,6293,14039,4409,1380,84,3355,3158,12386,34,68
583,1447,67,2896,2004,6997,544,1100,52,2228,2178,6102,34,69
395,987,8,2161,2375,5926,351,742,17,2429,2078,5617,34,70
1335,2157,18,2435,5894,11839,4762,1131,26,2713,2685,11317,34,71
1641,2387,17,2750,7401,14196,6011,1242,15,3277,3218,13763,34,72
1637,2501,9,2913,7251,14311,5608,1365,10,3554,3372,13909,34,73
1539,2675,33,2957,6645,13849,5019,1481,50,3461,3513,13524,34,74
1108,2530,59,3176,5063,11936,3616,1527,99,3412,3468,12122,34,75
1045,2532,85,3531,3420,10613,1241,1998,125,4036,3545,10945,34,76
491,1587,15,2476,3135,7704,498,1877,38,3577,2767,8757,34,77
1386,2585,4,2678,6962,13615,5270,1306,16,3894,3378,13864,34,78
1773,3228,7,3120,8411,16539,6577,1336,14,4284,3903,16114,34,79
1829,3751,15,3173,8493,17261,6076,1612,16,4661,4380,16745,34,80
1646,3571,6,3300,8150,16673,6086,1598,20,4466,4335,16505,34,81
1312,3173,105,4045,6772,15407,4505,1743,113,4078,4162,14601,34,82
403,2550,123,2889,3223,9188,585,1879,105,2832,3316,8717,34,83
510,1937,18,3665,4197,10327,484,1351,34,4208,3261,9338,34,84
1368,2893,21,3283,7303,14868,5035,1469,39,4234,3783,14560,34,85
1776,3443,24,3626,8528,17397,6104,1429,28,4642,4429,16632,34,86
1668,3086,12,3333,7447,15546,5661,1338,14,3903,4098,15014,34,87
1499,3395,22,3581,7592,16089,5271,1572,26,4470,4118,15457,34,88
1160,3120,93,4391,6789,15553,3988,1917,101,4771,4241,15018,34,89
587,2725,64,4520,4462,12358,611,1738,79,4681,4060,11169,34,90
528,1401,48,3263,2979,8219,405,1331,59,3408,2393,7596,34,91
1286,2485,28,3241,6636,13676,4744,1348,34,3864,3375,13365,34,92
1739,2723,18,3439,7878,15797,6271,1195,27,4261,3894,15648,34,93
1650,3031,40,3090,7546,15357,5980,1448,43,3930,3823,15224,34,94
1697,3724,31,3895,8279,17626,6061,1700,32,5035,4572,17400,34,95
1380,2954,87,4232,6488,15141,4143,2043,108,4263,4025,14582,34,96
727,2444,90,4142,3773,11176,636,1865,77,4370,3398,10346,34,97
740,1686,25,3120,2896,8467,573,1113,38,3431,2730,7885,34,98
1301,2521,13,3029,6296,13160,5127,1167,35,3673,3088,13090,34,99
1593,3022,17,3027,7894,15553,6359,1291,29,4165,3533,15377,34,100
1591,3222,10,3116,7857,15796,6069,1325,18,4198,3848,15458,34,101
1574,3210,7,3193,7609,15593,6015,1372,11,4090,3539,15027,34,102
1291,2683,90,4063,6246,14373,4461,1726,94,4147,3459,13887,34,103
611,2888,107,3406,3922,10934,786,1814,99,4024,3713,10436,34,104
436,1742,10,2774,3059,8021,438,1035,25,3434,2747,7679,34,105
1264,2709,11,2846,6506,13336,5070,999,15,3791,3081,12956,34,106
1527,3294,16,2887,8137,15861,6369,1274,20,4142,3609,15414,34,107
1557,3539,16,2906,7511,15529,5899,1368,13,4283,3593,15156,34,108
1425,3741,19,3116,7506,15807,5847,1361,25,4406,3687,15326,34,109
1154,2647,75,3437,6500,13813,4360,1731,98,3829,3208,13226,34,110
430,3008,118,3319,3763,10638,608,1955,98,3591,3980,10232,34,111
342,1255,8,2466,2270,6341,384,934,16,2750,2076,6160,34,112
1155,2384,8,2646,6753,12946,5240,982,8,3530,2940,12700,34,113
1464,3253,6,2854,8261,15838,6336,1538,14,4054,3603,15545,34,114
1479,3339,27,2965,7830,15640,6030,1398,27,4276,3601,15332,34,115
1406,3739,12,3257,8091,16505,6019,1539,14,4436,4068,16076,34,116
1170,3360,118,3559,6387,14594,4459,2107,86,4136,3697,14485,34,117
490,2447,89,3299,3414,9739,607,1593,131,3962,3022,9315,34,118
417,1619,11,2740,3783,8570,455,1194,44,3907,2494,8094,34,119
1247,2638,14,2617,6698,13214,4967,1188,16,3686,3099,12956,34,120
1591,2840,19,2966,7604,15020,6209,1362,22,3753,3321,14667,34,121
1579,2914,35,2948,7686,15162,5975,1325,34,3888,3439,14661,34,122
1532,2842,15,3208,7235,14832,5854,1379,16,3890,3458,14597,34,123
1197,2779,79,3524,6141,13720,4213,1673,59,3884,3365,13194,34,124
466,1771,67,2825,2963,8092,634,1402,60,3120,2429,7645,34,125
380,1200,6,2327,2031,5944,447,923,10,2176,1953,5509,34,126
1148,1918,15,2565,6189,11835,4988,992,20,3126,2542,11668,34,127
1539,2691,15,2925,7809,14979,6121,1625,25,3693,3290,14754,34,128
1633,2710,24,2930,7464,14761,5839,1515,21,3547,3413,14335,34,129
1460,2706,9,2803,7090,14068,5520,1338,12,3455,3295,13620,34,130
1097,2339,60,3085,5360,11941,3981,1356,70,3014,2938,11359,34,131
484,1964,52,2778,3695,8973,640,1183,62,3680,2560,8125,34,132
354,1054,5,2197,2110,5720,388,919,5,2363,1820,5495,34,133
1249,2459,11,2791,6103,12613,4991,1237,22,3134,2949,12333,34,134
1641,1884,19,2806,7531,13881,6127,1110,21,3347,2829,13434,34,135
1615,2316,20,2937,6995,13883,5668,1243,32,3509,2971,13423,34,136
1521,3533,27,3050,7252,15383,5830,1391,29,3981,4083,15314,34,137
1044,3019,98,3899,6183,14243,4892,1498,65,4517,3436,14408,34,138
389,2214,89,2278,2427,7397,724,1414,59,2493,2485,7175,34,139
809,1649,19,2622,3513,8612,526,1007,26,4270,2072,7901,34,140
1430,2027,21,2669,6392,12539,5042,1175,32,3082,2713,12044,34,141
1695,2398,8,2933,7613,14647,6382,1284,9,3509,3085,14269,34,142
1648,2554,23,2668,6929,13822,5969,1064,23,3263,3248,13567,34,143
1461,2308,22,2658,6498,12947,5439,991,20,3293,2795,12538,34,144
1059,2197,56,3073,4865,11250,3622,1356,54,3012,2872,10916,34,145
504,2159,57,2726,2691,8137,564,1471,50,3032,2601,7718,34,146
463,1629,4,3011,2839,7946,414,1206,10,3384,2403,7417,34,147
435,1014,3,2369,1811,5632,497,859,9,2110,1957,5432,34,148
1865,1969,27,2584,6840,13285,5689,1034,26,3306,3117,13172,34,149
1870,2099,2,2779,6711,13461,5791,1072,13,3098,3151,13125,34,150
1934,2827,19,2772,6717,14269,5632,1220,32,3490,3735,14109,34,151
1452,2657,78,3058,5234,12479,4051,1674,75,3137,3088,12025,34,152
438,2724,89,2767,2618,8636,640,1395,49,2795,3088,7967,34,153
444,1344,7,2553,2208,6556,429,993,8,2626,2188,6244,34,154
2370,1812,6,2365,6017,12570,4930,1294,8,2766,3435,12433,34,155
2665,2348,23,2516,7419,14971,6103,1722,26,3216,3974,15041,34,156
2768,2327,15,2863,7065,15038,5972,1355,19,3264,3872,14482,34,157
2564,2663,31,2768,7318,15344,5900,1763,42,3191,3974,14870,34,158
1888,3341,109,3071,5984,14393,3894,2433,145,3325,3674,13471,34,159
598,3008,127,3587,3981,11301,649,2539,117,3798,3786,10889,34,160
422,1546,13,3255,3389,8625,389,1372,13,3586,2895,8255,34,161
2295,1851,11,2571,6004,12732,4973,1166,13,2912,3545,12609,34,162
2835,2529,10,3070,7504,15948,6183,1851,15,3633,3978,15660,34,163
2837,2986,14,2926,7860,16623,5764,2488,35,3603,4238,16128,34,164
2740,2833,19,3050,7084,15726,5737,1660,18,3623,4040,15078,34,165
1998,2742,111,3229,5795,13875,4005,2201,119,3281,3512,13118,34,166
563,2056,134,3178,3028,8959,658,1740,125,3023,2859,8405,34,167
432,1357,16,2645,2210,6660,438,1051,13,2518,2258,6278,34,168
2278,1792,5,2632,5767,12474,4862,1164,14,2954,3316,12310,34,169
2748,2576,20,3002,6927,15273,5828,1973,19,3240,3899,14959,34,170
1083,1759,12,3027,2975,8856,1420,1537,23,2715,3055,8750,34,171
2619,2608,13,2791,6357,14388,5084,1538,23,3197,4036,13878,34,172
1858,2670,100,3178,4894,12700,3887,1735,117,3080,3322,12141,34,173
619,2525,141,3202,2593,9080,656,2264,255,2987,2407,8569,34,174
375,1379,10,2459,2156,6379,408,1035,25,2610,2213,6291,34,175
2256,1852,6,2514,5715,12343,4734,1202,18,2975,3312,12241,34,176
2818,2602,20,2796,7214,15450,5943,1795,26,3322,3964,15050,34,177
2854,2647,12,2839,6830,15182,5663,1567,15,3445,4221,14911,34,178
2720,3161,13,2713,6866,15473,5354,1825,20,3368,4260,14827,34,179
1964,3303,81,3316,5502,14166,3905,2238,87,3443,3750,13423,34,180
617,2433,90,3310,2931,9381,646,1669,104,3103,2958,8480,34,181
415,1287,57,2800,2044,6603,400,992,64,2590,2162,6208,34,182
2122,1938,12,2684,5988,12744,4612,1396,25,2846,3305,12184,34,183
2513,2328,11,3022,7137,15011,5648,1726,23,3204,3912,14513,34,184
2155,2770,16,3271,6637,14849,4736,2213,34,3704,3707,14394,34,185
664,7180,38,3646,3357,14885,495,5874,45,3502,4573,14489,34,186
969,2552,56,3773,4083,11433,2376,1948,65,3232,3045,10666,34,187
532,1890,58,3096,2467,8043,600,1642,89,2743,2640,7714,34,188
413,1171,17,2637,2050,6288,443,1142,17,2480,2131,6213,34,189
2175,1814,7,2562,5688,12246,4732,1288,8,2842,3215,12085,34,190
2779,2349,24,2789,6880,14821,5724,1617,27,3465,4007,14840,34,191
2760,2529,12,2869,6933,15103,5664,1406,22,3323,4199,14614,34,192
2609,2785,10,2901,6670,14975,5173,1605,23,3594,3998,14393,34,193
1770,2181,92,2985,5113,12141,3729,1473,87,2942,3411,11642,34,194
502,2239,95,3246,2820,8902,531,1689,129,3020,2903,8272,34,195
481,1372,15,2531,2004,6403,362,1143,21,2528,2176,6230,34,196
2169,1721,30,2566,5882,12368,4948,1115,32,2790,3212,12097,34,197
2675,2060,22,2686,6983,14426,5881,1563,27,3125,3625,14221,34,198
2702,1816,22,2774,6873,14187,5608,1244,26,3241,3716,13835,34,199
2604,2449,11,2944,6852,14860,5342,1565,5,3351,3931,14194,34,200
1735,2259,100,3229,5705,13028,3743,2065,216,3171,3101,12296,34,201
576,1825,108,3294,2897,8700,556,1890,119,2988,2638,8191,34,202
420,1305,13,2808,2360,6906,419,1162,16,2661,2362,6620,34,203
2207,1759,14,2565,5754,12299,4735,1272,14,2783,3336,12140,34,204
2702,2523,21,3007,7503,15756,5696,1942,18,3437,4088,15181,34,205
2453,2834,34,3226,7467,16014,5488,1958,63,3554,4237,15300,34,206
2682,2753,16,3331,6828,15610,5294,1635,17,3579,4149,14674,34,207
1718,2918,99,3309,5317,13361,3831,1926,149,3418,3524,12848,34,208
505,2340,87,3241,3244,9417,569,1630,172,3096,2918,8385,34,209
368,1685,3,2634,2487,7177,338,1163,21,2905,2521,6948,34,210
1907,1674,12,2550,5927,12070,4793,1125,29,2810,3008,11765,34,211
2427,2278,17,2664,6943,14329,5596,1394,10,3009,3908,13917,34,212
2390,2296,20,2636,6428,13770,5332,1302,18,3006,3655,13313,34,213
2242,2397,20,2699,6264,13622,5202,1399,25,3146,3521,13293,34,214
1512,2332,69,2945,4917,11775,3751,1746,69,2954,3131,11651,34,215
650,1480,64,2787,2390,7371,964,1013,63,2693,2278,7011,34,216
377,1608,13,2194,2071,6263,411,968,20,2388,2061,5848,34,217
1311,1774,11,2455,5441,10992,4470,1056,10,2664,2465,10665,34,218
1694,2254,21,2624,6746,13339,5445,1301,28,3051,2939,12764,34,219
1674,2135,5,2692,6329,12835,5230,1155,26,3083,3064,12558,34,220
1495,1935,6,2593,5811,11840,4708,982,8,3014,2806,11518,34,221
856,2063,56,2343,4109,9427,3028,1263,94,2315,2299,8999,34,222
494,1974,60,2393,2671,7592,568,1394,41,2688,2405,7096,34,223
379,1166,3,2124,2239,5911,374,892,10,2554,1728,5558,34,224
1105,1747,8,2280,5500,10640,4551,879,10,2705,2197,10342,34,225
1485,2133,15,2503,6715,12851,5447,1006,14,3189,2701,12357,34,226
1475,2324,6,2802,6459,13066,5377,1067,15,3310,2950,12719,34,227
1443,2343,12,2875,6328,13001,5295,1118,24,3286,2971,12694,34,228
959,2418,72,3340,5017,11806,3753,1357,52,3307,2742,11211,34,229
415,1736,60,2862,2761,7834,667,1124,67,3023,2512,7393,34,230
342,1249,16,2273,2561,6441,563,910,18,2508,2079,6078,34,231
1124,1923,15,2995,6318,12375,4716,1369,14,3376,2837,12312,34,232
1464,2633,32,3292,7667,15088,5673,1625,46,3793,3470,14607,34,233
1435,2548,21,3504,7580,15088,5558,1498,37,3870,3328,14291,34,234
1347,3535,12,2935,7227,15056,5254,1363,14,4100,3581,14312,34,235
949,2925,111,3706,5771,13462,3980,1799,123,3617,3349,12868,34,236
512,2635,97,3271,3000,9515,652,1718,140,3228,2963,8701,34,237
433,1376,11,3435,2719,7974,406,1122,67,3388,2536,7519,34,238
1164,2756,10,2666,7110,13706,5458,1304,12,3708,2981,13463,34,239
1406,3278,25,2930,8477,16116,6459,1490,28,4253,3471,15701,34,240
1483,3425,20,2813,8043,15784,6287,1357,26,4008,3722,15400,34,241
1409,3043,20,2969,8214,15655,6075,1199,18,4400,3371,15063,34,242
1065,2547,58,4188,5546,13404,4009,1715,171,3585,3140,12620,34,243
616,2061,116,3263,3279,9335,613,1618,110,3075,3122,8538,34,244
439,1924,11,3122,3006,8502,388,1600,24,2930,2816,7758,34,245
390,1257,13,2647,2406,6713,446,1220,22,2458,2155,6301,34,246
1374,3125,17,2721,8003,15240,6532,990,17,4180,3125,14844,34,247
1435,3686,37,2860,8216,16234,6705,1165,35,4139,3688,15732,34,248
1459,3422,29,2825,7995,15730,6499,1215,46,4074,3484,15318,34,249
1144,3073,116,3384,6435,14152,4529,1743,152,3724,3285,13433,34,250
553,2053,127,3250,3368,9351,630,1787,153,3514,2770,8854,34,251
434,1215,19,2579,2522,6769,408,966,20,2899,2250,6543,34,252
1368,3028,6,2562,7211,14175,5869,1202,9,3791,3221,14092,34,253
1682,3616,17,2859,8597,16771,7198,1323,23,4322,3638,16504,34,254
1708,3541,6,2904,8729,16888,6789,1419,14,4636,3819,16677,34,255
1690,3825,22,3153,8296,16986,6426,1546,24,4446,3900,16342,34,256
1262,2939,141,3742,6799,14883,4652,1928,129,3738,3571,14018,34,257
594,2389,146,3361,3561,10051,707,2155,156,3399,3256,9673,34,258
477,1417,12,3325,2447,7678,734,1128,22,2912,2496,7292,34,259
1418,3043,16,2721,7316,14514,5867,1052,16,4016,3375,14326,34,260
1784,3449,18,2889,8801,16941,7113,1231,14,4293,3803,16454,34,261
1804,3795,8,2942,8610,17159,6722,1379,13,4370,4065,16549,34,262
1795,3969,23,3210,8422,17419,6434,1699,41,4540,4240,16954,34,263
1373,3189,108,3898,6659,15227,4859,1801,146,3957,3729,14492,34,264
637,2346,161,3618,3781,10543,609,1814,163,3939,3260,9785,34,265
408,1530,9,2884,2635,7466,422,1260,16,3077,2355,7130,34,266
1414,2906,10,2729,7197,14256,5809,1091,24,3936,3366,14226,34,267
1600,3592,6,3061,8696,16955,6954,1368,17,4439,3842,16620,34,268
1758,3822,14,2931,8553,17078,6762,1363,21,4425,3983,16554,34,269
1581,3924,24,3029,8232,16790,6268,1491,26,4378,4071,16234,34,270
1295,2843,110,3621,6595,14464,4663,2035,141,3714,3241,13794,34,271
597,2889,131,3550,3519,10686,693,2149,159,3660,3413,10074,34,272
432,1409,8,2853,2584,7286,565,1050,16,2907,2424,6962,34,273
1342,2899,10,2815,7116,14182,5834,980,13,3783,3194,13804,34,274
1709,3420,9,2897,8245,16280,6839,1149,19,4220,3615,15842,34,275
1689,3467,15,3051,8572,16794,6910,1334,27,4393,3658,16322,34,276
1498,4246,8,3053,8172,16977,6287,1416,17,4558,4317,16595,34,277
1211,3379,116,3719,6520,14945,4643,1864,120,3891,3752,14270,34,278
630,2701,128,3518,3484,10461,683,1964,101,3510,3398,9656,34,279
565,1449,6,2684,2721,7425,455,1094,29,3129,2543,7250,34,280
1463,3017,8,3045,7423,14956,5998,1083,8,4146,3498,14733,34,281
1686,3618,5,2401,8612,16322,7113,1326,11,3569,3961,15980,34,282
1754,3728,12,3626,9416,18536,6749,1327,32,4601,3912,16621,34,283
1930,2887,15,3718,7510,16060,5745,1486,33,3852,3832,14948,34,284
1223,2510,91,3901,5735,13460,3944,1706,105,3882,3419,13056,34,285
784,2394,66,3209,3448,9901,599,1936,105,3478,3051,9169,34,286
752,1807,16,3162,3192,8929,545,1987,26,4131,3289,9978,34,287
1030,2847,5,3165,5178,12225,3072,1093,6,4333,3711,12215,34,288
1695,3617,16,3152,8836,17316,7040,1460,22,4623,4082,17227,34,289
1808,3637,16,3328,8739,17528,6980,1365,22,4876,4024,17267,34,290
1654,3891,10,3212,8555,17322,6459,1662,24,4610,4275,17030,34,291
1286,3741,117,4060,7094,16298,4733,2127,149,4342,4127,15478,34,292
612,3245,156,3861,4257,12131,753,2208,146,4595,3530,11232,34,293
407,1698,4,3025,3223,8357,489,1279,12,3447,2661,7888,34,294
1262,3057,9,3004,7705,15037,6004,1267,12,4154,3304,14741,34,295
1625,3733,20,2976,8703,17057,7118,1201,20,4542,3967,16848,34,296
1641,3955,16,3128,9030,17770,6970,1370,25,4610,4200,17175,34,297
1505,3729,10,3089,8733,17066,6618,1597,18,4462,3804,16499,34,298
1223,3303,108,4052,7096,15782,5095,1781,137,4101,3812,14926,34,299
502,2582,135,3547,3385,10151,703,1793,141,3714,3500,9851,34,300
1587,1380,5,5906,3782,12660,4652,1390,21,5139,2815,14017,34,301
1335,2977,15,2846,7545,14718,5771,1084,17,4046,3556,14474,34,302
1704,4277,9,3361,8582,17933,6933,1353,14,4507,4199,17006,34,303
1710,3531,5,3063,8929,17238,6851,1336,17,4527,3919,16650,34,304
1624,3664,20,3328,8411,17047,6245,1742,24,4270,3882,16163,34,305
1158,2864,186,3685,6478,14371,4445,1763,164,4133,3250,13755,34,306
478,2381,156,2822,3273,9110,683,1781,131,3090,2867,8552,34,307
419,1259,10,2614,2567,6869,521,1059,12,2916,2208,6716,34,308
1287,2962,12,2754,6997,14012,5528,1014,18,3961,3247,13768,34,309
1447,1609,13,3150,6025,12244,4765,1129,59,3218,2775,11946,34,310
1443,2716,6,2797,7482,14444,5892,1104,6,3951,3162,14115,34,311
1548,3269,13,3072,8142,16044,6303,1299,17,4343,3551,15513,34,312
1191,2849,129,3553,6592,14314,4363,1680,98,4047,3369,13557,34,313
542,2128,140,3362,3578,9750,717,1513,104,3743,3213,9290,34,314
435,1073,9,2929,2427,6873,477,915,20,2790,2620,6822,34,315
762,2736,3,2777,5032,11310,3263,941,7,3963,2818,10992,34,316
1637,3447,28,3071,8526,16709,7052,1079,48,4263,3978,16420,34,317
1760,3255,24,2851,9019,16909,6903,1204,44,4564,3892,16607,34,318
1737,3280,19,3264,8323,16623,6442,1172,25,4396,3855,15890,34,319
1317,3067,122,3712,6661,14879,4576,1577,114,4063,3896,14226,34,320
465,1979,107,3438,3406,9395,614,1475,105,3369,3282,8845,34,321
380,1238,14,2510,2896,7038,442,1066,25,3144,2174,6851,34,322
1312,3008,7,2783,7133,14243,5857,1044,16,3947,3392,14256,34,323
1675,3333,6,3021,8676,16711,6967,1065,11,4449,3845,16337,34,324
1743,3193,10,3175,8583,16704,6868,1142,23,4401,3736,16170,34,325
1746,3526,23,3102,8467,16864,6250,1427,26,4207,3840,15750,34,326
1460,2350,53,4013,6382,14258,4609,1284,80,3365,2649,11987,34,327
587,1816,76,2880,2957,8316,533,1221,103,2649,2479,6985,34,328
363,1273,13,2039,2130,5818,339,718,16,2088,1832,4993,34,329
1167,1587,18,2583,6144,11499,4779,744,17,3181,2009,10730,34,330
1047,1715,40,2679,6525,12006,5002,788,50,3079,2281,11200,34,331
811,1434,8,3300,3574,9127,3008,678,12,2637,1836,8171,34,332
277,464,3,1059,812,2615,198,416,6,844,779,2243,34,333
500,1201,34,1951,2415,6101,1126,956,51,2518,2000,6651,34,334
261,1274,36,1548,2081,5200,471,1109,63,2529,2210,6382,34,335
271,1036,13,1598,1880,4798,515,1501,25,2725,2429,7195,34,336
1152,2578,24,2281,6684,12719,5434,1013,32,4038,3176,13693,34,337
1571,2862,13,2628,8484,15558,6657,1200,24,4334,3487,15702,34,338
1690,3040,20,2928,8279,15957,6567,1193,26,4260,3744,15790,34,339
1535,3266,17,3030,8385,16233,6020,1447,21,4079,3972,15539,34,340
1313,2786,130,3425,6499,14153,4653,1720,152,3692,3434,13651,34,341
414,2263,78,2892,3793,9440,585,2396,130,3400,2965,9476,34,342
322,1354,13,2441,2769,6899,404,1241,17,2791,2262,6715,34,343
1358,2671,14,2562,7042,13647,5504,1174,17,3684,3179,13558,34,344
1817,2959,20,2974,8577,16347,6733,1295,22,4336,3592,15978,34,345
1856,2632,26,2885,7618,15017,6163,1373,39,3735,3413,14723,34,346
1727,2973,32,3134,7683,15549,6072,1440,51,4140,3348,15051,34,347
1246,2921,108,3599,6375,14249,4397,1709,93,3834,3397,13430,34,348
707,2167,89,3490,3567,10020,634,2038,122,3416,2921,9131,34,349
430,1129,14,2560,2321,6454,378,884,20,2476,2004,5762,34,350
1177,2102,13,2713,6705,12710,5110,965,20,3313,2484,11892,34,351
1665,2716,13,3036,7916,15346,6055,1346,17,3501,3111,14030,34,352
1675,2102,2,2901,7143,13823,5684,998,10,3170,2594,12456,34,353
1190,2151,29,2398,6460,12228,5063,939,36,3062,2576,11676,34,354
2066,3084,196,3749,6767,15862,5197,2104,142,4965,5454,17862,34,355
582,2220,128,3102,3878,9910,650,1688,82,4773,3423,10616,34,356
464,1926,35,2347,3421,8193,485,1135,17,4185,2779,8601,34,357
1440,1874,46,3141,5486,11987,3389,1209,31,4382,3263,12274,34,358
1066,904,17,2388,2205,6580,1427,786,13,2373,1759,6358,34,359
259,605,22,1139,1064,3089,316,642,10,1368,1362,3698,34,360
955,1615,42,2248,4202,9062,2274,1367,23,4148,2988,10800,34,361
1139,1996,92,2805,4859,10891,2372,1645,50,5279,3674,13020,34,362
484,1923,125,2343,2889,7764,642,1714,71,3981,2550,8958,34,363
452,1473,612,2435,3554,8526,652,1305,159,4387,2917,9420,34,364
676,1509,18,2082,3613,7898,2215,718,24,2546,1944,7447,34,365
565,1560,450,2220,2474,7269,2001,1174,339,1954,1849,7317,34,366
50,24,1,166,50,291,16,66,5,93,138,318,35,1
550,49,4,254,155,1012,66,155,8,134,600,963,35,2
731,50,5,263,200,1249,70,275,14,122,725,1206,35,3
699,52,41,218,148,1158,75,212,37,149,661,1134,35,4
422,49,12,222,251,956,74,200,39,155,430,898,35,5
68,31,1,134,101,335,16,105,13,91,89,314,35,6
41,36,10,244,68,399,14,106,13,81,192,406,35,7
618,36,8,186,133,981,79,185,13,122,587,986,35,8
885,41,14,216,90,1246,72,134,18,259,700,1183,35,9
911,55,4,253,141,1364,83,234,11,159,858,1345,35,10
788,80,19,271,222,1380,72,315,26,121,774,1308,35,11
460,80,2,220,157,919,80,176,23,156,438,873,35,12
68,210,70,402,616,1366,312,131,16,942,406,1807,35,13
52,216,25,321,308,922,165,126,11,411,261,974,35,14
92,45,4,218,94,453,41,119,7,100,177,444,35,15
210,39,1,169,153,572,64,165,10,96,191,526,35,16
655,48,4,258,153,1118,61,213,9,152,676,1111,35,17
843,44,2,253,172,1314,71,308,10,141,775,1305,35,18
214,47,4,181,125,571,53,131,20,95,210,509,35,19
70,31,2,212,177,492,27,171,23,99,159,479,35,20
69,32,11,179,99,390,16,110,11,104,160,401,35,21
652,39,10,216,142,1059,94,169,12,112,627,1014,35,22
969,47,4,237,160,1417,99,283,9,133,849,1373,35,23
955,45,14,286,197,1497,75,340,16,144,881,1456,35,24
859,51,4,251,142,1307,77,276,16,141,758,1268,35,25
480,69,12,241,234,1036,73,222,49,171,488,1003,35,26
9,2,0,1,1,13,12,8,2,4,7,33,35,27
0,0,2,0,2,4,1,8,2,2,6,19,35,28
641,34,2,278,127,1082,76,180,5,159,624,1044,35,29
981,36,0,223,158,1398,92,256,10,137,887,1382,35,30
975,52,13,300,187,1527,86,302,15,176,863,1442,35,31
865,60,20,284,220,1449,96,292,27,200,773,1388,35,32
450,56,8,228,237,979,91,217,35,142,441,926,35,33
99,57,3,309,161,629,24,168,29,163,246,630,35,34
63,27,18,242,79,429,9,93,20,121,186,429,35,35
628,48,11,199,151,1037,83,169,14,101,601,968,35,36
972,45,5,241,211,1474,94,294,13,148,881,1430,35,37
963,35,11,257,217,1483,90,294,18,131,885,1418,35,38
887,33,14,242,179,1355,94,253,24,200,760,1331,35,39
481,66,1,233,223,1004,80,224,17,162,431,914,35,40
51,41,2,167,93,354,16,91,17,76,112,312,35,41
40,21,4,108,75,248,13,48,26,66,104,257,35,42
628,40,1,194,149,1012,73,185,7,123,581,969,35,43
849,62,15,253,172,1351,87,333,19,135,634,1208,35,44
900,54,7,265,188,1414,88,207,18,170,885,1368,35,45
850,42,7,241,168,1308,90,274,15,146,768,1293,35,46
452,59,4,211,215,941,64,209,17,189,381,860,35,47
78,46,1,259,130,514,13,140,25,109,182,469,35,48
65,42,2,241,84,434,11,109,8,133,168,429,35,49
140,31,7,296,122,596,45,122,7,157,268,599,35,50
956,46,1,226,229,1458,77,311,4,162,885,1439,35,51
914,45,2,249,188,1398,79,295,11,140,809,1334,35,52
861,37,6,251,224,1379,64,322,14,165,781,1346,35,53
487,52,2,266,162,969,74,156,20,195,456,901,35,54
104,71,2,300,230,707,24,212,15,150,252,653,35,55
78,54,6,212,121,471,13,131,12,142,173,471,35,56
662,37,7,200,179,1085,76,241,7,137,595,1056,35,57
980,50,2,222,190,1444,103,278,13,134,852,1380,35,58
932,44,10,248,155,1389,78,261,13,140,860,1352,35,59
855,67,9,240,191,1362,66,319,17,143,781,1326,35,60
490,55,1,240,263,1049,66,274,22,134,487,983,35,61
94,46,0,228,150,518,9,159,19,129,188,504,35,62
59,47,0,285,110,501,22,96,5,123,228,474,35,63
666,32,3,203,146,1050,76,189,8,147,623,1043,35,64
968,40,1,240,179,1428,98,269,3,145,858,1373,35,65
961,44,3,325,189,1522,69,318,6,228,878,1499,35,66
838,68,2,271,213,1392,85,311,4,178,778,1356,35,67
462,60,2,272,256,1052,60,233,33,198,464,988,35,68
112,56,1,329,201,699,16,252,29,119,246,662,35,69
80,34,2,227,104,447,13,101,6,112,244,476,35,70
640,46,1,273,131,1091,69,218,6,139,629,1061,35,71
967,54,21,280,185,1507,96,295,27,140,911,1469,35,72
1017,54,22,303,218,1614,90,336,38,170,918,1552,35,73
881,86,8,324,240,1539,85,386,20,177,793,1461,35,74
469,67,3,299,298,1136,85,237,55,179,509,1065,35,75
183,120,7,518,229,1057,15,326,45,228,403,1017,35,76
58,53,18,357,173,659,17,193,15,134,267,626,35,77
649,40,18,238,155,1100,76,211,10,142,629,1068,35,78
967,42,1,318,207,1535,90,320,6,170,898,1484,35,79
977,49,2,368,255,1651,92,372,15,179,930,1588,35,80
870,55,4,356,268,1553,98,368,11,176,831,1484,35,81
512,56,6,325,318,1217,87,305,38,171,535,1136,35,82
97,62,2,360,209,730,15,206,34,120,317,692,35,83
108,42,6,449,133,738,18,182,6,197,340,743,35,84
637,34,13,419,204,1307,79,274,38,187,705,1283,35,85
874,44,9,474,210,1611,112,317,19,183,923,1554,35,86
829,32,3,340,184,1388,79,275,12,211,821,1398,35,87
735,56,1,345,164,1301,79,230,12,188,727,1236,35,88
381,64,3,430,234,1112,67,223,21,227,539,1077,35,89
101,51,5,550,272,979,10,295,35,223,418,981,35,90
54,73,2,239,142,510,17,154,9,148,264,592,35,91
595,48,1,433,152,1229,80,316,7,181,611,1195,35,92
961,51,5,288,198,1503,100,356,16,169,839,1480,35,93
932,42,27,304,216,1521,84,384,36,152,833,1489,35,94
940,45,4,348,274,1611,121,383,17,192,840,1553,35,95
517,73,11,326,252,1179,94,262,35,192,512,1095,35,96
182,63,7,366,193,811,48,200,34,275,220,777,35,97
180,36,7,334,175,732,25,201,14,245,267,752,35,98
681,52,8,323,149,1213,89,192,19,188,621,1109,35,99
956,62,11,275,214,1518,110,311,34,183,892,1530,35,100
988,64,4,340,198,1594,99,323,14,207,887,1530,35,101
928,55,5,320,177,1485,112,329,27,202,761,1431,35,102
575,71,23,305,264,1238,105,268,49,263,505,1190,35,103
124,78,7,393,246,848,34,283,47,218,265,847,35,104
73,43,3,294,120,533,16,145,17,172,237,587,35,105
673,51,3,288,209,1224,98,283,12,173,609,1175,35,106
999,80,6,292,209,1586,82,317,11,191,925,1526,35,107
1014,47,13,318,214,1606,95,375,18,182,860,1530,35,108
912,57,14,332,238,1553,105,371,23,198,798,1495,35,109
523,59,2,298,283,1165,85,249,34,188,529,1085,35,110
97,91,2,577,248,1015,29,343,49,159,362,942,35,111
61,42,1,273,120,497,8,144,6,126,222,506,35,112
644,51,6,254,127,1082,74,194,6,170,628,1072,35,113
967,66,3,298,237,1571,83,366,8,180,896,1533,35,114
998,60,7,310,236,1611,93,377,13,201,876,1560,35,115
1040,70,6,372,236,1724,115,372,20,269,910,1686,35,116
510,85,5,268,379,1247,83,360,25,198,559,1225,35,117
77,71,18,307,262,735,14,264,41,141,251,711,35,118
84,51,7,263,141,546,28,171,22,134,208,563,35,119
641,53,13,245,129,1081,94,208,19,151,592,1064,35,120
1006,60,2,323,183,1574,103,306,10,221,904,1544,35,121
956,54,8,296,209,1523,104,315,18,168,868,1473,35,122
919,68,6,313,204,1510,106,321,15,197,859,1498,35,123
512,76,5,272,262,1127,100,261,30,194,467,1052,35,124
123,76,5,263,170,637,30,211,27,166,198,632,35,125
62,34,4,230,117,447,10,145,7,122,206,490,35,126
717,53,5,249,145,1169,93,233,11,157,622,1116,35,127
980,56,10,291,266,1603,94,412,8,165,875,1554,35,128
962,59,6,313,272,1612,85,409,18,176,875,1563,35,129
910,62,5,293,204,1474,104,307,18,156,840,1425,35,130
520,58,1,264,183,1026,97,189,30,179,479,974,35,131
100,96,6,368,152,722,28,199,25,151,325,728,35,132
83,53,4,243,99,482,19,106,11,153,203,492,35,133
713,61,5,251,173,1203,89,212,9,155,669,1134,35,134
954,51,27,300,168,1500,86,244,31,206,916,1483,35,135
975,53,6,268,185,1487,91,289,12,152,881,1425,35,136
901,60,8,317,205,1491,91,342,18,194,823,1468,35,137
513,77,2,267,226,1085,91,216,20,198,532,1057,35,138
63,47,3,155,100,368,19,107,29,81,97,333,35,139
44,29,4,116,78,271,17,59,9,69,120,274,35,140
690,64,5,244,164,1167,91,204,8,198,628,1129,35,141
963,68,6,289,216,1542,84,324,14,203,871,1496,35,142
963,62,23,334,188,1570,100,294,34,193,908,1529,35,143
849,58,5,249,185,1346,106,267,11,179,769,1332,35,144
440,95,14,234,327,1110,79,311,51,202,372,1015,35,145
84,66,8,416,235,809,31,349,32,158,207,777,35,146
63,58,2,300,120,543,27,174,16,125,264,606,35,147
77,55,1,221,89,443,27,94,9,137,161,428,35,148
897,46,12,278,168,1401,91,234,8,140,798,1271,35,149
906,47,34,296,178,1461,106,281,17,194,791,1389,35,150
1334,83,20,395,201,2033,211,360,26,256,780,1633,35,151
523,117,20,243,252,1155,92,256,34,230,492,1104,35,152
71,37,16,23,27,174,49,28,9,16,33,135,35,153
64,47,33,42,34,220,59,25,59,52,40,235,35,154
72,37,28,74,38,249,56,26,28,91,39,240,35,155
50,59,26,25,35,195,60,46,20,32,49,207,35,156
93,41,25,58,47,264,76,36,33,75,49,269,35,157
81,58,26,74,37,276,63,44,26,76,60,269,35,158
92,26,16,88,72,294,88,31,17,95,66,297,35,159
84,40,20,58,46,248,65,31,35,58,51,240,35,160
67,33,22,51,61,234,49,32,22,68,50,221,35,161
84,35,22,59,41,241,80,28,26,72,42,248,35,162
99,47,7,42,40,235,101,44,10,51,36,242,35,163
80,45,24,80,56,285,75,37,24,82,53,271,35,164
76,32,6,60,61,235,67,35,19,81,57,259,35,165
67,15,27,45,63,217,62,22,28,44,46,202,35,166
91,20,15,71,47,244,72,27,1,67,72,239,35,167
53,13,13,32,48,159,40,16,16,40,47,159,35,168
98,40,13,59,55,265,79,46,18,67,42,252,35,169
99,33,17,74,55,278,86,35,3,77,47,248,35,170
92,28,8,66,43,237,89,27,15,82,37,250,35,171
115,27,23,78,58,301,80,30,14,97,60,281,35,172
98,30,20,54,76,278,122,29,33,49,55,288,35,173
87,25,26,45,46,229,73,37,12,48,49,219,35,174
72,60,46,42,61,281,70,62,44,58,38,272,35,175
122,75,22,124,97,440,112,91,15,136,101,455,35,176
214,60,31,107,73,485,160,53,35,161,64,473,35,177
120,41,14,74,45,294,98,50,24,89,58,319,35,178
122,43,5,90,39,299,87,38,7,93,52,277,35,179
116,46,12,60,44,278,103,42,21,63,43,272,35,180
71,25,12,45,33,186,53,38,4,47,35,177,35,181
93,36,15,48,76,268,74,39,27,52,68,260,35,182
112,19,8,76,91,306,102,43,16,88,71,320,35,183
125,44,14,82,78,343,110,70,19,92,61,352,35,184
131,46,10,75,66,328,108,54,21,96,63,342,35,185
50,23,7,44,21,145,49,20,15,47,25,156,35,186
75,31,20,45,70,241,49,49,17,58,57,230,35,187
66,47,3,27,54,197,51,53,11,40,59,214,35,188
67,38,32,37,60,234,48,49,32,32,60,221,35,189
123,34,27,88,65,337,106,48,48,85,63,350,35,190
119,34,14,86,81,334,80,50,23,100,85,338,35,191
113,26,18,82,48,287,92,36,13,107,39,287,35,192
155,40,25,92,38,350,154,44,18,100,54,370,35,193
119,23,11,104,55,312,103,20,31,108,67,329,35,194
120,29,11,81,72,313,93,28,23,103,76,323,35,195
49,30,38,48,61,226,38,25,47,38,81,229,35,196
119,33,23,82,63,320,97,39,15,88,73,312,35,197
96,63,18,56,43,276,103,35,34,61,57,290,35,198
112,41,27,69,53,302,127,30,33,90,37,317,35,199
98,45,6,44,49,242,96,35,14,51,52,248,35,200
79,45,12,56,48,240,88,35,40,57,51,271,35,201
88,35,25,56,63,267,72,36,34,57,68,267,35,202
54,41,97,30,53,275,59,38,99,35,60,291,35,203
156,38,16,63,48,321,128,27,25,91,62,333,35,204
87,45,9,120,55,316,87,38,32,124,63,344,35,205
81,54,8,77,59,279,71,40,13,77,63,264,35,206
84,36,27,49,65,261,92,36,28,50,73,279,35,207
77,48,11,34,49,219,88,39,31,38,55,251,35,208
79,33,19,42,66,239,69,48,17,60,57,251,35,209
51,35,9,42,65,202,53,52,9,50,64,228,35,210
83,36,33,67,66,285,59,58,33,70,63,283,35,211
75,53,13,110,60,311,69,59,23,120,44,315,35,212
83,49,34,50,57,273,55,49,41,64,53,262,35,213
108,44,16,64,37,269,73,32,36,96,46,283,35,214
108,25,18,47,49,247,82,31,27,67,60,267,35,215
63,36,10,49,40,198,49,23,18,62,52,204,35,216
28,22,8,25,31,114,25,23,17,29,25,119,35,217
57,28,14,58,37,194,54,29,24,61,44,212,35,218
66,38,6,64,43,217,53,37,20,75,42,227,35,219
85,41,16,100,47,289,65,41,42,108,48,304,35,220
100,45,10,53,45,253,67,46,22,52,53,240,35,221
56,29,5,63,38,191,47,31,6,75,39,198,35,222
45,15,7,19,30,116,45,25,14,21,24,129,35,223
41,36,12,48,39,176,37,38,11,54,37,177,35,224
111,48,35,90,59,343,81,66,36,86,48,317,35,225
109,41,29,99,62,340,86,55,25,89,53,308,35,226
133,51,26,135,38,383,100,42,26,151,52,371,35,227
129,64,24,90,71,378,108,73,29,121,70,401,35,228
126,49,29,80,46,330,111,55,36,96,54,352,35,229
51,54,29,48,35,217,58,57,27,46,44,232,35,230
58,28,10,71,35,202,68,30,8,71,30,207,35,231
156,58,14,104,38,370,138,53,21,122,41,375,35,232
92,25,14,55,35,221,78,16,9,51,24,178,35,233
45,10,9,15,41,120,37,9,9,22,37,114,35,234
80,26,18,76,34,234,82,22,30,97,38,269,35,235
84,19,3,42,33,181,71,31,2,62,33,199,35,236
38,40,31,24,12,145,36,39,32,33,13,153,35,237
51,27,2,49,22,151,41,37,5,53,22,158,35,238
41,16,3,46,21,127,27,19,2,58,19,125,35,239
48,5,10,26,22,111,33,6,10,28,27,104,35,240
79,6,6,77,28,196,75,7,7,68,31,188,35,241
26,11,11,41,23,112,20,9,14,25,39,107,35,242
19,19,1,15,10,64,18,23,1,23,7,72,35,243
14,8,6,26,12,66,8,14,5,34,12,73,35,244
57,60,3,318,134,572,18,161,9,134,279,601,35,245
88,35,2,166,101,392,34,86,6,173,118,417,35,246
806,48,15,203,158,1230,87,211,16,133,781,1228,35,247
910,72,19,226,187,1414,106,291,25,340,981,1743,35,248
815,34,3,219,173,1244,82,244,6,129,777,1238,35,249
461,54,17,187,212,931,80,213,29,143,414,879,35,250
116,66,3,292,251,728,32,254,42,167,233,728,35,251
79,42,7,254,91,473,11,118,7,153,187,476,35,252
673,44,2,237,149,1105,69,206,10,159,618,1062,35,253
944,85,12,221,215,1477,91,377,20,151,840,1479,35,254
900,88,0,271,195,1454,80,351,15,187,843,1476,35,255
853,49,1,269,200,1372,76,320,16,160,750,1322,35,256
465,55,11,229,298,1058,74,296,33,180,478,1061,35,257
103,74,3,386,266,832,26,340,44,161,211,782,35,258
80,45,12,373,94,604,19,145,12,149,299,624,35,259
611,48,17,177,126,979,79,188,23,121,552,963,35,260
962,50,4,227,180,1423,88,292,8,166,841,1395,35,261
947,50,24,235,170,1426,81,298,23,180,793,1375,35,262
870,55,6,267,256,1454,82,351,21,151,798,1403,35,263
492,72,5,258,215,1042,80,252,43,202,487,1064,35,264
119,121,4,444,386,1074,134,332,62,217,244,989,35,265
56,58,6,474,122,716,77,142,12,275,183,689,35,266
673,39,2,194,157,1065,72,188,13,132,614,1019,35,267
928,56,9,245,199,1437,93,323,25,145,870,1456,35,268
855,73,17,262,244,1451,73,355,26,179,783,1416,35,269
827,46,4,260,199,1336,71,292,14,140,814,1331,35,270
448,73,5,249,277,1052,75,329,24,166,467,1061,35,271
102,76,3,421,243,845,20,367,30,181,248,846,35,272
71,39,1,361,113,585,13,159,9,158,255,594,35,273
678,47,5,223,133,1086,88,200,13,133,598,1032,35,274
951,63,6,243,163,1426,89,283,14,162,841,1389,35,275
960,56,2,237,189,1444,94,272,9,193,869,1437,35,276
753,44,2,308,186,1293,67,248,10,204,738,1267,35,277
439,54,4,214,244,955,84,189,32,177,442,924,35,278
94,69,3,294,225,685,21,247,31,172,254,725,35,279
82,35,3,360,121,601,14,129,7,185,298,633,35,280
683,42,1,247,163,1136,69,231,9,125,628,1062,35,281
976,52,4,254,193,1479,100,308,12,170,843,1433,35,282
930,65,8,271,188,1462,93,307,24,174,838,1436,35,283
868,64,11,259,205,1407,83,331,20,175,816,1425,35,284
439,69,5,231,245,989,80,245,34,173,456,988,35,285
121,75,5,396,217,814,39,267,38,188,303,835,35,286
87,51,2,258,174,572,22,180,15,172,206,595,35,287
253,45,1,241,148,688,66,148,15,158,317,704,35,288
947,41,6,270,203,1467,97,314,21,187,922,1541,35,289
989,40,3,255,177,1464,98,320,13,209,864,1504,35,290
856,56,1,245,249,1407,105,361,17,170,768,1421,35,291
461,86,4,283,255,1089,85,259,38,194,545,1121,35,292
113,76,5,330,241,765,23,255,53,244,226,801,35,293
65,62,2,307,190,626,16,224,9,154,205,608,35,294
680,40,1,249,172,1142,80,215,15,157,658,1125,35,295
924,51,7,300,180,1462,86,303,13,210,873,1485,35,296
950,60,5,260,193,1468,86,303,17,173,842,1421,35,297
864,56,4,283,249,1456,81,360,19,200,769,1429,35,298
456,58,4,253,258,1029,65,236,24,220,494,1039,35,299
101,119,2,289,275,786,29,257,66,163,248,763,35,300
190,49,2,241,178,660,33,204,9,184,254,684,35,301
667,57,1,194,155,1074,96,231,12,154,614,1107,35,302
1019,60,4,301,482,1866,98,635,15,202,897,1847,35,303
996,57,3,285,227,1568,123,318,10,181,911,1543,35,304
724,93,1,236,221,1275,98,217,8,175,743,1241,35,305
454,83,2,209,199,947,93,199,27,163,432,914,35,306
105,82,7,294,280,768,32,331,28,166,241,798,35,307
85,61,6,256,115,523,20,125,13,181,214,553,35,308
692,44,1,268,156,1161,100,204,12,205,660,1181,35,309
673,49,4,272,151,1149,99,175,17,235,651,1177,35,310
749,44,2,255,215,1265,101,248,7,206,685,1247,35,311
881,42,1,220,170,1314,104,262,8,157,754,1285,35,312
494,60,3,238,329,1124,102,282,16,190,485,1075,35,313
100,68,4,337,155,664,26,191,21,173,309,720,35,314
92,41,1,389,90,613,13,116,2,148,378,657,35,315
270,50,2,255,135,712,69,186,5,153,297,710,35,316
959,48,1,271,183,1462,107,273,13,193,992,1578,35,317
989,45,1,265,272,1572,99,356,18,182,867,1522,35,318
908,52,2,279,197,1438,100,297,21,216,827,1461,35,319
524,63,5,226,221,1039,95,207,25,181,516,1024,35,320
111,63,3,397,156,730,27,169,24,225,277,722,35,321
57,48,4,196,107,412,6,139,6,136,149,436,35,322
687,41,2,220,157,1107,99,210,9,157,672,1147,35,323
1033,67,1,282,194,1577,101,315,11,196,980,1603,35,324
1006,53,2,244,210,1515,101,339,11,175,945,1571,35,325
886,59,1,334,271,1551,99,368,11,208,803,1489,35,326
469,61,12,208,243,993,80,239,34,160,456,969,35,327
77,62,8,339,216,702,9,247,39,139,248,682,35,328
53,32,1,234,95,415,10,122,8,103,249,492,35,329
575,64,10,250,165,1064,89,187,21,162,620,1079,35,330
672,57,1,298,189,1217,101,266,14,234,693,1308,35,331
333,40,1,328,223,925,83,167,10,259,395,914,35,332
62,62,3,110,56,293,22,67,3,152,113,357,35,333
139,51,5,465,115,775,46,146,15,143,434,784,35,334
72,37,2,338,136,585,20,156,14,144,267,601,35,335
84,36,1,256,119,496,19,124,6,114,199,462,35,336
617,33,1,224,148,1023,82,180,5,149,603,1019,35,337
965,39,1,279,234,1518,97,325,11,189,977,1599,35,338
993,50,6,287,196,1532,97,350,21,205,889,1562,35,339
896,38,1,271,244,1450,99,374,16,174,813,1476,35,340
569,67,3,254,240,1133,86,250,24,217,562,1139,35,341
69,51,2,322,279,723,19,279,33,143,264,738,35,342
66,46,18,313,161,604,13,180,29,158,234,614,35,343
678,42,3,203,178,1104,65,214,15,131,661,1086,35,344
1002,36,1,286,212,1537,97,352,9,192,903,1553,35,345
1017,50,5,282,202,1556,78,384,18,124,977,1581,35,346
953,72,2,337,253,1617,90,436,20,181,907,1634,35,347
535,79,2,305,296,1217,90,292,32,178,584,1176,35,348
92,85,2,374,266,819,18,328,45,170,288,849,35,349
68,38,1,231,115,453,10,133,4,168,194,509,35,350
671,51,5,193,176,1096,97,233,12,159,629,1130,35,351
930,59,3,329,271,1592,104,394,18,164,913,1593,35,352
875,49,1,293,231,1449,103,322,8,177,821,1431,35,353
742,73,1,294,308,1418,79,371,6,184,796,1436,35,354
410,74,4,229,297,1014,88,291,37,167,403,986,35,355
64,75,2,300,154,595,13,190,22,131,245,601,35,356
71,30,4,252,155,512,20,185,11,130,180,526,35,357
266,38,2,377,170,853,63,181,4,157,449,854,35,358
127,29,1,165,69,391,47,66,2,124,176,415,35,359
17,44,1,71,32,165,6,40,2,31,87,166,35,360
171,41,13,288,163,676,43,150,17,131,303,644,35,361
209,46,1,350,160,766,67,158,10,137,338,710,35,362
57,53,3,254,155,522,16,168,23,120,193,520,35,363
55,39,2,266,93,455,9,108,9,103,244,473,35,364
259,45,2,372,202,880,58,219,6,168,418,869,35,365
277,107,22,348,170,924,46,125,72,203,409,855,35,366
393,198,6,771,499,1867,153,554,36,568,729,2040,36,1
2104,322,10,1209,1185,4830,657,991,34,891,2245,4818,36,2
2733,332,9,1493,1423,5990,976,1114,53,1154,2735,6032,36,3
2692,356,5,1367,1595,6015,1002,1112,31,1042,2820,6007,36,4
2334,405,25,1521,1548,5833,930,1076,123,1005,2545,5679,36,5
581,276,11,958,537,2363,200,698,94,632,770,2394,36,6
467,219,15,1119,591,2411,178,689,42,642,959,2510,36,7
2736,383,10,1412,1635,6176,1004,1102,36,1147,2961,6250,36,8
2813,242,23,1273,1073,5424,1001,831,47,1121,2465,5465,36,9
3029,391,25,1679,1473,6597,1039,1222,67,1227,3068,6623,36,10
2958,475,24,1450,1744,6651,1026,1326,88,1110,3163,6713,36,11
2503,335,31,1512,1463,5844,900,1035,171,1151,2505,5762,36,12
679,363,15,1618,848,3523,261,887,165,935,1393,3641,36,13
497,232,5,1134,538,2406,162,669,38,724,943,2536,36,14
882,322,46,1072,580,2902,279,763,61,781,1147,3031,36,15
1206,282,17,978,712,3195,395,849,44,694,1267,3249,36,16
2348,366,25,1768,1251,5758,639,1118,71,1182,2855,5865,36,17
2940,413,31,1503,1610,6497,969,1244,103,1147,3068,6531,36,18
1298,311,33,1371,751,3764,416,798,154,691,1607,3666,36,19
628,253,14,1182,719,2796,197,742,177,736,1016,2868,36,20
440,221,13,999,560,2233,131,687,50,586,893,2347,36,21
2681,374,25,1408,1518,6006,936,1091,53,1071,2946,6097,36,22
3117,427,6,1589,1698,6837,1066,1273,50,1237,3238,6864,36,23
3234,417,10,1718,1587,6966,1043,1333,77,1293,3197,6943,36,24
3019,418,19,1561,1667,6684,988,1337,75,1200,3085,6685,36,25
2366,454,22,1865,1527,6234,891,1255,155,1295,2428,6024,36,26
980,513,36,2275,1287,5091,257,1051,230,1076,1608,4222,36,27
645,330,17,1603,706,3301,194,793,43,786,1109,2925,36,28
2889,341,9,1524,1520,6283,1059,1062,58,1252,2952,6383,36,29
3280,423,6,1566,1680,6955,1131,1204,51,1166,3348,6900,36,30
3266,428,7,1624,1647,6972,1086,1372,38,1329,3248,7073,36,31
3184,460,17,1500,1656,6817,1046,1287,59,1187,3252,6831,36,32
2701,434,31,1540,1618,6324,961,1194,151,1254,2719,6279,36,33
733,334,28,1482,875,3452,250,882,183,909,1284,3508,36,34
529,248,12,1201,634,2624,172,765,36,781,957,2711,36,35
2907,393,16,1535,1647,6498,1017,1112,51,1295,3037,6512,36,36
3316,415,21,1546,1764,7062,1063,1407,40,1270,3327,7107,36,37
3259,477,14,1655,1562,6967,1015,1453,35,1231,3213,6947,36,38
3208,436,9,1541,1739,6933,1089,1346,50,1167,3175,6827,36,39
2771,495,61,1591,1648,6566,940,1212,209,1256,2813,6430,36,40
928,698,49,2144,1549,5368,479,1510,243,1482,1810,5524,36,41
578,448,45,1580,909,3560,256,911,58,1114,1522,3861,36,42
2839,377,21,1353,1610,6200,930,1050,36,1142,3020,6178,36,43
3003,441,10,1512,2035,7001,1020,1408,30,1144,3492,7094,36,44
3251,408,16,1674,1670,7019,1069,1247,82,1251,3190,6839,36,45
3102,432,10,1599,1724,6867,1122,1348,45,1185,3207,6907,36,46
2366,447,41,1537,1582,5973,951,1177,154,1175,2395,5852,36,47
670,336,13,1219,769,3007,203,764,196,735,1184,3082,36,48
539,268,69,1144,667,2687,163,802,121,667,1032,2785,36,49
1153,303,25,1289,840,3610,400,906,54,925,1549,3834,36,50
3087,424,18,1643,1599,6771,946,1252,47,1250,3162,6657,36,51
3244,389,5,1698,1588,6924,1025,1296,53,1240,3251,6865,36,52
3042,405,28,1597,1705,6777,952,1326,55,1134,3207,6674,36,53
2718,421,32,1480,1587,6238,892,1157,182,1152,2685,6068,36,54
732,328,17,1506,1004,3587,240,975,194,914,1334,3657,36,55
549,289,14,1139,652,2643,169,806,36,690,1032,2733,36,56
2975,391,11,1487,1609,6473,1024,1218,37,1273,3120,6672,36,57
3330,371,17,1543,1737,6998,1078,1356,39,1298,3272,7043,36,58
3424,373,13,1610,1458,6878,1051,1295,43,1347,3253,6989,36,59
3193,411,23,1605,1784,7016,1021,1354,46,1226,3334,6981,36,60
2876,455,27,1693,1707,6758,995,1235,166,1288,2946,6630,36,61
698,373,15,1317,876,3279,208,941,161,799,1214,3323,36,62
568,314,15,1333,682,2912,171,866,47,800,1133,3017,36,63
3144,384,9,1513,1672,6722,1075,1251,37,1221,3252,6836,36,64
3238,393,10,1494,1680,6815,1025,1334,41,1099,3360,6859,36,65
3420,345,14,1658,1445,6882,1090,1329,67,1229,3180,6895,36,66
3390,460,6,1541,1697,7094,1051,1492,77,1147,3350,7117,36,67
2922,486,15,1743,1707,6873,980,1320,195,1232,2968,6695,36,68
789,304,11,1323,706,3133,209,926,164,828,1129,3256,36,69
591,284,5,1218,629,2727,172,827,38,694,1123,2854,36,70
2907,512,27,1407,1631,6484,954,1324,84,1064,3132,6558,36,71
3400,526,10,1669,1796,7401,1071,1567,53,1192,3498,7381,36,72
3478,488,5,1992,1645,7608,1064,1588,49,1421,3422,7544,36,73
3054,505,8,1826,1837,7230,1047,1576,78,1353,3173,7227,36,74
2536,534,36,1658,1502,6266,802,1323,221,1214,2578,6138,36,75
1017,485,49,1898,1015,4464,273,1307,258,1087,1654,4579,36,76
612,293,11,1350,758,3024,164,1048,52,814,1141,3219,36,77
3112,428,25,1503,1626,6694,1027,1292,44,1232,3097,6692,36,78
3402,484,30,1618,1854,7388,1082,1484,72,1209,3634,7481,36,79
3534,452,6,1794,1766,7552,1054,1599,48,1381,3440,7522,36,80
3443,493,20,1678,1770,7404,1051,1585,84,1345,3414,7479,36,81
2913,468,20,1764,1736,6901,926,1411,190,1296,2948,6771,36,82
757,400,14,1328,937,3436,238,1122,206,691,1233,3490,36,83
641,317,40,1520,732,3250,164,1017,76,883,1343,3483,36,84
3072,470,22,1589,1541,6694,868,1411,68,1204,3248,6799,36,85
3368,510,42,1734,1677,7331,937,1542,82,1288,3616,7465,36,86
3341,442,38,1526,1397,6744,904,1434,89,1193,3186,6806,36,87
3117,472,42,1565,1604,6800,886,1433,104,1197,3272,6892,36,88
2665,501,29,1885,1537,6617,773,1420,198,1321,2805,6517,36,89
819,431,24,1955,1059,4288,263,1247,188,1113,1541,4352,36,90
647,305,76,1372,652,3052,167,943,106,794,1265,3275,36,91
2794,437,48,1553,1634,6466,849,1431,82,1160,2964,6486,36,92
3263,450,18,1656,1611,6998,1030,1368,59,1264,3463,7184,36,93
3354,405,10,1527,1403,6699,987,1511,54,1111,3187,6850,36,94
3419,606,31,1672,1960,7688,1077,1603,91,1248,3732,7751,36,95
2629,490,26,1831,1856,6832,973,1464,192,1365,2677,6671,36,96
879,417,18,1665,945,3924,261,1209,174,1008,1380,4032,36,97
766,305,40,1481,724,3316,219,1023,65,846,1288,3441,36,98
3061,480,38,1604,1558,6741,1032,1316,84,1344,2991,6767,36,99
3403,488,22,1799,1770,7482,1072,1563,73,1339,3365,7412,36,100
3489,483,19,1805,1736,7532,1073,1588,62,1374,3415,7512,36,101
3460,437,7,1820,1724,7448,1059,1458,57,1384,3378,7336,36,102
2874,521,38,1693,1735,6861,967,1379,212,1279,2803,6640,36,103
884,505,16,1734,1076,4215,284,1279,213,1042,1558,4376,36,104
712,342,17,1523,679,3273,182,1154,54,814,1257,3461,36,105
2600,501,51,1616,1478,6246,743,1424,82,1159,2831,6239,36,106
2625,471,16,1765,1219,6096,618,1489,62,1130,2754,6053,36,107
2997,451,21,1848,1410,6727,766,1527,76,1217,3066,6652,36,108
2818,552,33,1686,1524,6613,796,1575,93,1120,3053,6637,36,109
2539,505,18,1873,1385,6320,759,1364,186,1176,2538,6023,36,110
806,486,14,1898,1126,4330,255,1408,252,985,1599,4499,36,111
632,311,7,1295,665,2910,174,931,41,728,1215,3089,36,112
3107,460,14,1563,1667,6811,973,1282,46,1117,3232,6650,36,113
3390,561,21,1689,1882,7543,1097,1627,74,1237,3519,7554,36,114
3397,484,45,1920,1847,7693,1118,1683,94,1436,3336,7667,36,115
3410,505,18,1658,1863,7454,1034,1660,57,1293,3368,7412,36,116
2956,581,11,1698,1957,7203,1006,1548,192,1332,2935,7013,36,117
836,419,15,1605,1105,3980,250,1160,214,1014,1361,3999,36,118
653,317,13,1400,725,3108,192,1071,52,803,1167,3285,36,119
3221,472,13,1528,1687,6921,1058,1364,45,1188,3135,6790,36,120
3558,504,22,1788,1750,7622,1065,1495,78,1358,3493,7489,36,121
3527,548,42,1760,1754,7631,1051,1631,90,1346,3452,7570,36,122
3422,549,11,1685,1868,7535,1063,1537,77,1342,3357,7376,36,123
2946,600,11,1738,1833,7128,987,1453,181,1295,2851,6767,36,124
777,384,17,1570,875,3623,253,1049,199,956,1260,3717,36,125
631,282,38,1268,671,2890,162,939,84,737,1138,3060,36,126
3045,486,21,1646,1730,6928,1018,1356,56,1215,3162,6807,36,127
3489,482,23,1745,1816,7555,1116,1555,74,1265,3476,7486,36,128
3499,523,28,2026,1758,7834,1102,1757,88,1458,3272,7677,36,129
3470,481,18,1768,1851,7588,1142,1552,73,1344,3325,7436,36,130
2828,555,35,1643,1666,6727,1000,1369,213,1213,2742,6537,36,131
896,443,45,1712,922,4018,291,1032,236,1113,1431,4103,36,132
621,373,33,1307,602,2936,207,988,64,753,1129,3141,36,133
3178,495,28,1552,1794,7047,1030,1407,57,1183,3117,6794,36,134
3533,442,27,1719,1654,7375,1075,1447,74,1249,3409,7254,36,135
3529,515,46,1870,1707,7667,1087,1596,103,1299,3543,7628,36,136
3483,573,57,1758,1995,7866,1118,1605,117,1242,3548,7630,36,137
3085,590,65,1705,1788,7233,996,1459,232,1266,2928,6881,36,138
1086,702,77,1894,1508,5267,522,1535,285,1434,1750,5526,36,139
860,608,48,1846,1056,4418,359,1274,87,1253,1566,4539,36,140
3302,498,17,1526,1837,7180,1125,1502,45,1205,3243,7120,36,141
3547,544,36,1696,1892,7715,1078,1609,68,1238,3631,7624,36,142
3538,502,25,1872,1728,7665,1158,1536,84,1318,3482,7578,36,143
3376,473,39,1602,1809,7299,1074,1484,79,1220,3246,7103,36,144
2809,567,54,1846,1868,7144,989,1640,228,1397,2604,6858,36,145
874,453,28,1769,1098,4222,252,1410,212,1005,1344,4223,36,146
707,378,17,1474,764,3340,192,1093,55,760,1269,3369,36,147
799,315,25,1221,663,3023,280,847,52,810,1218,3207,36,148
3252,509,26,1672,1675,7134,1055,1430,48,1281,3328,7142,36,149
3442,479,32,1819,1495,7267,1090,1347,92,1338,3308,7175,36,150
3419,541,34,1725,1871,7590,1099,1564,82,1273,3366,7384,36,151
2965,618,45,1840,1746,7214,1017,1497,235,1307,2986,7042,36,152
1531,996,78,3279,1972,7856,579,2560,398,2210,2796,8543,36,153
1131,748,34,2490,1360,5763,438,1923,108,1783,2167,6419,36,154
5936,906,57,3086,2811,12796,1963,2839,123,2408,6336,13669,36,155
6479,960,38,3124,2959,13560,1835,3130,133,2396,6719,14213,36,156
6596,874,62,3323,2759,13614,1910,3026,159,2465,6660,14220,36,157
6241,894,17,3229,3070,13451,1852,3311,149,2463,6253,14028,36,158
5024,1197,60,3113,3198,12592,1533,3273,411,2548,5229,12994,36,159
1563,1234,74,4129,2641,9641,557,3772,522,2132,3646,10629,36,160
1172,740,19,3157,1500,6588,418,2257,106,1742,2710,7233,36,161
5534,830,27,2975,2551,11917,1649,2520,148,2233,5687,12237,36,162
6339,989,18,3091,2667,13104,1781,3059,111,2321,6408,13680,36,163
6430,987,15,3240,2798,13470,1741,3156,207,2573,6247,13924,36,164
6070,927,17,3096,2591,12701,1617,2897,151,2405,5935,13005,36,165
4876,1046,43,3139,2743,11847,1414,2881,395,2474,4855,12019,36,166
1485,1007,45,3072,2088,7697,518,2750,403,1887,2565,8123,36,167
1140,735,15,2664,1258,5812,382,1923,116,1533,2318,6272,36,168
5051,892,21,2740,2148,10852,1263,2535,96,2233,5293,11420,36,169
5736,928,24,3008,2441,12137,1400,2991,118,2249,5599,12357,36,170
2678,915,37,3016,2193,8839,866,2653,119,2075,3369,9082,36,171
5429,1019,17,3020,2238,11723,1267,2822,171,2064,5483,11807,36,172
4391,988,46,2787,2213,10425,1173,2567,312,2161,4518,10731,36,173
1458,1073,61,2703,1879,7174,493,2414,427,1750,2323,7407,36,174
1130,751,27,2235,1205,5348,390,1886,148,1485,2032,5941,36,175
4908,838,20,2809,2093,10668,1326,2374,116,2058,5088,10962,36,176
5834,839,18,2968,2262,11921,1429,2728,118,2132,5987,12394,36,177
5871,761,16,3012,2247,11907,1395,2782,125,2163,5929,12394,36,178
5727,959,18,3118,2309,12131,1370,2948,135,2182,5635,12270,36,179
4158,911,33,2660,2082,9844,1166,2075,317,1918,3938,9414,36,180
1336,753,34,2401,1399,5923,406,1785,274,1434,1958,5857,36,181
959,550,35,1839,979,4362,284,1455,106,1080,1530,4455,36,182
4180,771,13,2294,1982,9240,1108,2123,72,1757,3978,9038,36,183
4518,806,12,2526,2087,9949,1213,2271,73,1827,4083,9467,36,184
4157,895,73,2621,2226,9972,1153,2406,164,1985,3747,9455,36,185
1127,2258,46,2209,1906,7546,397,3282,150,1380,1732,6941,36,186
2716,779,28,2226,1649,7398,768,1904,199,1536,2678,7085,36,187
1154,643,28,2120,1305,5250,371,1677,224,1190,1721,5183,36,188
985,490,9,1821,942,4247,294,1348,64,1093,1530,4329,36,189
4086,690,11,2219,1643,8649,1107,1811,67,1630,3891,8506,36,190
4458,690,20,2355,1758,9281,1242,2025,112,1731,4110,9220,36,191
4496,666,39,2324,1746,9271,1178,1896,114,1654,4248,9090,36,192
4356,739,17,2401,1944,9457,1162,2106,126,1675,4184,9253,36,193
3656,705,29,2249,1890,8529,1006,2010,248,1606,3329,8199,36,194
1145,746,44,2210,1580,5725,373,1944,264,1257,1845,5683,36,195
953,512,12,1719,950,4146,302,1282,66,1070,1560,4280,36,196
4141,615,33,2027,1449,8265,1094,1689,93,1616,3750,8242,36,197
4474,666,26,2248,1691,9105,1135,2042,100,1640,4030,8947,36,198
4558,631,16,2264,1709,9178,1111,1918,74,1646,4251,9000,36,199
4393,752,9,2337,1855,9346,1117,2144,93,1683,4125,9162,36,200
3620,860,34,2292,2284,9090,1019,2220,426,1655,3399,8719,36,201
1182,693,50,2352,1420,5697,348,1790,283,1335,1775,5531,36,202
956,508,9,1864,940,4277,303,1370,56,1060,1570,4359,36,203
3979,690,17,1967,1538,8191,1058,1789,79,1527,3668,8121,36,204
4612,743,19,2321,1837,9532,1144,2177,113,1619,4299,9352,36,205
4403,745,13,2414,1908,9483,1106,2083,107,1726,4252,9274,36,206
4366,689,27,2423,1839,9344,1147,2035,105,1652,4190,9129,36,207
3633,804,37,2296,1865,8635,1036,1994,250,1696,3474,8450,36,208
1161,702,44,2303,1371,5581,367,1655,345,1346,1876,5589,36,209
958,495,15,1718,1043,4229,285,1428,87,1127,1562,4489,36,210
3839,627,21,2052,1729,8268,967,1910,157,1578,3629,8241,36,211
4433,635,9,2270,1690,9037,1056,1926,88,1644,4157,8871,36,212
4435,736,18,2516,1641,9346,1018,1912,86,1833,4172,9021,36,213
4149,755,9,2303,1780,8996,965,1975,88,1562,3990,8580,36,214
3563,785,27,2369,1824,8568,888,2083,229,1614,3263,8077,36,215
1288,624,37,2338,1266,5553,390,1548,269,1311,1907,5425,36,216
991,538,8,1858,856,4251,307,1282,57,1042,1654,4342,36,217
3784,654,18,2000,1587,8043,914,1813,90,1532,3698,8047,36,218
4382,729,31,2162,1711,9015,979,2005,103,1486,4104,8677,36,219
4346,669,20,2280,1552,8867,1018,1909,107,1518,3921,8473,36,220
3875,606,22,2138,1528,8169,911,1835,82,1503,3621,7952,36,221
2921,716,29,1738,1689,7093,769,1794,266,1258,2719,6806,36,222
1193,739,39,2254,1299,5524,375,1637,211,1352,1831,5406,36,223
923,582,16,1825,910,4256,292,1330,69,1066,1651,4408,36,224
3620,670,27,1953,1564,7834,932,1671,85,1497,3648,7833,36,225
4113,697,85,2180,1749,8824,999,1925,130,1545,4055,8654,36,226
4148,654,16,2196,1672,8686,974,2000,76,1533,3967,8550,36,227
3872,719,29,2237,1825,8682,997,1950,105,1550,3858,8460,36,228
3284,797,30,2151,1811,8073,853,1908,218,1501,3182,7662,36,229
1136,600,36,2276,1187,5235,369,1357,252,1482,1688,5148,36,230
912,490,9,1846,952,4209,279,1204,69,1107,1580,4239,36,231
3603,623,16,1959,1554,7755,934,1681,74,1445,3606,7740,36,232
4143,737,10,2252,1911,9053,1039,2094,91,1534,4201,8959,36,233
4156,767,21,2318,1944,9206,1065,2058,95,1636,4234,9088,36,234
4069,814,20,2356,2088,9347,1129,1976,143,1618,4111,8977,36,235
3431,767,35,2221,2077,8531,1026,1913,266,1611,3314,8130,36,236
1274,694,41,2485,1458,5952,378,1853,232,1312,1941,5716,36,237
956,527,22,2062,981,4548,273,1343,80,1123,1635,4454,36,238
4180,719,40,2182,2125,9246,1337,1904,107,1635,4177,9160,36,239
4740,817,24,2289,2394,10264,1429,2188,79,1661,4654,10011,36,240
4727,697,27,2340,2091,9882,1352,2105,81,1635,4529,9702,36,241
4541,613,11,2171,2073,9409,1429,1812,71,1629,4431,9372,36,242
3775,709,30,2278,2349,9141,1256,1923,218,1899,3543,8839,36,243
1142,669,39,2448,1435,5733,373,1724,235,1331,1879,5542,36,244
771,394,4,1611,751,3531,244,999,54,902,1418,3617,36,245
700,371,10,1254,870,3205,250,976,39,933,1263,3461,36,246
3492,586,5,1777,1912,7772,1274,1452,57,1408,3639,7830,36,247
3634,554,15,1892,1838,7933,1260,1538,49,1419,3556,7822,36,248
3493,543,17,1811,2103,7967,1298,1531,53,1361,3586,7829,36,249
3165,578,29,1811,1899,7482,1174,1468,160,1426,3075,7303,36,250
912,516,26,1883,1144,4481,345,1276,260,1159,1490,4530,36,251
620,399,13,1414,816,3262,223,1075,48,943,1202,3491,36,252
3336,552,23,1652,1924,7487,1214,1446,78,1256,3511,7505,36,253
3691,622,25,1838,1984,8160,1307,1698,95,1448,3659,8207,36,254
3726,577,22,1973,1928,8226,1264,1713,75,1414,3656,8122,36,255
3638,565,13,1785,2121,8122,1295,1798,60,1378,3602,8133,36,256
3387,605,23,1757,2066,7838,1210,1571,211,1404,3007,7403,36,257
896,474,34,1856,1285,4545,279,1485,261,1183,1429,4637,36,258
740,408,13,1693,751,3605,191,1020,50,895,1496,3652,36,259
3361,521,10,1633,1876,7401,1225,1395,68,1322,3443,7453,36,260
3740,529,30,1670,1912,7881,1325,1539,77,1357,3637,7935,36,261
3649,533,14,1837,1827,7860,1232,1664,72,1360,3470,7798,36,262
3603,561,11,1741,2080,7996,1202,1703,82,1265,3566,7818,36,263
3242,620,20,1801,1931,7614,1188,1539,215,1427,3082,7451,36,264
866,468,21,1877,1149,4381,291,1490,234,1084,1474,4573,36,265
685,333,5,1335,741,3099,209,1013,33,856,1117,3228,36,266
3310,496,3,1642,1928,7379,1196,1391,47,1324,3378,7336,36,267
3699,575,12,1757,1875,7918,1304,1593,71,1328,3742,8038,36,268
3671,504,12,1904,1939,8030,1278,1567,60,1352,3552,7809,36,269
3347,600,15,1810,2014,7786,1166,1567,85,1278,3566,7662,36,270
2926,519,18,1928,1859,7250,1135,1534,193,1341,2876,7079,36,271
870,596,23,1977,1304,4770,262,1664,322,1189,1545,4982,36,272
658,373,13,1479,739,3262,177,1043,40,801,1338,3399,36,273
3297,519,14,1598,1860,7288,1214,1434,69,1198,3366,7281,36,274
3538,570,24,1571,1968,7671,1226,1579,70,1257,3583,7715,36,275
3697,544,16,1831,1800,7888,1217,1517,61,1464,3450,7709,36,276
3512,562,8,1848,1998,7928,1265,1561,79,1392,3485,7782,36,277
3165,603,19,1792,1983,7562,1139,1592,202,1472,3007,7412,36,278
920,478,17,1949,1142,4506,317,1166,235,1170,1595,4483,36,279
662,351,10,1539,774,3336,194,1063,32,928,1276,3493,36,280
3328,513,10,1668,1959,7478,1245,1384,61,1389,3532,7611,36,281
3737,586,10,1831,1945,8109,1338,1651,47,1434,3729,8199,36,282
3782,580,23,1872,1905,8162,1323,1593,82,1564,3599,8161,36,283
3137,605,11,2043,2017,7813,1177,1641,49,1500,3242,7609,36,284
2694,567,26,1970,1792,7049,977,1489,177,1341,2733,6717,36,285
938,442,22,1822,1124,4348,293,1263,198,1091,1531,4376,36,286
698,362,12,1459,928,3459,187,1145,59,878,1314,3583,36,287
1543,430,30,1514,1157,4674,470,1179,73,1046,2122,4890,36,288
3546,562,16,1713,1982,7819,1180,1609,74,1329,3622,7814,36,289
3721,526,30,1895,1905,8077,1215,1619,97,1360,3688,7979,36,290
3615,583,22,1866,2074,8160,1266,1575,87,1300,3692,7920,36,291
3054,619,41,1781,2084,7579,1067,1629,240,1379,3162,7477,36,292
893,630,41,1864,1312,4740,264,1557,333,1134,1680,4968,36,293
661,338,20,1492,860,3371,186,1183,45,830,1271,3515,36,294
3371,524,31,1616,2024,7566,1201,1411,68,1268,3558,7506,36,295
3567,582,31,1801,1999,7980,1309,1546,70,1335,3906,8166,36,296
3646,534,14,1959,1932,8085,1299,1690,68,1426,3689,8172,36,297
3624,528,19,1721,2077,7969,1309,1667,83,1344,3568,7971,36,298
3074,563,23,1906,2053,7619,1123,1501,171,1423,3099,7317,36,299
869,536,37,1721,989,4152,289,1215,248,1112,1394,4258,36,300
807,350,12,1346,757,3272,237,998,43,926,1303,3507,36,301
3281,537,18,1680,1937,7453,1212,1378,65,1236,3559,7450,36,302
3663,598,13,1708,2355,8337,1296,1879,68,1375,3689,8307,36,303
3777,547,15,2065,1924,8328,1223,1595,61,1591,3849,8319,36,304
3510,692,38,1805,2211,8256,1191,1569,154,1503,3614,8031,36,305
2918,593,19,2038,1785,7353,1147,1390,196,1497,2990,7220,36,306
812,517,26,1653,1181,4189,267,1256,190,1061,1401,4175,36,307
693,308,7,1448,739,3195,218,901,46,970,1239,3374,36,308
3007,487,10,1606,1731,6841,1086,1279,50,1358,3197,6970,36,309
2782,516,18,1860,1654,6830,1132,1242,97,1465,2962,6898,36,310
3371,446,18,1799,1864,7498,1298,1384,61,1366,3439,7548,36,311
3418,548,2,1701,2061,7730,1298,1502,53,1346,3465,7664,36,312
2986,533,14,1792,2013,7338,1177,1383,187,1446,3019,7212,36,313
838,389,19,1730,1031,4007,287,960,204,1057,1512,4020,36,314
660,262,7,1558,742,3229,199,841,62,912,1466,3480,36,315
1574,439,3,1586,1234,4836,516,1128,60,1170,1994,4868,36,316
3544,484,13,1732,2071,7844,1305,1442,70,1463,3741,8021,36,317
3683,464,8,1926,1999,8080,1317,1475,64,1439,3753,8048,36,318
3514,501,3,1832,1974,7824,1233,1484,57,1368,3578,7720,36,319
3052,553,14,1633,1948,7200,1130,1377,177,1384,3135,7203,36,320
973,994,92,2717,1936,6712,775,1208,191,2102,2222,6498,36,321
680,659,53,1859,1397,4648,432,1002,46,1519,1529,4528,36,322
3157,499,24,1717,1902,7299,1222,1349,71,1369,3487,7498,36,323
3691,491,5,1666,2028,7881,1286,1458,39,1388,3784,7955,36,324
3559,426,4,1896,1948,7833,1308,1434,41,1395,3644,7822,36,325
3478,501,4,1730,2014,7727,1325,1509,78,1383,3481,7776,36,326
2906,404,17,1544,1756,6627,1133,1224,177,1293,2773,6600,36,327
804,386,25,1624,1051,3890,280,1047,196,1021,1426,3970,36,328
581,287,6,1344,708,2926,193,765,53,815,1172,2998,36,329
2940,498,14,1553,1747,6752,997,1248,60,1275,3092,6672,36,330
2771,469,13,1761,1780,6794,1022,1319,50,1458,3013,6862,36,331
2126,458,4,1770,1229,5587,661,1110,56,1522,2020,5369,36,332
424,231,1,825,464,1945,187,451,23,647,675,1983,36,333
1163,344,19,1478,992,3996,366,989,106,1026,1556,4043,36,334
627,340,19,1345,827,3158,227,888,109,882,1195,3301,36,335
558,240,18,1174,639,2629,199,788,48,800,1075,2910,36,336
2932,454,17,1593,1757,6753,1109,1250,51,1275,3234,6919,36,337
3329,461,38,1691,1972,7491,1169,1421,75,1368,3543,7576,36,338
3461,454,11,1860,1912,7698,1214,1420,64,1424,3564,7686,36,339
3255,428,8,1596,2007,7294,1168,1471,81,1275,3322,7317,36,340
2794,441,31,1731,1629,6626,1047,1260,212,1292,2760,6571,36,341
761,448,29,1604,1069,3911,249,1173,195,1035,1339,3991,36,342
592,345,11,1290,786,3024,196,900,51,886,1240,3273,36,343
3169,469,15,1618,1871,7142,1164,1351,59,1236,3352,7162,36,344
3524,531,49,1682,1924,7710,1274,1486,94,1231,3608,7693,36,345
3413,435,13,1710,1508,7079,1178,1456,64,1311,3154,7163,36,346
3379,483,10,1708,1952,7532,1183,1521,90,1263,3545,7602,36,347
2885,479,32,1649,1978,7023,1097,1345,189,1296,2937,6864,36,348
773,398,23,1672,950,3816,256,1101,209,1045,1379,3990,36,349
578,277,29,1296,706,2886,190,872,55,844,1088,3049,36,350
3007,421,21,1611,1770,6830,1170,1276,64,1245,3133,6888,36,351
3346,493,25,1905,1972,7741,1236,1456,65,1420,3563,7740,36,352
3290,430,59,1766,1755,7300,1209,1377,106,1388,3242,7322,36,353
3145,542,30,1817,2010,7544,1137,1460,68,1417,3321,7403,36,354
2550,464,25,1778,1635,6452,996,1309,147,1391,2523,6366,36,355
740,348,23,1493,887,3491,242,924,152,995,1255,3568,36,356
522,230,12,1181,642,2587,164,790,39,779,919,2691,36,357
1745,387,19,1459,1081,4691,517,1047,32,1101,2065,4762,36,358
1263,264,4,1291,857,3679,459,688,27,1216,1351,3741,36,359
279,158,6,594,370,1407,146,337,34,382,491,1390,36,360
1470,331,7,1330,1005,4143,399,1086,43,991,1709,4228,36,361
1611,391,16,1532,1137,4687,431,1125,130,1097,1888,4671,36,362
660,323,15,1193,725,2916,189,952,133,742,1043,3059,36,363
520,245,7,1193,638,2603,160,743,43,689,1058,2693,36,364
1843,376,12,1575,1206,5012,527,1112,38,1159,2169,5005,36,365
1692,509,101,1526,1041,4869,503,808,243,1362,1739,4655,36,366
138,87,5,389,188,807,50,232,19,316,424,1041,37,1
1297,112,5,651,367,2432,282,406,17,479,1437,2621,37,2
1706,143,5,645,629,3128,306,602,26,451,1858,3243,37,3
1613,134,4,605,401,2757,277,443,25,478,1637,2860,37,4
1130,187,2,674,576,2569,250,535,51,487,1250,2573,37,5
187,109,6,391,316,1009,68,374,55,251,420,1168,37,6
146,106,0,861,214,1327,45,532,18,303,551,1449,37,7
1502,121,1,493,450,2567,286,516,20,398,1520,2740,37,8
1887,102,2,430,348,2769,321,360,21,601,1617,2920,37,9
2037,116,3,572,508,3236,360,549,24,525,1849,3307,37,10
1858,147,6,621,659,3291,339,738,24,552,1728,3381,37,11
1006,120,6,676,444,2252,238,427,39,499,1063,2266,37,12
234,138,4,1613,391,2380,81,668,59,381,1276,2465,37,13
137,82,1,526,173,919,53,305,24,263,454,1099,37,14
226,105,2,542,219,1094,106,264,33,332,485,1220,37,15
457,73,0,288,302,1120,172,347,19,227,494,1259,37,16
1597,107,3,551,407,2665,271,514,21,454,1594,2854,37,17
1866,138,3,602,655,3264,327,663,27,460,1822,3299,37,18
903,87,6,639,318,1953,169,364,45,404,980,1962,37,19
249,101,3,665,359,1377,83,472,62,353,581,1551,37,20
173,105,1,532,236,1047,57,331,19,293,503,1203,37,21
1578,119,1,521,360,2579,303,423,18,401,1555,2700,37,22
2100,115,4,602,476,3297,358,532,33,463,1991,3377,37,23
2101,113,7,606,616,3443,410,637,28,465,1960,3500,37,24
1856,151,6,657,560,3230,331,679,26,427,1790,3253,37,25
1208,188,4,816,569,2785,286,561,78,541,1440,2906,37,26
297,161,9,1298,478,2243,71,526,59,535,1211,2402,37,27
174,118,23,667,196,1178,78,310,41,350,630,1409,37,28
1598,121,0,559,453,2731,345,446,19,431,1625,2866,37,29
2122,121,0,581,481,3305,390,554,20,455,1960,3379,37,30
2099,131,7,586,521,3344,373,671,31,494,1862,3431,37,31
1954,155,11,597,477,3194,383,555,36,467,1861,3302,37,32
1284,168,6,579,554,2591,292,560,70,503,1292,2717,37,33
216,165,5,864,337,1587,99,451,37,429,692,1708,37,34
185,112,6,670,218,1191,79,388,20,340,558,1385,37,35
1646,120,4,535,411,2716,322,471,22,470,1488,2773,37,36
2076,98,1,602,571,3348,372,576,14,514,1984,3460,37,37
2120,125,3,587,535,3370,363,570,24,560,1924,3441,37,38
1970,152,4,622,480,3228,328,609,25,509,1800,3271,37,39
1295,209,2,546,544,2596,315,479,119,512,1344,2769,37,40
221,154,5,1040,451,1871,74,600,68,435,811,1988,37,41
165,97,2,686,203,1153,79,287,39,347,646,1398,37,42
1626,118,0,575,430,2749,338,447,22,475,1550,2832,37,43
2007,115,0,626,568,3316,329,704,23,441,1942,3439,37,44
2062,129,5,608,508,3312,359,590,52,496,1928,3425,37,45
1870,147,5,642,508,3172,350,585,26,467,1774,3202,37,46
1104,179,3,618,549,2453,272,460,51,566,1111,2460,37,47
273,144,8,850,379,1654,77,436,53,370,769,1705,37,48
197,117,0,716,221,1251,63,350,14,319,686,1432,37,49
440,114,0,749,332,1635,166,388,14,502,844,1914,37,50
2081,119,2,629,601,3432,349,725,21,538,1877,3510,37,51
2136,151,16,586,525,3414,362,551,39,567,2014,3533,37,52
2251,136,3,570,507,3467,334,796,36,517,2100,3783,37,53
1555,126,3,587,468,2739,268,539,53,560,1587,3007,37,54
259,141,9,860,516,1785,91,576,75,432,782,1956,37,55
154,113,7,565,255,1094,71,364,19,300,484,1238,37,56
2073,128,4,528,514,3247,327,664,22,481,1946,3440,37,57
2503,105,11,611,535,3765,339,722,28,499,2376,3964,37,58
2443,117,14,577,435,3586,371,607,32,559,2178,3747,37,59
2286,135,5,634,480,3540,333,665,24,552,2104,3678,37,60
1610,196,9,601,706,3122,270,746,71,560,1676,3323,37,61
235,156,1,881,372,1645,100,526,46,431,676,1779,37,62
196,122,3,894,216,1431,86,326,31,320,837,1600,37,63
2064,154,8,617,411,3254,317,510,21,570,1981,3399,37,64
2560,132,4,769,481,3946,315,592,22,563,2570,4062,37,65
2469,140,6,643,533,3791,318,739,33,472,2400,3962,37,66
2401,158,5,762,587,3913,317,801,72,674,2262,4126,37,67
1425,179,10,873,606,3093,289,758,70,640,1553,3310,37,68
464,143,9,1116,467,2199,88,872,71,492,831,2354,37,69
318,137,10,827,227,1519,79,342,41,411,860,1733,37,70
1720,155,6,784,450,3115,336,602,17,445,1818,3218,37,71
2148,145,3,973,618,3887,383,787,26,566,2258,4020,37,72
2171,172,5,972,581,3901,384,775,46,556,2324,4085,37,73
2145,196,9,1100,685,4135,380,872,75,537,2357,4221,37,74
1309,191,5,928,630,3063,262,598,123,666,1540,3189,37,75
534,251,4,1806,692,3287,107,952,209,729,1378,3375,37,76
276,145,2,1017,398,1838,84,602,25,486,836,2033,37,77
1755,127,4,791,476,3153,288,586,23,536,1784,3217,37,78
2202,126,14,837,543,3722,350,672,41,580,2159,3802,37,79
2232,153,5,1001,714,4105,328,910,40,590,2351,4219,37,80
2034,162,14,999,655,3864,338,820,39,691,2131,4019,37,81
1414,203,3,1175,853,3648,259,1018,73,736,1672,3758,37,82
303,213,3,1147,545,2211,80,702,81,456,974,2293,37,83
473,151,4,2362,402,3392,107,782,26,633,2064,3612,37,84
1759,187,2,1640,633,4221,282,792,109,704,2266,4153,37,85
2167,171,4,1633,694,4669,343,1042,35,750,2577,4747,37,86
1907,130,8,958,543,3546,347,692,19,643,2050,3751,37,87
1823,148,0,1091,530,3592,322,655,38,608,2035,3658,37,88
1314,185,4,1740,682,3925,256,873,66,792,2067,4054,37,89
570,200,5,2599,807,4181,107,1256,87,776,2179,4405,37,90
240,164,9,1158,410,1981,88,631,21,486,1025,2251,37,91
1744,161,4,1673,646,4228,305,1266,35,725,1977,4308,37,92
2144,149,2,1078,523,3896,347,750,18,653,2339,4107,37,93
2176,129,1,860,696,3862,358,808,28,522,2216,3932,37,94
2139,168,1,1304,840,4452,335,1048,39,688,2413,4523,37,95
1432,217,5,1096,782,3532,258,815,71,710,1778,3632,37,96
469,170,7,1586,498,2730,111,884,56,632,1157,2840,37,97
431,162,8,1202,370,2173,93,657,25,607,1091,2473,37,98
1724,135,11,651,358,2879,295,470,54,595,1687,3101,37,99
2217,211,5,782,632,3847,387,655,146,652,2122,3962,37,100
2137,177,10,974,567,3865,373,758,43,726,2335,4235,37,101
2047,157,0,698,524,3426,345,708,42,579,1917,3591,37,102
1497,224,1,761,683,3166,262,822,48,597,1572,3301,37,103
591,198,4,1727,872,3392,106,1183,87,712,1460,3548,37,104
239,172,2,1112,320,1845,76,555,26,519,1007,2183,37,105
1792,168,7,674,643,3284,333,721,27,563,1737,3381,37,106
2207,172,11,770,538,3698,370,684,33,589,2177,3853,37,107
2259,172,8,718,597,3754,396,870,31,591,2055,3943,37,108
2108,164,5,750,595,3622,388,816,34,582,2032,3852,37,109
1439,205,11,750,758,3163,270,715,65,654,1545,3249,37,110
394,257,11,2100,777,3539,117,1391,129,555,1426,3618,37,111
234,152,0,919,245,1550,104,421,18,440,811,1794,37,112
1789,128,11,662,503,3093,349,574,24,517,1752,3216,37,113
2348,159,8,709,747,3971,370,866,34,553,2273,4096,37,114
2295,183,6,742,719,3945,405,920,29,640,2066,4060,37,115
2676,195,0,923,631,4425,388,887,55,954,2245,4529,37,116
1370,244,6,776,810,3206,302,857,78,649,1510,3396,37,117
440,186,25,942,509,2102,123,643,144,519,791,2220,37,118
222,214,31,969,435,1871,109,606,68,468,888,2139,37,119
1772,153,9,687,459,3080,324,592,24,603,1625,3168,37,120
2332,145,2,640,536,3655,368,626,22,595,2199,3810,37,121
2321,173,2,686,557,3739,395,727,33,653,2068,3876,37,122
2040,158,9,699,564,3470,336,654,30,626,1916,3562,37,123
1374,232,9,880,731,3226,316,748,73,677,1552,3366,37,124
365,172,10,1166,509,2222,104,870,78,489,838,2379,37,125
216,141,4,788,280,1429,72,621,20,427,586,1726,37,126
1801,182,9,710,449,3151,350,504,24,566,1815,3259,37,127
2299,172,4,657,665,3797,401,794,33,588,2102,3918,37,128
2218,176,1,753,782,3930,410,901,35,549,2145,4040,37,129
1946,145,6,783,556,3436,359,604,34,641,1985,3623,37,130
1340,187,14,679,507,2727,299,567,66,653,1437,3022,37,131
475,215,13,1267,425,2395,133,613,72,566,1169,2553,37,132
215,145,4,704,280,1348,98,369,29,439,657,1592,37,133
1697,160,23,744,524,3148,353,635,42,558,1692,3280,37,134
2220,180,7,667,557,3631,371,655,35,585,2200,3846,37,135
2246,163,4,733,604,3750,358,752,27,597,2115,3849,37,136
2082,186,6,870,621,3765,390,777,33,659,2010,3869,37,137
1416,244,5,775,624,3064,325,654,60,639,1482,3160,37,138
271,218,7,930,467,1893,106,652,73,455,809,2095,37,139
329,166,9,787,283,1574,84,439,45,484,764,1816,37,140
1734,178,3,714,600,3229,331,682,22,591,1778,3404,37,141
2285,190,5,767,701,3948,399,791,35,635,2171,4031,37,142
2333,185,5,943,584,4050,401,692,36,719,2374,4222,37,143
2000,167,2,808,586,3563,407,631,28,682,1944,3692,37,144
1163,220,8,887,854,3132,330,833,83,683,1211,3140,37,145
453,257,5,1610,750,3075,112,1184,145,639,1026,3106,37,146
326,135,3,1325,413,2202,96,435,89,619,1190,2429,37,147
335,161,14,997,273,1780,113,490,42,564,955,2164,37,148
2151,169,4,807,575,3706,357,625,61,591,2143,3777,37,149
2234,173,1,789,531,3728,427,660,33,601,2231,3952,37,150
2082,184,2,876,636,3780,394,739,31,611,2130,3905,37,151
1426,248,6,849,693,3222,334,714,79,652,1592,3371,37,152
373,201,13,1130,530,2247,120,720,82,583,980,2485,37,153
251,146,8,833,293,1531,101,411,17,456,754,1739,37,154
1937,166,13,746,566,3428,348,705,35,516,1941,3545,37,155
2419,178,11,955,677,4240,433,867,53,658,2401,4412,37,156
2348,178,20,962,580,4088,407,864,41,613,2362,4287,37,157
2168,189,2,859,940,4158,446,1041,78,596,2095,4256,37,158
1454,288,7,1029,1152,3930,314,1169,140,704,1692,4019,37,159
447,278,16,2669,1235,4645,94,2384,161,579,1398,4616,37,160
253,167,9,1757,421,2607,82,759,39,537,1432,2849,37,161
1870,160,31,805,532,3398,401,637,75,601,1838,3552,37,162
2437,198,7,922,682,4246,491,826,46,649,2378,4390,37,163
2346,194,0,1084,782,4406,488,945,103,702,2341,4579,37,164
2063,180,4,971,674,3892,481,764,35,681,2043,4004,37,165
1374,243,10,988,1052,3667,337,909,180,647,1644,3717,37,166
446,212,11,1191,666,2526,116,1017,113,581,917,2744,37,167
230,164,3,951,253,1601,104,402,21,518,854,1899,37,168
1763,180,11,759,508,3221,363,563,35,574,1737,3272,37,169
2212,169,5,930,871,4187,425,1029,42,748,2104,4348,37,170
674,192,26,1056,576,2524,227,849,58,554,968,2656,37,171
1853,259,9,1106,678,3905,373,842,35,539,2045,3834,37,172
1426,252,17,892,628,3215,302,772,105,680,1561,3420,37,173
348,285,6,1072,617,2328,103,866,122,542,853,2486,37,174
249,161,13,708,375,1506,116,398,122,430,658,1724,37,175
1865,177,10,753,517,3322,379,632,31,559,1836,3437,37,176
2330,183,10,870,574,3967,420,789,44,619,2287,4159,37,177
2349,157,28,842,675,4051,393,859,45,700,2271,4268,37,178
2240,210,12,882,656,4000,429,856,41,666,2143,4135,37,179
1474,258,9,970,665,3376,347,775,78,682,1626,3508,37,180
486,255,6,1575,478,2800,148,700,74,989,1064,2975,37,181
259,156,13,735,280,1443,101,433,29,435,753,1751,37,182
1760,207,11,892,718,3588,404,814,37,640,1923,3818,37,183
2156,182,23,913,801,4075,412,909,102,650,2188,4261,37,184
1863,246,31,1149,1127,4416,333,1162,97,892,1903,4387,37,185
547,1912,26,1751,2578,6814,103,4401,270,885,969,6628,37,186
837,211,3,1067,688,2806,290,775,70,671,1213,3019,37,187
351,236,5,1144,426,2162,106,785,63,467,897,2318,37,188
218,151,9,799,285,1462,100,454,25,516,696,1791,37,189
1712,155,24,915,503,3309,408,712,47,564,1786,3517,37,190
2057,194,27,802,571,3651,430,801,69,592,2005,3897,37,191
2108,184,26,815,560,3693,425,759,51,584,2018,3837,37,192
1905,210,3,816,611,3545,403,791,52,579,1969,3794,37,193
1383,240,9,886,705,3223,305,731,82,626,1572,3316,37,194
411,288,14,1486,1067,3266,116,1494,112,560,1111,3393,37,195
264,144,24,725,288,1445,103,379,66,469,661,1678,37,196
1758,176,42,778,391,3145,359,549,76,547,1694,3225,37,197
2117,159,6,756,611,3649,390,850,36,570,1998,3844,37,198
2128,154,14,728,521,3545,385,595,38,590,2155,3763,37,199
2015,180,16,1001,626,3838,390,799,68,682,2127,4066,37,200
1387,268,10,937,891,3493,307,839,231,688,1503,3568,37,201
334,254,3,1285,939,2815,128,1245,93,525,1055,3046,37,202
267,174,10,1159,287,1897,109,452,28,520,1055,2164,37,203
1697,134,31,782,624,3268,349,847,51,491,1681,3419,37,204
2179,204,30,898,665,3976,417,853,52,565,2187,4074,37,205
2136,186,21,931,766,4040,412,900,94,609,2238,4253,37,206
2017,207,11,1017,623,3875,408,760,44,614,2194,4020,37,207
1364,230,8,1048,697,3347,306,709,171,655,1610,3451,37,208
352,242,10,1386,821,2811,76,939,266,560,1093,2934,37,209
230,172,24,872,368,1666,83,503,106,491,803,1986,37,210
1688,121,30,871,831,3541,372,690,278,544,1797,3681,37,211
2167,156,10,783,511,3627,388,650,36,599,2241,3914,37,212
2197,161,13,756,516,3643,385,627,34,537,2253,3836,37,213
1974,180,9,817,598,3578,351,670,51,556,2108,3736,37,214
1472,231,11,1058,963,3735,292,1142,143,626,1553,3756,37,215
520,159,17,1620,425,2741,57,1080,163,526,1029,2855,37,216
347,141,15,1018,271,1792,84,464,31,486,1058,2123,37,217
1606,133,21,713,526,2999,354,580,40,533,1769,3276,37,218
2128,170,25,799,737,3859,392,884,57,562,2124,4019,37,219
2033,164,20,800,562,3579,372,690,38,601,2134,3835,37,220
1833,144,4,773,570,3324,326,596,67,583,1875,3447,37,221
1213,194,7,695,588,2697,277,594,125,544,1153,2693,37,222
324,218,3,1151,623,2319,114,832,63,510,917,2436,37,223
277,134,16,848,416,1691,88,611,30,472,888,2089,37,224
1650,161,11,742,397,2961,336,482,25,628,1818,3289,37,225
2052,147,6,786,579,3570,424,668,34,634,2142,3902,37,226
2040,143,6,815,584,3588,347,641,39,638,2122,3787,37,227
1787,165,4,731,593,3280,332,620,46,632,1774,3404,37,228
1286,180,10,852,607,2935,294,649,66,685,1452,3146,37,229
323,284,5,984,509,2105,93,594,145,512,959,2303,37,230
211,148,4,694,315,1372,71,420,33,393,711,1628,37,231
1552,139,3,667,420,2781,330,460,25,502,1661,2978,37,232
2124,177,10,743,634,3688,382,781,46,563,2064,3836,37,233
2008,165,4,724,688,3589,395,692,98,582,2050,3817,37,234
1835,175,6,834,532,3382,367,654,38,507,2008,3574,37,235
1291,215,11,720,763,3000,294,785,89,575,1419,3162,37,236
465,188,2,1366,617,2638,109,903,68,597,1130,2807,37,237
220,148,0,744,359,1471,89,533,71,416,676,1785,37,238
1620,143,4,669,679,3115,345,769,17,506,1665,3302,37,239
2086,144,4,692,777,3703,384,935,23,577,2041,3960,37,240
2041,183,9,688,767,3688,421,875,37,528,2015,3876,37,241
1939,183,7,737,684,3550,404,615,175,554,1836,3584,37,242
984,200,11,803,687,2685,301,633,95,585,1165,2779,37,243
368,167,7,1499,511,2552,86,1018,69,532,957,2662,37,244
217,151,3,1102,300,1773,80,505,32,422,956,1995,37,245
194,143,5,774,241,1357,123,441,24,425,742,1755,37,246
2125,145,14,656,474,3414,376,600,27,590,2063,3656,37,247
2121,153,6,651,499,3430,369,585,30,588,2001,3573,37,248
1973,147,6,658,543,3327,373,695,25,522,1894,3509,37,249
1333,202,8,733,600,2876,315,603,68,580,1366,2932,37,250
329,184,1,881,626,2021,110,605,238,473,796,2222,37,251
269,170,0,641,310,1390,83,467,20,468,632,1670,37,252
1717,178,1,687,525,3108,330,664,54,563,1693,3304,37,253
2282,156,6,704,655,3803,394,812,29,561,2149,3945,37,254
2270,177,1,777,672,3897,402,848,32,590,2088,3960,37,255
2039,149,0,817,626,3631,369,914,38,598,1930,3849,37,256
1320,255,3,788,802,3168,326,835,100,628,1489,3378,37,257
378,235,1,1325,659,2598,121,1006,125,567,1031,2850,37,258
231,155,7,1106,346,1845,71,473,19,499,1108,2170,37,259
1750,155,3,669,465,3042,356,557,20,524,1748,3205,37,260
2257,139,4,701,501,3602,382,781,25,554,2204,3946,37,261
2257,141,0,712,537,3647,379,781,23,597,2105,3885,37,262
2041,183,2,790,740,3756,377,928,29,608,1965,3907,37,263
1361,226,6,786,666,3045,353,664,102,654,1494,3267,37,264
384,228,3,1224,703,2542,80,899,198,566,943,2686,37,265
231,153,2,687,276,1349,86,442,28,393,617,1566,37,266
1799,137,5,682,445,3068,332,563,51,411,1871,3228,37,267
2275,138,2,770,586,3771,376,844,39,537,2201,3997,37,268
2202,181,0,655,706,3744,342,914,21,585,2059,3921,37,269
2022,197,0,884,623,3726,378,839,65,589,2087,3958,37,270
1411,235,13,724,721,3104,301,794,160,637,1403,3295,37,271
322,225,5,1785,802,3139,105,1392,102,585,1077,3261,37,272
207,139,2,968,273,1589,84,723,41,469,603,1920,37,273
1667,122,3,643,423,2858,320,526,21,563,1714,3144,37,274
2261,123,2,673,501,3560,362,655,24,552,2201,3794,37,275
2269,132,0,775,581,3757,367,690,27,591,2145,3820,37,276
2083,170,0,880,628,3761,399,729,27,599,2027,3781,37,277
1365,200,9,828,629,3031,323,600,93,655,1498,3169,37,278
338,189,8,1166,550,2251,86,815,75,491,943,2410,37,279
255,154,4,903,294,1610,83,458,23,478,905,1947,37,280
1767,134,4,725,478,3108,349,618,21,577,1777,3342,37,281
2298,147,1,732,498,3676,364,707,30,577,2243,3921,37,282
2304,182,1,787,590,3864,371,738,28,589,2295,4021,37,283
1999,168,0,840,619,3626,345,802,20,593,2016,3776,37,284
1235,237,6,1054,677,3209,319,757,54,728,1473,3331,37,285
715,242,11,1585,781,3334,99,1231,91,685,1381,3487,37,286
913,155,5,1020,450,2543,100,563,117,1214,876,2870,37,287
911,118,7,945,399,2380,239,529,27,593,1311,2699,37,288
2647,123,2,890,700,4362,372,976,33,660,2509,4550,37,289
2548,141,1,788,552,4030,388,772,32,676,2283,4151,37,290
2110,152,0,854,719,3835,378,883,37,592,2085,3975,37,291
1414,249,6,826,680,3175,303,672,78,637,1558,3248,37,292
371,197,6,1075,634,2283,115,788,103,584,872,2462,37,293
175,129,3,1041,309,1657,113,731,18,441,636,1939,37,294
1710,128,3,744,554,3139,402,631,31,499,1765,3328,37,295
2241,134,6,710,587,3678,381,744,27,564,2187,3903,37,296
2264,166,8,766,689,3893,411,874,47,621,2197,4150,37,297
2088,162,9,698,716,3673,413,886,48,528,2012,3887,37,298
1414,205,6,746,604,2975,350,665,70,709,1549,3343,37,299
473,182,7,1107,605,2374,122,774,128,665,894,2583,37,300
1415,162,1,1448,412,3438,128,704,89,1326,1298,3545,37,301
1803,110,9,658,497,3077,356,566,24,570,1924,3440,37,302
2356,154,6,947,1188,4651,405,1505,20,642,2334,4906,37,303
2327,152,0,721,571,3771,373,696,29,624,2214,3936,37,304
1955,179,0,678,714,3526,349,665,37,700,1874,3625,37,305
1375,197,9,877,681,3139,307,625,65,660,1475,3132,37,306
341,242,7,1251,691,2532,96,1066,86,568,864,2680,37,307
251,123,7,746,306,1433,102,428,23,472,728,1753,37,308
1798,120,6,704,612,3240,380,633,25,617,1792,3447,37,309
1668,132,4,733,503,3040,364,447,36,613,1798,3258,37,310
1841,120,1,636,652,3250,371,629,30,545,1782,3357,37,311
1986,148,0,707,607,3448,391,644,21,537,1953,3546,37,312
1208,212,5,781,745,2951,354,684,49,685,1278,3050,37,313
360,192,4,1143,442,2141,124,548,79,573,993,2317,37,314
264,130,2,1093,309,1798,89,460,28,457,1069,2103,37,315
787,128,3,820,397,2135,224,480,40,574,1148,2466,37,316
2266,122,3,662,515,3568,383,632,21,545,2210,3791,37,317
2312,125,12,721,677,3847,398,704,102,580,2133,3917,37,318
2116,128,7,691,582,3524,382,664,35,532,2028,3641,37,319
1405,173,6,691,639,2914,310,628,52,570,1570,3130,37,320
345,189,6,1052,407,1999,104,492,52,490,1030,2168,37,321
209,101,9,620,337,1276,87,433,10,419,588,1537,37,322
1794,129,14,661,519,3117,366,530,48,522,1711,3177,37,323
2288,133,7,648,554,3630,424,657,12,543,2210,3846,37,324
2237,138,3,715,567,3660,391,667,36,565,2156,3815,37,325
2070,137,1,710,695,3613,335,825,37,602,1954,3753,37,326
1336,170,7,615,722,2850,312,676,77,633,1400,3098,37,327
318,179,5,960,668,2130,106,729,123,468,920,2346,37,328
267,115,1,931,260,1574,74,336,29,472,940,1851,37,329
1614,139,6,833,540,3132,320,532,61,619,1778,3310,37,330
1788,177,3,951,698,3617,384,720,24,681,2098,3907,37,331
1163,208,0,1147,591,3109,331,621,33,1041,1521,3547,37,332
155,134,1,208,145,643,61,134,12,416,364,987,37,333
521,198,4,1475,492,2690,185,602,45,583,1368,2783,37,334
233,140,6,1132,413,1924,98,557,63,492,977,2187,37,335
196,126,0,911,359,1592,82,444,13,422,845,1806,37,336
1729,125,4,587,476,2921,333,492,14,474,1711,3024,37,337
2239,116,5,612,697,3669,358,771,16,564,2158,3867,37,338
2228,127,30,674,560,3619,377,690,43,556,2104,3770,37,339
2028,121,10,721,669,3549,359,842,36,552,1940,3729,37,340
1347,195,8,682,589,2821,291,595,39,572,1375,2872,37,341
276,162,9,1076,768,2291,100,912,92,486,842,2432,37,342
159,116,9,704,395,1383,59,464,60,429,620,1632,37,343
1708,136,14,577,468,2903,346,565,35,472,1738,3156,37,344
2384,129,16,659,480,3668,375,717,38,549,2277,3956,37,345
2395,136,18,643,490,3682,343,767,55,566,2154,3885,37,346
2160,155,0,722,684,3721,346,891,29,615,2103,3984,37,347
1387,205,4,709,697,3002,289,661,64,639,1500,3153,37,348
1054,167,7,1335,719,3282,136,1017,109,1249,981,3492,37,349
177,127,7,589,327,1227,79,472,13,444,507,1515,37,350
1689,130,5,630,593,3047,342,527,13,584,1796,3262,37,351
2130,133,1,809,688,3761,398,685,60,579,2224,3946,37,352
2102,150,4,744,592,3592,363,659,44,604,2101,3771,37,353
1821,148,7,782,698,3456,335,793,21,610,1887,3646,37,354
1133,179,7,739,926,2984,275,896,43,638,1236,3088,37,355
217,158,1,972,496,1844,101,549,52,454,816,1972,37,356
215,118,0,1048,457,1838,76,636,12,376,974,2074,37,357
967,153,0,1141,721,2982,292,791,14,718,1428,3243,37,358
374,76,4,440,257,1151,175,238,16,442,521,1392,37,359
70,74,3,183,140,470,48,124,8,187,179,546,37,360
567,120,2,919,582,2190,204,608,18,445,977,2252,37,361
717,183,2,1058,510,2470,233,520,49,582,1150,2534,37,362
168,177,7,868,419,1639,72,522,64,360,761,1779,37,363
186,94,4,893,375,1552,58,417,82,429,744,1730,37,364
966,155,4,1258,614,2997,278,671,26,728,1439,3142,37,365
797,457,70,1120,555,2999,236,387,294,705,1343,2965,37,366
85,140,6,346,284,861,89,150,11,379,291,920,38,1
929,265,12,888,1005,3099,723,292,15,771,1249,3050,38,2
1194,325,7,929,1167,3622,769,456,11,803,1500,3539,38,3
1097,310,20,930,1205,3562,764,375,30,811,1506,3486,38,4
713,377,11,892,1166,3159,590,447,44,833,1123,3037,38,5
125,236,12,605,444,1422,137,231,33,584,418,1403,38,6
88,205,16,790,458,1557,91,207,19,614,573,1504,38,7
1187,280,12,918,1088,3485,776,393,16,866,1418,3469,38,8
1309,232,11,873,809,3234,786,297,16,806,1318,3223,38,9
1477,341,18,1138,1187,4161,882,507,12,935,1711,4047,38,10
1336,373,16,1054,1320,4099,831,591,20,878,1673,3993,38,11
823,366,28,948,1057,3222,580,367,46,835,1196,3024,38,12
178,399,22,1258,699,2556,167,392,40,749,1040,2388,38,13
129,243,5,761,472,1610,110,240,11,621,591,1573,38,14
239,262,15,822,601,1939,349,289,17,727,537,1919,38,15
456,244,20,635,702,2057,487,306,25,617,580,2015,38,16
1153,306,17,1076,1062,3614,771,450,23,846,1464,3554,38,17
1425,403,15,1045,1337,4225,836,718,20,917,1555,4046,38,18
491,293,25,667,643,2119,396,301,28,557,695,1977,38,19
130,343,23,745,652,1893,169,360,58,601,594,1782,38,20
75,214,14,626,482,1411,101,265,19,535,516,1436,38,21
1212,330,39,861,1070,3512,770,422,40,799,1497,3528,38,22
1587,358,13,1030,1257,4245,887,576,16,820,1809,4108,38,23
1536,374,33,1112,1230,4285,867,627,32,911,1781,4218,38,24
1392,366,41,1021,1284,4104,828,631,39,909,1609,4016,38,25
929,522,33,1060,1226,3770,648,530,55,953,1371,3557,38,26
161,419,17,1019,777,2393,176,422,46,854,814,2312,38,27
128,286,12,815,512,1753,127,234,13,655,619,1648,38,28
1186,313,21,927,1115,3562,772,467,15,831,1447,3532,38,29
1597,348,16,1016,1242,4219,868,550,22,866,1822,4128,38,30
1556,381,25,1056,1241,4259,814,552,20,881,1807,4074,38,31
1430,371,16,993,1301,4111,761,567,22,965,1688,4003,38,32
890,490,25,942,1287,3634,617,561,43,897,1275,3393,38,33
129,284,24,761,589,1787,113,254,24,587,504,1482,38,34
112,182,8,605,382,1289,97,154,17,482,426,1176,38,35
1241,358,4,972,1123,3698,791,425,8,926,1482,3632,38,36
1557,398,38,1077,1337,4407,885,651,38,916,1801,4291,38,37
1624,418,10,1118,1306,4476,890,612,18,972,1809,4301,38,38
1442,404,11,1055,1312,4224,824,575,18,950,1700,4067,38,39
993,474,42,1012,1246,3767,662,521,62,990,1362,3597,38,40
187,375,42,1038,936,2578,198,480,31,915,885,2509,38,41
133,252,13,755,536,1689,127,247,12,596,743,1725,38,42
1237,288,13,885,1050,3473,740,480,11,781,1457,3469,38,43
1402,352,20,981,1290,4045,798,696,21,816,1613,3944,38,44
1555,424,24,1143,1273,4419,822,571,24,999,1911,4327,38,45
1482,411,26,1050,1276,4245,792,620,26,938,1654,4030,38,46
846,431,88,1071,1221,3657,637,458,113,906,1286,3400,38,47
299,404,40,939,667,2349,261,371,71,676,776,2155,38,48
185,260,6,823,543,1817,129,276,22,648,700,1775,38,49
345,267,11,933,773,2329,417,308,23,763,703,2214,38,50
1517,341,5,1108,1290,4261,848,612,15,980,1742,4197,38,51
1556,435,15,1115,1194,4315,878,599,18,905,1854,4254,38,52
1433,386,8,1116,1301,4244,863,618,12,918,1692,4103,38,53
943,474,114,1058,1146,3735,639,529,87,913,1335,3503,38,54
56,59,17,41,37,210,49,44,26,44,22,185,38,55
55,66,25,25,36,207,40,58,28,27,20,173,38,56
1250,314,32,879,1120,3595,809,509,24,769,1502,3613,38,57
1611,351,5,1024,1285,4276,899,623,9,898,1800,4229,38,58
1506,367,6,1083,1101,4063,838,548,12,888,1718,4004,38,59
1446,415,16,1091,1230,4198,873,677,22,949,1609,4130,38,60
891,392,28,1038,1270,3619,613,614,36,955,1321,3539,38,61
159,404,24,850,747,2184,161,450,50,667,707,2035,38,62
129,248,13,893,549,1832,98,265,15,647,734,1759,38,63
1205,298,24,871,1130,3528,790,453,26,819,1497,3585,38,64
1595,382,9,1021,1245,4252,859,597,16,892,1831,4195,38,65
1583,404,16,1141,1308,4452,839,712,19,907,1913,4390,38,66
1445,424,13,1128,1416,4426,832,800,20,977,1795,4424,38,67
1003,503,30,1087,1317,3940,652,613,66,975,1471,3777,38,68
737,979,35,3455,2091,7297,431,2275,225,1983,2537,7451,38,69
458,691,11,2720,1254,5134,305,1216,38,1843,2499,5901,38,70
1203,353,10,1050,1101,3717,752,516,15,856,1486,3625,38,71
1563,412,14,1169,1408,4566,888,880,28,965,1910,4671,38,72
1655,439,7,1380,1327,4808,904,770,24,1058,2002,4758,38,73
1478,438,7,1274,1452,4649,837,826,40,1053,1841,4597,38,74
904,447,23,1111,1287,3772,603,568,96,980,1371,3618,38,75
1136,1411,40,5647,2736,10970,492,3228,406,2794,4313,11233,38,76
549,611,49,3573,2016,6798,308,1996,86,1976,3031,7397,38,77
1231,360,13,1016,1135,3755,799,525,10,852,1615,3801,38,78
1656,426,8,1222,1355,4667,907,718,14,987,1985,4611,38,79
1634,419,5,1284,1407,4749,857,824,14,1025,1874,4594,38,80
1539,432,15,1258,1497,4741,865,776,28,981,1846,4496,38,81
1006,473,18,1225,1411,4133,660,688,60,1039,1453,3900,38,82
164,444,36,907,813,2364,151,538,51,584,917,2241,38,83
209,290,6,1198,667,2370,107,445,15,757,1024,2348,38,84
1151,382,3,1250,1225,4011,733,648,32,888,1611,3912,38,85
1543,405,6,1486,1364,4804,837,796,7,1005,2066,4711,38,86
1393,395,12,1300,1173,4273,786,669,19,989,1732,4195,38,87
1281,432,14,1292,1212,4231,770,671,19,1007,1711,4178,38,88
773,511,41,1395,1221,3941,570,626,56,1013,1555,3820,38,89
222,440,18,1490,992,3162,200,647,46,971,1151,3015,38,90
196,253,8,913,521,1891,119,315,18,717,745,1914,38,91
1021,400,6,1141,1099,3667,647,727,17,811,1460,3662,38,92
1620,362,19,1200,1214,4415,801,663,17,962,1981,4424,38,93
1546,386,24,1060,1298,4314,837,725,22,893,1873,4350,38,94
1502,456,14,1313,1464,4749,814,850,19,1053,1924,4660,38,95
979,563,46,1381,1365,4334,644,753,64,1071,1645,4177,38,96
285,536,28,1376,945,3170,168,537,69,1041,1200,3015,38,97
321,275,10,969,704,2279,152,494,19,894,689,2248,38,98
1244,378,18,1019,1046,3705,753,574,15,862,1497,3701,38,99
1597,459,24,1188,1293,4561,898,763,37,1016,1823,4537,38,100
1592,440,21,1260,1351,4664,890,798,25,1087,1931,4731,38,101
1598,440,23,1235,1346,4642,877,748,13,1000,1872,4510,38,102
1048,637,38,1206,1412,4341,750,756,43,1034,1497,4080,38,103
273,492,16,1286,928,2995,183,669,46,902,1094,2894,38,104
249,291,16,1032,616,2204,138,439,21,823,785,2206,38,105
1227,365,7,1147,1271,4017,758,668,17,874,1570,3887,38,106
1530,394,8,1282,1371,4585,863,783,22,1038,1866,4572,38,107
1685,440,13,1340,1355,4833,866,791,26,1055,1839,4577,38,108
1499,460,14,1277,1463,4713,851,925,31,1082,1802,4691,38,109
1042,549,35,1179,1332,4137,658,658,49,978,1621,3964,38,110
255,489,25,1275,944,2988,198,826,71,842,960,2897,38,111
146,306,18,837,591,1898,119,265,28,664,727,1803,38,112
1191,400,6,1039,1235,3871,803,552,6,945,1683,3989,38,113
1652,461,16,1172,1460,4761,937,745,20,1065,1942,4709,38,114
1715,450,11,1267,1507,4950,981,830,29,1135,1888,4863,38,115
1669,386,6,1263,1497,4821,876,792,18,1138,1812,4636,38,116
941,596,45,1134,1495,4211,714,813,79,971,1465,4042,38,117
204,443,20,1023,729,2419,182,446,70,835,767,2300,38,118
167,336,20,916,647,2086,120,398,34,733,740,2025,38,119
1226,373,6,1034,1127,3766,791,496,6,909,1545,3747,38,120
1607,418,24,1151,1322,4522,920,666,30,991,1851,4458,38,121
1545,449,13,1192,1376,4575,920,722,25,1016,1842,4525,38,122
1421,384,13,1265,1418,4501,906,704,14,1102,1738,4464,38,123
942,603,37,1096,1380,4058,728,723,56,1006,1423,3936,38,124
204,421,20,986,706,2337,187,441,55,728,795,2206,38,125
115,276,9,785,460,1645,111,281,17,645,603,1657,38,126
1257,374,12,1093,1202,3938,804,519,18,947,1537,3825,38,127
1554,398,4,1229,1420,4605,925,770,22,1003,1871,4591,38,128
1593,472,7,1254,1489,4815,891,856,32,1083,1888,4750,38,129
1488,489,17,1197,1384,4575,897,752,24,987,1793,4453,38,130
871,469,21,1067,1213,3641,695,511,41,977,1329,3553,38,131
203,482,22,1063,730,2500,174,439,26,825,913,2377,38,132
147,279,11,760,500,1697,120,279,21,666,592,1678,38,133
1278,363,4,950,1281,3876,814,536,15,904,1570,3839,38,134
1613,360,5,1133,1285,4396,856,581,14,1013,1903,4367,38,135
1672,423,6,1197,1358,4656,937,700,21,1048,1898,4604,38,136
1488,483,10,1224,1444,4649,900,775,29,1111,1856,4671,38,137
952,540,33,1133,1309,3967,708,603,55,1019,1433,3818,38,138
198,451,60,1024,716,2449,163,497,48,831,855,2394,38,139
197,282,7,972,588,2046,156,389,7,804,754,2110,38,140
1372,401,6,1109,1371,4259,873,682,8,1017,1584,4164,38,141
1654,441,19,1236,1515,4865,992,878,26,1016,1896,4808,38,142
1667,467,10,1390,1380,4914,971,672,28,1009,2069,4749,38,143
1507,425,10,1144,1350,4436,852,633,10,1066,1716,4277,38,144
831,497,22,1191,1322,3863,684,639,67,1095,1264,3749,38,145
199,437,29,1053,711,2429,170,589,50,802,723,2334,38,146
178,314,38,964,584,2078,114,421,51,760,739,2085,38,147
170,227,19,699,459,1574,153,308,22,566,540,1589,38,148
1517,413,9,1202,1273,4414,886,580,27,1028,1881,4402,38,149
1620,392,7,1295,1271,4585,973,640,15,1026,1835,4489,38,150
1538,472,11,1294,1339,4654,891,733,24,1078,1766,4492,38,151
927,512,19,1158,1208,3824,710,602,46,1005,1337,3700,38,152
188,524,29,990,834,2565,210,622,47,808,794,2481,38,153
179,283,6,929,607,2004,144,362,12,783,664,1965,38,154
1450,408,7,1110,1307,4282,850,650,13,1018,1827,4358,38,155
1806,376,12,1239,1439,4872,929,748,18,1042,2076,4813,38,156
1786,423,28,1343,1330,4910,870,769,29,1108,2001,4777,38,157
1677,439,13,1170,1473,4772,892,829,28,1094,1849,4692,38,158
1089,625,19,1155,1557,4445,698,930,83,1072,1431,4214,38,159
225,505,27,1530,1186,3473,215,960,85,942,1178,3380,38,160
184,316,9,1103,633,2245,135,459,15,763,812,2184,38,161
1401,365,13,1077,1261,4117,870,596,11,953,1662,4092,38,162
1727,450,18,1251,1309,4755,918,737,20,1023,1978,4676,38,163
1738,456,11,1283,1448,4936,901,812,18,1059,2059,4849,38,164
1620,504,13,1321,1430,4888,888,809,22,1122,1914,4755,38,165
999,583,23,1266,1360,4231,698,690,77,1080,1414,3959,38,166
273,530,18,1159,918,2898,185,614,67,949,922,2737,38,167
167,319,7,898,556,1947,142,331,14,685,774,1946,38,168
1299,415,6,1131,1071,3922,802,518,17,923,1624,3884,38,169
1665,455,11,1243,1526,4900,942,770,28,1125,1928,4793,38,170
526,398,2,1219,1088,3233,610,563,9,1008,879,3069,38,171
1517,518,14,1391,1292,4732,875,732,31,1134,1804,4576,38,172
998,537,19,1070,1073,3697,702,591,44,956,1292,3585,38,173
241,552,32,949,764,2538,196,641,116,770,690,2413,38,174
168,281,5,824,544,1822,144,308,20,702,610,1784,38,175
1380,382,7,1070,1149,3988,797,607,20,923,1614,3961,38,176
1681,423,16,1230,1320,4670,909,724,19,1085,1940,4677,38,177
1697,393,6,1244,1334,4674,983,700,20,1062,1934,4699,38,178
1617,499,4,1291,1367,4778,902,737,6,1096,1850,4591,38,179
954,566,20,1126,1219,3885,707,581,57,1023,1306,3674,38,180
232,519,22,1095,765,2633,219,532,51,921,888,2611,38,181
165,304,5,840,567,1881,147,281,24,695,687,1834,38,182
1273,361,10,1127,1272,4043,793,613,14,921,1613,3954,38,183
1447,433,8,1200,1331,4419,848,677,11,1110,1787,4433,38,184
1254,466,6,1276,1366,4368,782,784,36,1140,1502,4244,38,185
209,1290,15,1180,1145,3839,170,1768,32,910,689,3569,38,186
538,509,13,1154,897,3111,516,507,56,876,950,2905,38,187
190,465,18,992,636,2301,170,489,53,718,744,2174,38,188
178,268,11,797,536,1790,120,290,10,693,676,1789,38,189
1301,344,7,1063,1154,3869,802,573,12,842,1608,3837,38,190
1667,398,19,1135,1218,4437,908,717,22,942,1790,4379,38,191
1617,412,32,1214,1279,4554,905,680,39,983,1883,4490,38,192
1570,490,23,1241,1365,4689,876,726,35,1091,1745,4473,38,193
976,473,31,1065,1087,3632,698,516,55,909,1242,3420,38,194
236,472,10,1006,802,2526,173,559,67,892,808,2499,38,195
177,288,5,841,486,1797,117,326,8,759,642,1852,38,196
1302,291,14,938,1064,3609,842,488,23,856,1493,3702,38,197
1661,389,18,1042,1310,4420,945,734,29,966,1754,4428,38,198
1589,401,29,1158,1167,4344,985,555,40,1002,1827,4409,38,199
1520,435,25,1227,1252,4459,875,673,28,1013,1692,4281,38,200
967,494,38,1127,1305,3931,696,708,84,1000,1362,3850,38,201
208,481,31,1009,868,2597,159,639,63,906,754,2521,38,202
162,285,7,920,538,1912,144,353,13,690,677,1877,38,203
1278,316,16,994,1068,3672,772,516,23,883,1467,3661,38,204
1662,398,22,1169,1336,4587,928,773,23,1012,1809,4545,38,205
1563,406,7,1260,1262,4498,885,777,17,1000,1763,4442,38,206
1481,418,12,1286,1250,4447,845,627,10,1046,1797,4325,38,207
979,466,22,1193,1126,3786,698,611,69,1000,1342,3720,38,208
219,464,26,1103,755,2567,179,539,69,812,888,2487,38,209
190,269,21,867,498,1845,111,313,34,712,667,1837,38,210
1198,332,14,1017,1109,3670,742,548,73,896,1441,3700,38,211
1562,335,25,1139,1164,4225,868,584,36,952,1764,4204,38,212
1531,423,18,1831,1211,5014,2005,609,33,1179,1692,5518,38,213
1410,432,19,1079,1193,4133,789,603,20,969,1664,4045,38,214
930,430,19,1047,1092,3518,689,621,57,939,1172,3478,38,215
201,354,14,996,633,2198,166,452,59,790,750,2217,38,216
209,243,4,833,479,1768,120,312,3,753,665,1853,38,217
1149,374,22,954,1097,3596,740,542,27,856,1331,3496,38,218
1413,357,40,1046,1177,4033,890,587,48,877,1646,4048,38,219
1328,381,9,1013,1203,3934,845,653,18,883,1571,3970,38,220
1154,348,16,989,1046,3553,749,471,19,883,1368,3490,38,221
631,429,17,788,995,2860,574,450,56,716,966,2762,38,222
182,450,19,853,739,2243,200,497,58,784,632,2171,38,223
148,242,17,815,449,1671,107,228,23,711,641,1710,38,224
1026,306,9,925,972,3238,702,450,11,813,1255,3231,38,225
1281,336,10,1097,1188,3912,841,526,15,866,1607,3855,38,226
1266,352,4,1055,1173,3850,838,549,12,907,1532,3838,38,227
1180,407,18,1087,1141,3833,788,648,17,931,1395,3779,38,228
776,443,22,1045,1043,3329,596,455,55,943,1120,3169,38,229
171,383,46,920,738,2258,176,415,46,809,701,2147,38,230
154,240,22,759,481,1656,118,263,25,655,549,1610,38,231
954,350,13,943,1000,3260,756,415,10,853,1296,3330,38,232
1241,390,22,1072,1258,3983,803,665,22,935,1563,3988,38,233
1257,405,8,1105,1250,4025,817,651,12,933,1613,4026,38,234
1159,404,7,1162,1130,3862,775,533,10,994,1497,3809,38,235
798,517,24,1066,1100,3505,622,513,52,968,1160,3315,38,236
214,447,18,1026,850,2555,179,634,42,839,921,2615,38,237
163,271,8,882,497,1821,121,304,12,718,624,1779,38,238
1183,299,7,963,1153,3605,743,600,11,845,1466,3665,38,239
1503,364,7,1055,1314,4243,832,667,12,948,1778,4237,38,240
1483,351,14,1082,1318,4248,895,673,18,951,1686,4223,38,241
1280,329,14,1063,1213,3899,802,539,15,922,1629,3907,38,242
828,489,20,1007,1222,3566,624,545,43,985,1172,3369,38,243
185,379,23,1045,789,2421,158,537,50,745,885,2375,38,244
135,325,6,1060,538,2064,115,363,15,705,782,1980,38,245
142,254,5,746,514,1661,155,297,10,660,592,1714,38,246
1546,341,14,1058,1220,4179,897,575,23,942,1832,4269,38,247
1629,356,5,1070,1244,4304,920,567,12,973,1826,4298,38,248
1450,379,10,1161,1278,4278,888,650,11,970,1701,4220,38,249
995,482,23,1011,1182,3693,734,536,71,944,1272,3557,38,250
194,422,12,1038,985,2651,196,595,147,873,858,2669,38,251
149,244,5,815,535,1748,133,270,7,735,604,1749,38,252
1387,348,11,1016,1158,3920,862,536,12,847,1629,3886,38,253
1803,412,4,1122,1352,4693,943,788,8,987,1957,4683,38,254
1742,373,10,1201,1410,4736,946,738,28,962,1943,4617,38,255
1690,384,12,1171,1446,4703,868,859,15,1044,1798,4584,38,256
981,528,19,1116,1440,4084,746,751,44,1011,1444,3996,38,257
216,473,26,1083,1010,2808,169,671,59,922,918,2739,38,258
165,248,6,1016,555,1990,149,294,14,787,767,2011,38,259
1408,434,10,1046,1260,4158,885,545,12,897,1805,4144,38,260
1791,380,10,1172,1324,4677,935,744,26,1024,2013,4742,38,261
1711,419,5,1125,1340,4600,903,730,21,968,1966,4588,38,262
1706,455,19,1185,1501,4866,919,897,25,1018,1949,4808,38,263
1124,517,25,1115,1410,4191,741,690,56,1022,1483,3992,38,264
202,461,38,1172,841,2714,176,583,101,879,852,2591,38,265
154,216,9,861,544,1784,118,279,17,783,599,1796,38,266
1402,323,9,998,1225,3957,883,473,8,911,1636,3911,38,267
1753,379,20,1168,1400,4720,986,665,28,1018,2018,4715,38,268
1774,413,16,1200,1448,4851,936,737,24,1019,1994,4710,38,269
1522,448,21,1256,1343,4590,912,712,32,1086,1864,4606,38,270
1012,528,37,1152,1385,4114,780,757,57,1063,1450,4107,38,271
249,492,21,1265,1035,3062,206,777,54,908,1007,2952,38,272
196,246,7,938,581,1968,137,300,8,774,714,1933,38,273
1410,330,12,1030,1168,3950,823,498,27,822,1758,3928,38,274
1731,408,5,1161,1342,4647,932,651,13,1001,1952,4549,38,275
1620,389,7,1129,1382,4527,960,654,18,969,1940,4541,38,276
1450,473,10,1240,1438,4611,880,702,15,1161,1769,4527,38,277
1025,541,29,1179,1371,4145,784,628,50,1115,1462,4039,38,278
176,478,25,1045,907,2631,196,591,68,904,855,2614,38,279
163,264,13,887,558,1885,119,284,12,749,723,1887,38,280
1384,353,4,1043,1306,4090,866,572,10,929,1736,4113,38,281
1800,412,2,1191,1387,4792,953,701,8,1042,2073,4777,38,282
1744,459,5,1261,1371,4840,996,688,14,1048,2156,4902,38,283
1555,503,10,1311,1431,4810,944,744,11,1093,1922,4714,38,284
933,554,14,1167,1297,3965,766,647,42,1008,1454,3917,38,285
273,458,13,1223,859,2826,197,610,56,981,907,2751,38,286
238,308,16,1025,648,2235,123,429,24,810,837,2223,38,287
592,272,11,1062,994,2931,568,406,20,937,1018,2949,38,288
1815,391,15,1231,1505,4957,973,854,13,1059,2068,4967,38,289
1784,404,24,1252,1361,4825,1001,759,38,921,2080,4799,38,290
1548,485,5,1234,1541,4813,915,847,16,1019,1883,4680,38,291
1047,558,31,1287,1444,4367,745,758,71,1068,1609,4251,38,292
250,478,32,1123,944,2827,187,689,60,1022,894,2852,38,293
190,242,10,901,645,1988,140,411,16,765,662,1994,38,294
1405,340,13,1141,1276,4175,867,567,19,949,1827,4229,38,295
1769,427,2,1236,1483,4917,999,705,9,1068,2126,4907,38,296
1752,536,3,1312,1496,5099,1072,826,18,1056,2116,5088,38,297
1633,508,23,1419,1483,5066,961,853,22,1059,1962,4857,38,298
1059,574,16,1276,1393,4318,759,642,78,1122,1557,4158,38,299
303,469,24,1191,954,2941,208,534,66,981,1041,2830,38,300
332,299,10,1031,618,2290,163,326,17,964,781,2251,38,301
1364,382,15,1100,1310,4171,860,526,21,932,1875,4214,38,302
1792,436,27,1205,2017,5477,953,1348,28,1085,1968,5382,38,303
1734,441,20,1271,1521,4987,960,823,23,1063,2114,4983,38,304
1436,445,16,1135,1450,4482,876,604,29,1054,1935,4498,38,305
986,596,15,1127,1369,4093,723,605,64,1028,1561,3981,38,306
218,463,38,1116,1008,2843,173,717,52,919,897,2758,38,307
156,283,4,939,556,1938,159,249,6,877,675,1966,38,308
1376,304,10,1105,1352,4147,907,532,13,999,1665,4116,38,309
1297,367,7,1243,1242,4156,901,470,28,1070,1646,4115,38,310
1438,366,5,1160,1334,4303,915,586,9,987,1780,4277,38,311
1564,437,7,1189,1359,4556,980,617,11,1007,1869,4484,38,312
988,470,15,1239,1424,4136,788,629,49,1091,1522,4079,38,313
198,388,35,1164,821,2606,186,449,51,858,858,2402,38,314
166,243,17,983,535,1944,130,252,22,774,716,1894,38,315
783,278,8,1106,1090,3265,654,379,18,991,1167,3209,38,316
1834,376,19,1134,1447,4810,984,606,28,1045,2051,4714,38,317
1726,373,9,1208,1537,4853,1057,774,25,1023,1954,4833,38,318
1639,403,15,1183,1397,4637,977,668,29,1056,1940,4670,38,319
1065,510,23,1190,1339,4127,822,599,53,1057,1492,4023,38,320
243,465,20,1180,811,2719,180,493,59,926,982,2640,38,321
185,242,6,945,670,2048,134,312,14,796,753,2009,38,322
1385,352,4,1150,1250,4141,908,483,22,952,1713,4078,38,323
1773,387,26,1209,1482,4877,984,641,34,1096,2114,4869,38,324
1761,422,6,1240,1377,4806,997,663,14,1055,2040,4769,38,325
1669,398,10,1189,1540,4806,965,765,16,1083,1840,4669,38,326
1027,451,16,1083,1263,3840,797,517,38,958,1382,3692,38,327
187,436,30,962,916,2531,202,451,55,843,798,2349,38,328
115,243,8,860,556,1782,126,256,16,689,708,1795,38,329
1184,306,13,1127,1215,3845,871,454,10,994,1600,3929,38,330
1263,373,4,1266,1266,4172,813,519,10,1104,1738,4184,38,331
707,346,9,1272,1034,3368,707,496,16,1085,1140,3444,38,332
124,207,4,372,290,997,97,151,7,412,392,1059,38,333
248,326,27,1278,721,2600,309,375,35,761,984,2464,38,334
133,315,32,871,668,2019,165,373,36,747,699,2020,38,335
116,249,10,727,542,1644,125,282,21,616,622,1666,38,336
1279,305,16,1025,1204,3829,872,478,20,876,1620,3866,38,337
1608,393,33,1151,1510,4695,971,674,21,990,1966,4622,38,338
1609,395,15,1290,1369,4678,967,678,29,1027,1988,4689,38,339
1532,372,5,1171,1535,4615,952,701,19,1033,1815,4520,38,340
1005,452,20,1078,1239,3794,718,587,34,1032,1462,3833,38,341
144,504,22,1098,1050,2818,168,631,82,871,919,2671,38,342
122,298,2,942,661,2025,126,388,16,701,759,1990,38,343
1395,325,40,995,1327,4082,871,570,39,960,1731,4171,38,344
1848,431,14,1233,1498,5024,1018,856,10,1049,2127,5060,38,345
1830,435,10,1171,1334,4780,1012,755,14,953,1849,4583,38,346
1717,437,10,1404,1560,5128,984,892,20,1118,2080,5094,38,347
1038,560,23,1310,1430,4361,822,711,49,1095,1509,4186,38,348
233,447,34,1197,1036,2947,199,584,78,867,953,2681,38,349
141,248,5,904,631,1929,152,352,9,708,669,1890,38,350
1256,344,15,1098,1207,3920,842,489,21,945,1562,3859,38,351
1573,415,31,1331,1584,4934,997,844,46,1022,1972,4881,38,352
1508,402,7,1225,1399,4541,926,635,14,1057,1883,4515,38,353
1321,481,16,1343,1438,4599,877,709,28,1152,1715,4481,38,354
761,472,17,1086,1275,3611,663,545,37,969,1254,3468,38,355
159,330,19,843,704,2055,188,348,24,703,664,1927,38,356
104,235,3,799,592,1733,102,302,7,627,630,1668,38,357
507,256,5,1066,1013,2847,577,288,6,844,1051,2766,38,358
268,205,6,702,472,1653,410,174,8,615,455,1662,38,359
73,106,4,201,133,517,42,81,6,210,158,497,38,360
319,242,24,784,790,2159,443,334,28,598,789,2192,38,361
347,325,20,1008,927,2627,487,354,31,759,874,2505,38,362
122,306,22,825,609,1884,144,362,34,564,695,1799,38,363
126,198,3,725,483,1535,111,232,11,548,592,1494,38,364
536,273,4,1061,1018,2892,562,388,12,829,1092,2883,38,365
453,420,124,1194,710,2901,543,308,208,789,961,2809,38,366
146,959,14,1194,1657,3970,247,389,29,1686,1200,3551,39,1
606,2356,17,1568,4323,8870,2729,811,24,2425,2694,8683,39,2
760,5769,22,1829,5043,13423,3559,2013,21,2786,5187,13566,39,3
754,2345,24,1880,4872,9875,3265,774,29,2768,2884,9720,39,4
662,6846,244,1797,3983,13532,2226,1733,77,2549,7145,13730,39,5
229,5286,230,2258,2612,10615,521,1521,86,3743,4509,10380,39,6
189,1698,31,1813,6153,9884,407,663,38,6510,2176,9794,39,7
732,4864,35,1655,4452,11738,3103,1235,43,2520,4684,11585,39,8
920,2411,17,2334,4415,10097,4182,644,36,2532,2756,10150,39,9
928,2770,17,2345,6181,12241,4437,941,34,3148,3110,11670,39,10
910,7075,26,2272,5259,15542,3878,1417,43,3126,6822,15286,39,11
710,2497,194,2125,4140,9666,2240,1165,81,2911,3154,9551,39,12
222,3222,215,2372,8617,14648,533,1351,79,8784,3480,14227,39,13
206,1857,18,2052,3192,7325,359,789,16,3494,2145,6803,39,14
284,1846,16,2044,5591,9781,626,656,27,5431,2222,8962,39,15
478,5345,30,1168,2126,9147,1295,1104,31,1845,4807,9082,39,16
773,2523,48,1786,5319,10449,3554,885,49,3004,3037,10529,39,17
954,7417,31,2246,5792,16440,4168,2321,29,3579,6799,16896,39,18
649,2663,238,1760,2744,8054,1378,1481,61,2564,2855,8339,39,19
426,5844,316,2820,3838,13244,603,1800,97,4307,5272,12079,39,20
202,4262,30,2161,3176,9831,388,619,21,3566,4380,8974,39,21
815,2046,17,1677,4502,9057,3131,766,24,2542,2578,9041,39,22
958,3532,37,1987,6321,12835,4740,938,26,3153,3818,12675,39,23
961,5873,38,1948,6202,15022,4739,1439,36,3113,5457,14784,39,24
946,5305,40,1962,5749,14002,4104,1582,45,3124,4863,13718,39,25
699,3260,274,2271,4327,10831,2433,1547,79,3137,3310,10506,39,26
247,5276,335,2882,6601,15341,529,1631,89,7088,4791,14128,39,27
187,1359,31,2356,4963,8896,413,489,52,5634,1788,8376,39,28
869,1971,21,1710,4468,9039,3146,790,26,2365,2617,8944,39,29
1027,2830,32,1938,6148,11975,4741,911,41,2958,3172,11823,39,30
1084,5882,54,2122,6093,15235,4757,1486,57,3222,5503,15025,39,31
983,3006,76,2044,5586,11695,3877,1029,74,3225,3164,11369,39,32
736,6737,568,2150,4387,14578,2485,2557,213,2887,6256,14398,39,33
356,2547,275,2351,4897,10426,569,1361,117,5064,2933,10044,39,34
200,1574,92,1737,5077,8680,438,700,89,4107,2947,8281,39,35
845,1959,78,1845,4323,9050,3173,832,72,2505,2456,9038,39,36
1010,6382,84,1949,6252,15677,4795,1363,90,2932,6377,15557,39,37
1029,5208,56,2237,6254,14784,4786,1331,51,3276,4934,14378,39,38
993,2826,80,2095,5515,11509,4066,920,81,2974,3009,11050,39,39
787,4088,254,2156,4294,11579,2522,2288,72,2970,3457,11309,39,40
251,5832,303,4453,5008,15847,650,2093,102,7680,5556,16081,39,41
192,1416,92,2602,8523,12825,409,671,104,10880,2171,14235,39,42
915,2088,98,1847,4516,9464,3188,743,106,2671,2602,9310,39,43
1077,6727,112,2320,6090,16326,4563,1274,121,3457,6764,16179,39,44
1096,2960,105,2245,6434,12840,4622,1247,129,3343,3408,12749,39,45
999,2889,84,2189,5463,11624,4049,1058,94,3080,3086,11367,39,46
646,4281,253,2247,4159,11586,2315,1629,87,2890,4425,11346,39,47
209,3108,286,2791,4619,11013,530,1428,113,5633,3329,11033,39,48
166,2218,104,2086,3667,8241,385,837,99,3841,2475,7637,39,49
365,1578,77,2295,3230,7545,966,720,72,3380,2126,7264,39,50
917,6563,75,1879,5792,15226,4359,1268,83,3048,6536,15294,39,51
995,3508,114,2169,6022,12808,4525,1068,130,3271,3507,12501,39,52
966,5786,112,2137,5450,14451,4073,1335,99,3223,5582,14312,39,53
720,2914,235,2069,4276,10214,2438,1469,57,2984,3196,10144,39,54
198,2731,268,2433,4143,9773,573,1418,81,4228,3063,9363,39,55
202,4082,47,1838,3010,9179,426,687,47,3354,4105,8619,39,56
876,5730,41,1861,4678,13186,3373,1283,46,2677,5763,13142,39,57
1036,6048,72,2136,6341,15633,4974,1219,75,3033,5875,15176,39,58
1029,2856,61,2179,6245,12370,4814,869,51,3066,3282,12082,39,59
937,3355,39,1930,5549,11810,4267,1089,39,2899,3352,11646,39,60
799,7816,334,2155,4303,15407,2557,2231,69,3101,7536,15494,39,61
217,4003,295,2228,4064,10807,525,1900,112,4254,3640,10431,39,62
239,1978,92,2301,6628,11238,524,875,78,7466,2236,11179,39,63
891,2281,49,1841,4719,9781,3439,917,43,2618,2650,9667,39,64
1069,4025,56,1917,6225,13292,4703,1132,49,3141,3983,13008,39,65
1013,6145,39,2307,6324,15828,4813,1457,43,3526,5777,15616,39,66
998,5671,61,2226,5928,14884,4275,2467,47,3386,4196,14371,39,67
796,6369,322,2321,4475,14283,2512,2362,74,3442,5653,14043,39,68
267,7451,243,2992,4677,15630,667,1742,57,5628,6719,14813,39,69
195,2214,44,2094,3964,8511,420,781,52,3806,2545,7604,39,70
895,2567,90,1872,4832,10256,3109,969,108,2853,2943,9982,39,71
1034,4917,53,2339,6938,15281,4665,1360,63,4612,4196,14896,39,72
1083,6675,52,2947,7790,18547,4783,1890,49,5840,5737,18299,39,73
916,7578,324,3275,8268,20361,4264,2160,143,7333,6088,19988,39,74
731,6140,1743,2572,4841,16027,2451,2521,109,3714,6899,15694,39,75
419,7524,393,3721,4442,16499,909,4312,143,5210,4993,15567,39,76
398,5539,54,2226,3170,11387,411,875,47,3616,5393,10342,39,77
852,2693,51,2028,4967,10591,3204,992,52,3061,2934,10243,39,78
1005,5648,54,2270,6866,15843,4891,1550,64,3688,5082,15275,39,79
1065,8790,42,2595,7026,19518,4914,3072,39,4093,6637,18755,39,80
1039,6443,49,2491,6354,16376,4488,1880,57,3829,5464,15718,39,81
793,8730,415,2738,5091,17767,2584,2283,102,3908,8455,17332,39,82
229,6471,331,2862,5616,15509,633,3121,76,5814,4797,14441,39,83
328,2680,34,3110,8335,14487,629,1027,50,8843,3158,13707,39,84
1027,6780,96,2355,5550,15808,3268,2378,106,3539,6023,15314,39,85
1117,8515,69,2510,7072,19283,4518,1621,83,4072,8618,18912,39,86
1139,6105,63,2852,6511,16670,4403,1508,79,4213,5662,15865,39,87
1003,3908,68,2778,6642,14399,3948,1382,48,4172,4010,13560,39,88
759,6892,371,2972,5427,16421,2311,2551,125,4315,6563,15865,39,89
337,8216,299,3407,6161,18420,665,2329,86,5867,7865,16812,39,90
301,4547,55,2590,3188,10681,490,875,63,3760,4768,9956,39,91
807,2973,182,2518,5232,11712,2999,2752,130,3454,3686,13021,39,92
980,6587,39,2352,6913,16871,4707,1482,45,3805,6171,16210,39,93
1062,7145,63,2517,6782,17569,4854,1727,75,3677,6671,17004,39,94
992,8641,49,2727,6732,19141,4611,1998,56,4221,8481,19367,39,95
775,6729,338,2879,6232,16953,2731,2866,91,4344,6561,16593,39,96
366,3308,258,4219,4883,13034,916,2130,87,5539,3809,12481,39,97
389,5534,46,2883,3012,11864,586,941,47,3699,6274,11547,39,98
855,2325,70,1989,4840,10079,3156,919,49,2894,2718,9736,39,99
1033,6013,72,2136,6395,15649,4795,3160,55,3348,4422,15780,39,100
1075,3403,79,2646,6363,13566,5001,1142,57,3842,3250,13292,39,101
997,3595,49,2173,5876,12690,4369,1212,49,3382,3521,12533,39,102
830,7241,336,2438,4715,15560,2839,2639,81,3367,6556,15482,39,103
344,8036,367,3532,5187,17466,854,2121,123,5475,7661,16234,39,104
251,2127,30,2552,3535,8495,523,875,29,3992,2529,7948,39,105
752,7304,42,2068,4585,14751,3091,1409,53,3077,7229,14859,39,106
923,3292,42,2203,6072,12532,4431,1210,43,3384,3206,12274,39,107
902,3130,11,2392,6782,13217,4630,1081,18,3546,4471,13746,39,108
931,3458,15,2381,5807,12592,4084,1312,24,3503,3403,12326,39,109
711,2938,255,2477,4594,10975,2424,1690,98,3308,3139,10659,39,110
285,4460,267,2717,6788,14517,599,2218,126,4791,4462,12196,39,111
204,1644,39,2064,2679,6630,404,826,45,2910,2155,6340,39,112
890,2193,25,1993,4762,9863,3176,932,36,2774,2675,9593,39,113
1029,3042,42,2113,6601,12827,4624,1297,55,3314,3280,12570,39,114
986,3217,9,2415,6643,13270,4605,1371,17,3670,3334,12997,39,115
989,3603,11,2500,6394,13497,4463,1483,11,3649,3544,13150,39,116
807,8162,323,2469,4704,16465,2704,2310,66,3389,8225,16694,39,117
295,2919,284,2677,3612,9787,658,1638,138,3927,3090,9451,39,118
226,5836,67,2056,3049,11234,509,3139,87,3195,4061,10991,39,119
857,2332,33,1974,4617,9813,3272,936,37,2676,2734,9655,39,120
1033,3184,42,2327,6208,12794,4982,1156,52,3383,3259,12832,39,121
998,3280,25,2307,6424,13034,4819,1134,28,3586,3509,13076,39,122
942,3218,62,2406,5592,12220,4282,1148,75,3712,3195,12412,39,123
796,3237,284,2326,4511,11154,2620,2084,91,3211,3195,11201,39,124
253,2878,229,2507,3386,9253,566,1609,84,3455,3078,8792,39,125
225,1670,20,2078,2651,6644,465,785,23,3144,1981,6398,39,126
831,2218,26,1869,4613,9557,3142,868,26,2729,2575,9340,39,127
995,3213,21,2324,6768,13321,4873,1436,25,3444,3216,12994,39,128
973,3341,24,2570,6691,13599,4837,1384,27,3802,3420,13470,39,129
899,3625,48,2187,5765,12524,4052,1178,54,3194,3678,12156,39,130
742,2917,225,2222,4357,10463,2433,1525,75,3048,3418,10499,39,131
335,2744,226,3170,3647,10122,1083,1353,72,3928,2977,9413,39,132
322,1781,26,1985,2448,6562,454,807,25,3017,1975,6278,39,133
955,2616,25,2076,4749,10421,3261,1005,36,3037,3279,10618,39,134
1063,3512,35,2421,6634,13665,4819,1157,42,3681,3645,13344,39,135
1069,3388,27,2569,6616,13669,4780,1248,34,3771,3642,13475,39,136
1007,3531,33,2708,6184,13463,4420,1245,30,3690,3615,13000,39,137
749,3232,275,2416,4433,11105,2495,1638,70,3295,3478,10976,39,138
263,2996,286,2466,3907,9918,679,1571,83,4259,2982,9574,39,139
242,2053,24,2013,3172,7504,583,805,32,3507,2306,7233,39,140
915,2526,23,2251,5224,10939,3521,1049,19,3048,2985,10622,39,141
1094,3468,39,2431,6812,13844,5176,1304,37,3494,3560,13571,39,142
1156,3059,33,2761,6362,13371,4808,1153,43,3667,3547,13218,39,143
949,2979,65,2358,5662,12013,4021,1070,49,3250,3243,11633,39,144
862,2746,236,2667,4147,10658,2313,1801,92,3168,3207,10581,39,145
289,4391,238,2484,3563,10965,598,2576,71,4021,3374,10640,39,146
301,3902,20,2520,2965,9708,457,2273,23,3457,3298,9508,39,147
321,1508,29,1944,2624,6426,510,762,29,2860,1764,5925,39,148
1012,3881,48,2102,5949,12992,4476,1775,43,3166,3634,13094,39,149
1089,2891,26,2345,6206,12557,4913,1040,24,3172,3233,12382,39,150
1029,3191,9,2285,6139,12653,4338,1211,17,3362,3433,12361,39,151
850,3433,240,2567,4232,11322,2614,1509,94,3193,3739,11149,39,152
386,2540,230,2404,3446,9006,575,1496,100,3748,2676,8595,39,153
260,1578,22,2030,2454,6344,419,820,26,3052,2040,6357,39,154
915,2376,20,2068,5164,10543,3331,1123,25,2835,2956,10270,39,155
1101,3172,22,2564,6843,13702,4791,1305,22,3678,3552,13348,39,156
1095,3241,30,2563,6479,13408,4727,1204,25,3578,3474,13008,39,157
1103,5416,53,2478,6504,15554,4454,1808,48,3739,5302,15351,39,158
919,8364,353,2556,5039,17231,2744,3792,149,3676,7235,17596,39,159
398,7915,370,3527,5021,17231,811,2944,155,4801,6414,15125,39,160
288,3237,30,2452,4161,10168,462,1163,27,4334,3257,9243,39,161
924,2598,63,2115,4817,10517,3282,1097,42,2891,3028,10340,39,162
1153,3489,31,2642,6438,13753,4921,1240,39,3633,3721,13554,39,163
1135,5061,59,2743,6883,15881,4924,2741,43,3835,3967,15510,39,164
1166,3599,31,2381,5901,13078,4299,1276,34,3483,3565,12657,39,165
836,4334,307,2656,4599,12732,2514,2204,124,3323,4146,12311,39,166
355,2932,278,2522,3569,9656,612,1917,115,3775,2879,9298,39,167
284,1827,13,2335,2928,7387,509,848,22,3184,2342,6905,39,168
832,2544,19,2031,4641,10067,3058,976,22,2935,2996,9987,39,169
951,3112,20,2435,6669,13187,4399,1617,29,3403,3347,12795,39,170
437,2293,17,2436,3956,9139,1352,1179,22,3659,2799,9011,39,171
820,3340,13,2460,5635,12268,3835,2709,21,3376,3703,13644,39,172
728,3324,200,2397,4184,10833,2287,1625,79,3075,3463,10529,39,173
317,3838,472,2542,3275,10444,513,2181,113,3883,3264,9954,39,174
275,3125,40,2071,2879,8390,430,1679,25,3236,2743,8113,39,175
885,2338,21,2035,4794,10073,3106,1032,29,3024,2748,9939,39,176
1037,3194,27,2335,6383,12976,4466,1164,22,3450,3411,12513,39,177
1012,4607,20,2410,6208,14257,4690,1493,22,3738,4154,14097,39,178
997,3475,140,2354,6233,13199,4052,1398,153,3655,3632,12890,39,179
841,3503,266,2607,4375,11592,2431,1686,91,3481,3547,11236,39,180
338,2620,278,3087,3744,10067,807,1670,108,4089,2748,9422,39,181
255,1655,45,2033,2756,6744,399,796,56,2953,2213,6417,39,182
866,2213,27,2198,4983,10287,3066,1095,25,3043,2813,10042,39,183
992,4272,35,2446,6162,13907,4039,2157,43,3511,3779,13529,39,184
861,4399,55,2969,5279,13563,3175,2522,55,3762,3926,13440,39,185
413,5997,49,3070,3692,13221,682,3529,61,4419,3954,12645,39,186
564,2839,191,2867,4269,10730,1283,1734,86,3725,3239,10067,39,187
281,2503,229,2488,3403,8904,507,1623,79,3552,2708,8469,39,188
353,1610,16,2035,2531,6545,362,920,21,2863,2159,6325,39,189
944,2114,16,2120,4853,10047,3159,1056,17,2847,2674,9753,39,190
1200,3692,14,3055,6858,14819,4359,1585,18,3902,4043,13907,39,191
1555,3715,12,2757,6625,14664,4722,1523,17,3632,4185,14079,39,192
1400,3796,19,2900,6309,14424,4239,1655,18,3981,4033,13926,39,193
817,5595,305,2507,4231,13455,2296,3188,70,3249,4106,12909,39,194
294,2832,271,2590,3757,9744,602,1864,90,3757,2944,9257,39,195
254,1644,5,2103,2689,6695,421,803,16,3147,2085,6472,39,196
812,2087,13,2150,4679,9741,3136,875,19,2972,2754,9756,39,197
1113,2678,13,3414,6188,13406,4603,1196,18,3418,3038,12273,39,198
1022,3197,37,2370,6405,13031,4547,1125,35,3447,3576,12730,39,199
889,3172,23,2455,5897,12436,3921,1337,28,3396,3330,12012,39,200
731,4565,328,2298,4608,12530,2163,2576,190,3141,3955,12025,39,201
295,6752,306,2561,4197,14111,595,3219,126,3999,5529,13468,39,202
266,1940,19,2164,3063,7452,444,944,19,3137,2625,7169,39,203
768,5564,19,2157,4511,13019,3160,1638,19,3157,5111,13085,39,204
959,3443,29,2276,6521,13228,4426,1381,40,3448,3440,12735,39,205
915,3196,49,2558,6822,13540,4219,1503,57,3568,3476,12823,39,206
879,3528,43,2423,5583,12456,3719,1409,41,3517,3651,12337,39,207
663,3449,302,2447,4205,11066,2323,1856,105,3213,3562,11059,39,208
297,7395,375,2508,4143,14718,671,2934,194,4609,6245,14653,39,209
251,1782,43,2133,2733,6942,398,968,66,3029,2237,6698,39,210
746,2104,23,2100,4865,9838,2990,1201,32,2959,2741,9923,39,211
1020,2844,24,2308,6200,12396,4440,1114,30,3276,3154,12014,39,212
1020,3011,17,2319,5960,12327,4097,1108,18,3276,3357,11856,39,213
949,3172,14,2361,5658,12154,3771,1219,10,3467,3422,11889,39,214
676,6916,294,2246,4353,14485,2327,2559,90,3637,5930,14543,39,215
294,3197,288,2498,4120,10397,716,1345,67,4485,3090,9703,39,216
208,1711,28,2214,3362,7523,518,786,30,3253,2188,6775,39,217
704,2028,11,2075,4482,9300,2828,1049,15,2887,2532,9311,39,218
904,5647,16,2474,6058,15099,4247,1485,20,3808,5191,14751,39,219
881,2731,22,2329,5903,11866,4143,1122,30,3405,3057,11757,39,220
794,5190,18,2187,5087,13276,3439,1646,28,3141,4830,13084,39,221
573,2473,224,1896,3635,8801,1838,1570,98,2514,2734,8754,39,222
277,2316,240,2221,3207,8261,523,1784,74,3404,2602,8387,39,223
243,3272,21,1876,2478,7890,372,916,18,2872,3591,7769,39,224
728,2112,8,1891,4150,8889,2727,893,11,2676,2533,8840,39,225
899,2827,22,2391,5724,11863,4120,1101,26,3479,2994,11720,39,226
881,3179,23,2087,5823,11993,3977,1194,36,3297,3382,11886,39,227
855,2994,20,2128,5416,11413,3371,1168,31,3259,3151,10980,39,228
694,3976,376,2357,3798,11201,2111,2217,78,3140,3530,11076,39,229
273,4266,433,2178,3169,10319,514,2495,107,3531,3333,9980,39,230
202,1508,13,2007,2438,6168,334,642,17,2809,2063,5865,39,231
748,1932,22,1875,4098,8675,2746,794,26,2565,2372,8503,39,232
854,4500,30,2028,6008,13420,4119,2328,37,3058,3506,13048,39,233
921,4507,23,2194,5895,13540,4134,2497,19,3229,3532,13411,39,234
842,2602,24,2106,5172,10746,3486,1176,33,3030,2809,10534,39,235
695,5897,354,2297,3923,13166,2179,3030,78,3136,4752,13175,39,236
268,3302,259,2941,4766,11536,913,1505,73,4931,2981,10403,39,237
239,1517,24,1989,2723,6492,425,760,45,2850,1920,6000,39,238
864,1805,11,1821,4434,8935,2892,925,11,2465,2452,8745,39,239
1065,3461,26,2045,6167,12764,4301,1946,27,2942,3175,12391,39,240
1007,2576,15,2159,6042,11799,4308,1186,30,2920,3077,11521,39,241
960,6520,33,2257,5148,14918,3618,3524,25,3094,4127,14388,39,242
791,2586,266,2333,4113,10089,2139,1761,103,2997,2960,9960,39,243
233,3409,258,2538,3528,9966,561,2043,90,3820,2996,9510,39,244
257,2294,21,2246,3163,7981,475,1156,32,3254,2565,7482,39,245
254,1501,9,1903,2393,6060,440,778,8,2584,1785,5595,39,246
1037,2308,24,1949,5923,11241,4632,919,21,3000,2802,11374,39,247
1129,2698,28,2268,6095,12218,4770,1043,33,3119,3097,12062,39,248
1103,3042,36,2158,5786,12125,4257,1159,47,3168,3377,12008,39,249
818,2893,269,2265,4277,10522,2545,1583,89,3121,3338,10676,39,250
332,2676,262,2811,3820,9901,631,1988,169,3808,2827,9423,39,251
281,2425,27,2157,2503,7393,455,1383,31,2898,2198,6965,39,252
976,2538,26,1877,4807,10224,3484,1951,25,2802,3168,11430,39,253
1200,3093,18,2122,6679,13112,5075,1216,17,3316,3192,12816,39,254
1049,4096,15,2246,6579,13985,4918,1364,18,3543,3943,13786,39,255
1059,4228,69,2275,6443,14074,4595,1511,92,3355,4049,13602,39,256
884,4065,311,2583,4856,12699,2875,2004,95,3353,4246,12573,39,257
259,3953,328,3185,4467,12192,666,1980,120,5173,3933,11872,39,258
264,2200,12,2250,3298,8024,514,834,29,3889,2744,8010,39,259
978,2277,12,2018,4837,10122,3562,902,15,2781,2697,9957,39,260
1166,3105,13,2185,7017,13486,5246,1015,15,3389,3388,13053,39,261
1118,3366,44,2175,6630,13333,4952,1095,40,3459,4055,13601,39,262
1079,9164,35,2594,6070,18942,4803,2256,40,3481,8104,18684,39,263
912,4297,377,2577,4441,12604,2622,2770,143,3427,3913,12875,39,264
329,5500,247,2591,3553,12220,629,2705,124,3909,4931,12298,39,265
226,1917,30,1892,4377,8442,440,748,45,4602,2411,8246,39,266
956,2260,37,1989,4718,9960,3453,833,43,2746,2814,9889,39,267
1169,4687,8,2165,6753,14782,5146,1730,9,3328,4433,14646,39,268
1120,6063,35,2578,6457,16253,4913,2745,26,3606,4771,16061,39,269
1060,4136,21,2230,5937,13384,4100,1759,23,3375,3827,13084,39,270
919,5374,313,2378,4567,13551,2611,2482,87,3265,5079,13524,39,271
292,7034,680,2894,4462,15362,650,3949,162,4768,5143,14672,39,272
268,3221,14,2176,3277,8956,471,1049,17,3440,3142,8119,39,273
1007,2330,13,1938,4912,10200,3465,856,19,2774,2870,9984,39,274
1200,3189,32,2135,6421,12977,5001,1062,32,3211,3332,12638,39,275
1130,3424,36,2562,6407,13559,4866,1118,46,3442,3720,13192,39,276
1040,3410,44,2586,5889,12969,4109,1262,36,3762,3644,12813,39,277
826,4929,401,2485,4362,13003,2549,2847,98,3307,4321,13122,39,278
399,5939,253,3289,4191,14071,694,1961,150,4961,5982,13748,39,279
259,2026,20,2027,2966,7298,491,875,37,3412,2262,7077,39,280
963,2551,27,2138,4962,10641,3623,985,34,3005,2915,10562,39,281
1176,3311,25,2402,6801,13715,5195,1131,25,3468,3563,13382,39,282
1151,3986,123,2763,6901,14924,5139,2293,47,3961,4031,15471,39,283
998,5442,18,2431,6242,15131,4302,1622,20,3719,4951,14614,39,284
768,4921,318,2695,4596,13298,2592,2197,143,3615,4964,13511,39,285
287,8371,350,2960,4709,16677,821,2347,104,5460,7525,16257,39,286
414,4734,47,2371,3305,10871,597,2280,38,3689,3491,10095,39,287
531,2330,35,2369,3876,9141,1744,953,39,3268,2469,8473,39,288
1058,7582,33,2223,6995,17891,5103,1675,41,3749,6981,17549,39,289
1096,3331,19,2975,6760,14181,5135,1234,23,3865,3672,13929,39,290
1078,8107,32,2323,6225,17765,4435,2212,34,3594,7595,17870,39,291
913,6073,364,2750,4720,14820,2806,2767,243,3678,5533,15027,39,292
385,3770,950,3200,4103,12408,706,2918,178,4404,3890,12096,39,293
292,1911,21,2202,3253,7679,429,1067,25,3301,2369,7191,39,294
1051,2553,8,2140,4903,10655,3535,991,16,2995,3044,10581,39,295
1173,3387,25,2253,6829,13667,4993,1148,33,3540,3561,13275,39,296
1203,7766,26,2797,6944,18736,5153,3190,31,4125,6738,19237,39,297
1127,8136,25,2571,6158,18017,4409,2017,38,3694,7398,17556,39,298
926,3485,333,2600,4743,12087,2940,1925,83,3407,3820,12175,39,299
351,6065,347,2811,4351,13925,670,2353,184,4790,5635,13632,39,300
603,4301,30,2274,3035,10243,606,2043,39,3429,3367,9484,39,301
1012,2480,15,2089,5030,10626,3430,886,18,2923,3060,10317,39,302
1135,8470,40,2356,6403,18404,4855,3285,31,3549,6898,18618,39,303
1128,5589,48,2641,7014,16420,5121,1597,45,4080,5493,16336,39,304
1063,6174,14,2247,5841,15339,4215,2251,36,3284,5881,15667,39,305
855,3290,323,2425,4555,11448,2570,1910,119,3189,3626,11414,39,306
296,8009,302,2581,4242,15430,595,1874,110,4769,8086,15434,39,307
303,3265,20,2203,2936,8727,508,1552,26,3555,2779,8420,39,308
982,5163,17,2201,4869,13232,3627,1491,15,2994,5008,13135,39,309
967,2129,55,2529,5063,10743,3744,977,81,3152,2575,10529,39,310
1029,6353,15,2229,5306,14932,3931,1473,21,3230,6760,15415,39,311
1041,2684,26,2071,5629,11451,4055,1022,39,3054,3204,11374,39,312
829,7913,435,2657,4576,16410,2855,2996,116,3400,7351,16718,39,313
332,3084,233,2457,4409,10515,535,1707,107,4198,3699,10246,39,314
291,2881,25,2406,2924,8527,506,1012,36,3335,3269,8158,39,315
532,1810,8,2227,3428,8005,1420,798,18,3177,2325,7738,39,316
1132,2884,58,2191,6654,12919,5123,957,65,3233,3644,13022,39,317
1190,7394,29,2497,6767,17877,5344,3276,54,3592,6545,18811,39,318
1159,3230,39,2525,6282,13235,4609,1092,38,3415,3689,12843,39,319
891,3222,289,2567,4805,11774,2852,1688,77,3390,3851,11858,39,320
295,2869,263,2925,5171,11523,718,1646,93,5599,3439,11495,39,321
247,4186,17,2074,2950,9474,572,825,24,3636,4173,9230,39,322
962,2446,28,1938,4980,10354,3555,952,27,2804,2980,10318,39,323
1218,3209,57,2310,6785,13579,5188,1094,65,3362,3619,13328,39,324
1201,3764,64,2385,6747,14161,5111,1315,56,3589,3804,13875,39,325
1204,7994,64,2456,6304,18022,4511,2058,45,3634,8470,18718,39,326
995,7508,386,2605,4643,16137,2900,2437,78,3550,7429,16394,39,327
354,8371,374,3739,5933,18771,709,2543,104,6736,9207,19299,39,328
291,2371,61,2789,4609,10121,455,914,46,4995,3480,9890,39,329
887,4120,50,2345,4979,12381,3043,1636,39,3334,4099,12151,39,330
897,6231,52,2419,5672,15271,3247,1771,42,3418,6409,14887,39,331
652,5362,10,3139,4292,13455,1883,1527,15,3890,5577,12892,39,332
214,971,12,1193,1336,3726,302,496,23,1679,1070,3570,39,333
358,3436,123,3412,8789,16118,838,1134,30,9341,4574,15917,39,334
229,3558,176,3203,6070,13236,488,1317,87,5904,5184,12980,39,335
195,4714,12,2566,3978,11465,440,1666,11,4388,4314,10819,39,336
901,2629,9,1984,4764,10287,3176,910,16,2880,3504,10486,39,337
1158,8286,19,2288,7011,18762,4981,2271,23,3776,8856,19907,39,338
1167,4148,21,2605,7089,15030,5027,1280,34,3946,4528,14815,39,339
1134,8228,49,2556,7074,19041,4688,2128,57,3922,7985,18780,39,340
983,5107,369,2727,5737,14923,2640,2237,81,4064,5773,14795,39,341
326,9005,408,4536,9214,23489,610,2892,95,9391,10611,23599,39,342
240,5863,48,3934,7215,17300,473,1623,44,8033,7504,17677,39,343
976,4338,32,2130,6134,13610,4030,1251,41,3648,4233,13203,39,344
1125,5610,27,2641,8603,18006,5838,1468,37,4665,5191,17199,39,345
1147,5065,29,2962,7683,16886,5709,1312,34,4585,4363,16003,39,346
1130,8626,29,3193,8770,21748,5266,2353,32,5363,7767,20781,39,347
885,5933,367,3882,7270,18337,3135,2551,100,5500,6683,17969,39,348
411,8808,502,4940,9054,23715,614,3998,164,9576,12126,26478,39,349
274,6191,36,3563,5228,15292,435,883,42,6330,6491,14181,39,350
963,2901,42,2443,5722,12071,3241,971,49,3433,3947,11641,39,351
1093,7849,33,2790,7926,19691,4760,2663,40,4612,7515,19590,39,352
1103,4935,25,2890,7534,16487,4551,1259,35,4617,5550,16012,39,353
954,7303,5,2927,6940,18129,3926,1863,14,4390,7366,17559,39,354
1007,9026,363,3306,6025,19727,2371,2229,81,4560,8992,18233,39,355
398,3879,239,4074,6817,15407,584,1521,86,7012,5273,14476,39,356
294,6512,22,3056,5500,15384,440,890,33,5920,6803,14086,39,357
716,5397,32,3409,7965,17519,1822,1513,49,6934,5636,15954,39,358
530,1254,6,2267,2353,6410,969,525,8,2446,1574,5522,39,359
245,847,4,807,1088,2991,178,380,12,1179,1038,2787,39,360
497,5426,12,2257,4227,12419,1389,1295,15,3622,5000,11321,39,361
540,3123,166,2776,4518,11123,1380,1265,52,3893,3322,9912,39,362
298,5630,274,2830,4143,13175,572,1573,61,4732,4943,11881,39,363
304,2343,43,2311,3975,8976,460,923,98,3697,2515,7693,39,364
630,6358,28,2602,4678,14296,1862,1441,39,4155,6447,13944,39,365
595,1961,914,2789,7486,13745,1755,1730,514,7913,2469,14381,39,366
168,240,5,686,495,1594,109,415,18,474,618,1634,40,1
1130,367,4,1005,1039,3545,415,660,22,779,1448,3324,40,2
1594,372,3,1255,1395,4619,820,752,12,902,1672,4158,40,3
1581,407,5,1205,1539,4737,894,804,21,945,1727,4391,40,4
1230,532,39,1085,1532,4418,713,773,76,841,1478,3881,40,5
284,402,38,953,575,2252,147,589,68,625,660,2089,40,6
270,355,5,1023,672,2325,104,563,15,713,834,2229,40,7
1445,450,3,1067,1640,4605,865,788,9,833,1698,4193,40,8
1788,308,4,1015,1045,4160,843,571,20,858,1471,3763,40,9
1857,463,4,1334,1479,5137,898,855,15,909,1897,4574,40,10
1797,523,61,1173,1595,5149,889,955,70,833,1812,4559,40,11
1291,473,29,1244,1572,4609,788,760,90,873,1542,4053,40,12
367,514,32,1476,897,3286,154,747,105,851,1196,3053,40,13
259,378,3,1182,724,2546,112,593,19,786,822,2332,40,14
446,329,6,1025,665,2471,210,635,42,688,879,2454,40,15
703,321,4,828,772,2628,240,718,12,597,836,2403,40,16
1498,454,6,1386,1424,4768,450,849,15,1118,1811,4243,40,17
1845,491,4,1238,1657,5235,894,967,20,965,1931,4777,40,18
757,485,31,925,850,3048,272,794,88,612,983,2749,40,19
334,499,38,1283,888,3042,148,750,117,822,926,2763,40,20
263,297,5,1023,736,2324,114,561,17,703,769,2164,40,21
1614,423,8,1189,1510,4744,874,800,23,945,1642,4284,40,22
2004,484,1,1234,1572,5295,917,950,17,976,1938,4798,40,23
1903,538,13,1400,1499,5353,910,1025,31,920,1990,4876,40,24
1851,536,3,1173,1519,5082,912,1065,17,881,1818,4693,40,25
1209,715,52,1268,1401,4645,503,1043,119,992,1519,4176,40,26
391,541,35,1373,1003,3343,167,765,142,958,1014,3046,40,27
233,388,4,1093,700,2418,113,592,18,794,807,2324,40,28
1593,404,13,1159,1511,4680,934,788,26,850,1668,4266,40,29
1964,442,61,1215,1511,5193,935,905,75,898,1978,4791,40,30
1907,473,4,1307,1485,5176,908,1025,20,919,1878,4750,40,31
1872,490,4,1245,1539,5150,922,925,19,969,1899,4734,40,32
1376,645,34,1356,1532,4943,853,978,117,962,1601,4511,40,33
334,493,45,1338,907,3117,185,814,74,959,905,2937,40,34
258,318,6,970,659,2211,112,577,35,695,841,2260,40,35
1525,397,5,1186,1485,4598,873,768,15,942,1717,4315,40,36
1958,486,6,1214,1511,5175,939,984,22,950,1906,4801,40,37
1917,493,2,1359,1455,5226,923,1030,13,991,1907,4864,40,38
1810,520,6,1299,1525,5160,908,951,21,917,1876,4673,40,39
1315,666,39,1272,1557,4849,918,943,98,946,1544,4449,40,40
374,562,39,1455,1047,3477,176,854,118,975,1105,3228,40,41
265,414,21,1064,695,2459,117,566,42,671,959,2355,40,42
1512,356,24,1143,1568,4603,912,752,39,890,1797,4390,40,43
1770,427,13,1057,1328,4595,819,858,37,869,1830,4413,40,44
1846,454,16,1418,1363,5097,953,869,21,1011,1943,4797,40,45
1704,384,13,1149,1485,4735,890,895,23,944,1805,4557,40,46
1039,492,24,1083,1252,3890,512,868,117,834,1366,3697,40,47
336,461,27,1129,794,2747,134,662,103,713,972,2584,40,48
242,260,9,960,603,2074,119,538,41,618,731,2047,40,49
467,268,10,907,706,2358,216,580,16,685,903,2400,40,50
1730,333,13,1035,1208,4319,843,820,28,794,1777,4262,40,51
1803,410,11,1103,1384,4711,831,878,27,817,1878,4431,40,52
1696,420,16,1083,1358,4573,824,899,33,837,1775,4368,40,53
1223,473,29,1049,1355,4129,735,851,91,765,1514,3956,40,54
352,447,26,1138,852,2815,176,761,103,829,890,2759,40,55
225,229,3,947,606,2010,96,507,10,565,768,1946,40,56
1534,340,15,954,1434,4277,964,774,22,759,1579,4098,40,57
1898,343,13,1034,1422,4710,998,876,23,752,1950,4599,40,58
1897,341,17,1167,1347,4769,1025,937,21,834,1763,4580,40,59
1760,375,17,1166,1476,4794,897,903,24,802,1776,4402,40,60
1276,491,36,1124,1561,4488,817,886,105,905,1595,4308,40,61
306,476,30,1105,788,2705,156,758,111,754,899,2678,40,62
279,262,2,1054,609,2206,119,487,12,734,830,2182,40,63
1587,321,37,998,1381,4324,933,751,53,751,1623,4111,40,64
1922,325,12,1030,1336,4625,832,888,19,749,1896,4384,40,65
1904,343,8,1214,1310,4779,924,921,26,771,1951,4593,40,66
1797,426,4,1089,1557,4873,969,921,26,832,1849,4597,40,67
1279,563,29,1115,1455,4441,748,921,122,868,1596,4255,40,68
359,351,21,1284,800,2815,170,743,101,941,857,2812,40,69
219,295,5,959,590,2068,104,585,21,599,774,2083,40,70
1538,363,10,1058,1483,4452,976,852,19,821,1660,4328,40,71
1851,385,4,1218,1545,5003,947,1062,22,812,1930,4773,40,72
1924,429,17,1387,1459,5216,995,1135,33,854,1891,4908,40,73
1565,547,12,1207,1385,4716,647,1144,55,833,1782,4461,40,74
1117,532,37,1255,1288,4229,563,937,131,826,1427,3884,40,75
802,652,39,2001,986,4480,214,1071,121,1291,1300,3997,40,76
269,318,13,1092,710,2402,99,741,22,655,819,2336,40,77
1524,384,12,1166,1539,4625,966,852,24,833,1805,4480,40,78
1933,376,4,1190,1569,5072,955,1027,17,857,2013,4869,40,79
1963,449,13,1316,1532,5273,975,1209,27,882,1997,5090,40,80
1819,505,12,1168,1764,5268,911,1229,32,858,1940,4970,40,81
1347,612,26,1395,1664,5044,920,1071,117,977,1669,4754,40,82
310,483,29,1127,950,2899,148,1013,109,655,981,2906,40,83
309,326,9,1157,700,2501,108,738,16,818,960,2640,40,84
1583,422,9,1320,1617,4951,1005,907,18,903,1923,4756,40,85
1886,423,2,1185,1625,5121,1018,1018,13,834,2166,5049,40,86
1872,455,18,1242,1323,4910,960,961,33,842,1944,4740,40,87
1628,525,12,1286,1548,4999,918,1011,26,859,1959,4773,40,88
1164,615,39,1430,1537,4785,848,1060,135,993,1587,4623,40,89
355,440,24,1625,1072,3516,163,1057,114,917,1327,3578,40,90
273,284,11,1152,674,2394,124,570,21,686,910,2311,40,91
1473,373,8,1286,1429,4569,849,998,16,883,1724,4470,40,92
1895,403,14,1392,1528,5232,966,1017,31,861,2039,4914,40,93
1902,388,6,1222,1372,4890,920,1056,24,803,1820,4623,40,94
1797,433,9,1259,1617,5115,927,1134,20,862,2003,4946,40,95
1211,569,31,1284,1342,4437,458,1136,112,914,1553,4173,40,96
443,496,24,1501,888,3352,194,928,93,1042,1035,3292,40,97
482,398,16,1255,645,2796,135,744,31,918,947,2775,40,98
1520,419,12,1152,1325,4428,894,850,27,844,1692,4307,40,99
1898,448,13,1198,1594,5151,1025,967,20,925,2054,4991,40,100
1966,447,24,1284,1486,5207,950,1035,36,947,1993,4961,40,101
1802,425,13,1188,1510,4938,917,984,24,808,1868,4601,40,102
1408,570,38,1282,1524,4822,838,1024,113,926,1684,4585,40,103
411,518,48,1348,1040,3365,198,1011,139,890,1025,3263,40,104
289,354,13,1113,659,2428,105,707,19,788,842,2461,40,105
1298,391,16,1133,1022,3860,461,973,28,858,1480,3800,40,106
1464,413,14,1169,987,4047,380,1014,40,735,1628,3797,40,107
1633,466,39,1172,993,4303,455,1086,48,819,1488,3896,40,108
1562,483,15,1157,1130,4347,474,1081,39,935,1617,4146,40,109
1091,588,33,1174,1281,4167,445,978,127,844,1510,3904,40,110
388,592,22,1523,1084,3609,177,1120,167,841,1332,3637,40,111
271,323,8,1053,521,2176,109,603,17,662,864,2255,40,112
1491,355,10,1035,1339,4230,951,805,15,792,1564,4127,40,113
1886,406,2,1115,1594,5003,976,1067,21,813,1997,4874,40,114
1882,437,2,1293,1559,5173,979,1176,15,879,1987,5036,40,115
1786,414,4,1212,1577,4993,987,1139,18,899,1801,4844,40,116
1423,537,16,1202,1607,4785,884,1150,118,894,1536,4582,40,117
390,1170,30,1260,1931,4781,162,890,149,1636,2260,5097,40,118
314,364,6,1109,730,2523,128,734,29,783,915,2589,40,119
1641,345,7,1098,1370,4461,1025,818,19,797,1692,4351,40,120
1965,443,8,1309,1441,5166,1064,991,16,886,1967,4924,40,121
1969,462,10,1334,1464,5239,1037,1043,25,921,1937,4963,40,122
1840,443,11,1237,1481,5012,987,973,39,906,1872,4777,40,123
1382,614,19,1329,1591,4935,925,1126,113,970,1603,4737,40,124
340,467,24,1242,828,2901,156,883,85,817,875,2816,40,125
283,332,1,1035,617,2268,137,669,17,676,815,2314,40,126
1537,387,3,1084,1446,4457,959,874,15,873,1619,4340,40,127
1977,391,5,1218,1558,5149,1034,1145,20,854,1867,4920,40,128
2008,553,6,1441,1482,5490,1083,1155,42,1042,1957,5279,40,129
1805,511,27,1139,1527,5009,971,1029,41,847,1909,4797,40,130
1326,514,20,1211,1500,4571,894,883,94,905,1595,4371,40,131
438,487,35,1290,892,3142,206,755,127,981,1049,3118,40,132
281,300,11,981,508,2081,123,591,19,723,752,2208,40,133
1551,403,6,1081,1466,4507,974,908,18,871,1686,4457,40,134
1964,340,6,1167,1413,4890,1009,1044,32,839,1799,4723,40,135
1960,473,8,1339,1332,5112,1019,1092,35,944,1932,5022,40,136
1826,487,19,1244,1661,5237,954,1100,52,866,1998,4970,40,137
1298,556,28,1305,1562,4749,838,976,111,996,1558,4479,40,138
369,475,31,1297,883,3055,139,934,117,802,945,2937,40,139
349,340,4,1134,647,2474,103,672,18,755,862,2410,40,140
1580,445,2,1144,1490,4661,997,973,13,844,1808,4635,40,141
1967,425,4,1190,1577,5163,1015,1164,27,890,1939,5035,40,142
1932,477,12,1423,1517,5361,963,1128,23,945,2082,5141,40,143
1758,482,2,1177,1532,4951,943,972,22,902,1858,4697,40,144
1231,561,18,1338,1711,4859,905,1083,111,1028,1428,4555,40,145
369,424,32,1270,928,3023,168,953,105,820,919,2965,40,146
306,456,6,1114,652,2534,114,846,23,704,857,2544,40,147
288,307,4,879,531,2009,126,600,12,638,729,2105,40,148
1791,313,2,1028,1369,4503,1018,866,21,744,1850,4499,40,149
1918,411,8,1288,1380,5005,987,901,26,898,1888,4700,40,150
1797,481,2,1184,1573,5037,963,1039,23,872,1847,4744,40,151
1427,617,28,1338,1583,4993,905,1084,101,966,1592,4648,40,152
390,637,57,1278,942,3304,185,957,127,893,1046,3208,40,153
297,334,8,1128,589,2356,122,616,18,788,870,2414,40,154
1648,384,7,1077,1540,4656,956,938,33,901,1794,4622,40,155
1910,406,25,1284,1422,5047,735,1148,40,911,1980,4814,40,156
2094,435,5,1378,1264,5176,991,1103,16,919,2007,5036,40,157
1978,471,6,1277,1778,5510,1034,1306,32,997,1951,5320,40,158
1430,629,37,1321,1956,5373,819,1376,159,986,1697,5037,40,159
451,696,68,1896,1339,4450,193,1685,210,1081,1576,4745,40,160
294,353,6,1340,771,2764,127,872,20,760,1027,2806,40,161
1746,407,1,1150,1398,4702,934,857,24,909,1822,4546,40,162
2033,443,21,1217,1491,5205,972,1084,37,910,1951,4954,40,163
2014,449,1,1411,1442,5317,910,1262,31,965,1903,5071,40,164
1918,496,1,1387,1447,5249,936,1119,21,1007,1876,4959,40,165
1393,586,41,1380,1503,4903,824,1146,128,1030,1529,4657,40,166
377,593,34,1355,1072,3431,167,1153,157,891,1006,3374,40,167
284,309,6,1165,600,2364,128,737,27,724,875,2491,40,168
1486,398,1,1065,1217,4167,685,871,29,894,1685,4164,40,169
1766,423,1,1254,1185,4629,595,1062,22,822,1722,4223,40,170
650,483,0,1254,1000,3387,300,1038,30,786,1101,3255,40,171
1683,502,2,1207,1091,4485,485,1015,33,868,1702,4103,40,172
1175,608,31,1153,1132,4099,448,999,134,830,1416,3827,40,173
395,615,39,1198,878,3125,175,1062,167,822,871,3097,40,174
286,386,10,962,601,2245,134,609,48,683,798,2272,40,175
1427,380,5,1091,1004,3907,503,866,19,810,1528,3726,40,176
1843,409,4,1182,1035,4473,544,999,27,833,1833,4236,40,177
1851,444,4,1036,1119,4454,601,1055,25,774,1902,4357,40,178
1763,483,12,1331,1212,4801,615,1129,34,919,1761,4458,40,179
1313,596,25,1354,1262,4550,590,1038,122,1055,1434,4239,40,180
358,575,32,1202,906,3073,168,1032,127,854,904,3085,40,181
255,318,14,1014,695,2296,121,636,34,705,773,2269,40,182
1367,400,4,1187,1146,4104,566,929,11,914,1601,4021,40,183
1646,431,12,1288,1141,4518,624,1012,31,944,1714,4325,40,184
1423,500,3,1344,1332,4602,609,1113,40,1011,1600,4373,40,185
360,1199,22,1206,1037,3824,142,1190,52,925,902,3211,40,186
730,539,24,1174,976,3443,374,960,87,806,1123,3350,40,187
354,463,24,1095,738,2674,152,838,126,755,778,2649,40,188
276,305,5,946,637,2169,125,606,20,731,741,2223,40,189
1401,390,4,1088,951,3834,595,861,11,878,1609,3954,40,190
1772,415,25,1185,1090,4487,649,1039,40,966,1922,4616,40,191
1740,392,5,1303,1125,4565,709,1041,30,1012,1899,4691,40,192
1781,483,7,1292,1220,4783,691,1082,44,1031,1908,4756,40,193
1249,560,22,1261,1192,4284,621,1081,107,901,1471,4181,40,194
383,587,25,1228,932,3155,200,1011,119,787,901,3018,40,195
275,334,3,1088,614,2314,124,644,24,714,818,2324,40,196
1457,347,11,1119,911,3845,571,722,33,833,1584,3743,40,197
1777,395,6,1160,1143,4481,624,1040,38,857,1797,4356,40,198
1759,382,5,1221,1093,4460,601,890,14,901,1878,4284,40,199
1692,454,1,1192,1142,4481,587,976,28,876,1758,4225,40,200
1188,621,32,1195,1446,4482,487,1085,238,879,1418,4107,40,201
339,532,39,1259,865,3034,185,999,138,893,925,3140,40,202
313,364,9,1003,591,2280,112,658,22,736,867,2395,40,203
1371,322,13,1063,917,3686,536,797,23,818,1462,3636,40,204
1785,392,11,1141,1080,4409,572,1087,19,837,1802,4317,40,205
1629,448,9,1233,1158,4477,526,1045,24,915,1869,4379,40,206
1698,503,9,1250,1102,4562,542,1080,25,942,1735,4324,40,207
1166,621,20,1244,1121,4172,519,1038,121,856,1463,3997,40,208
366,577,37,1241,915,3136,180,1008,167,830,958,3143,40,209
283,326,5,1020,680,2314,126,735,55,679,753,2348,40,210
1346,379,5,1168,1084,3982,540,913,59,892,1518,3922,40,211
1687,358,7,1092,1017,4161,536,892,18,764,1751,3961,40,212
1708,434,10,1180,900,4232,516,960,30,820,1739,4065,40,213
1583,493,12,1240,1089,4417,502,969,19,869,1796,4155,40,214
1179,606,22,1275,1181,4263,491,1087,115,913,1355,3961,40,215
383,434,38,1300,778,2933,181,766,103,867,1017,2934,40,216
277,355,3,1087,600,2322,134,615,15,697,923,2384,40,217
1244,342,11,1071,919,3587,454,809,23,754,1391,3431,40,218
1583,385,5,1137,942,4052,475,903,36,801,1641,3856,40,219
1557,376,4,1072,977,3986,466,942,16,792,1645,3861,40,220
1461,338,4,1030,877,3710,432,808,19,717,1582,3558,40,221
879,493,23,1055,996,3446,363,891,120,695,1141,3210,40,222
371,531,31,1177,808,2918,171,954,94,816,899,2934,40,223
322,335,6,1008,576,2247,102,635,20,687,817,2261,40,224
1206,379,2,1005,833,3425,468,787,19,751,1331,3356,40,225
1556,359,1,1104,971,3991,524,866,15,851,1617,3873,40,226
1509,420,2,1148,1055,4134,469,974,15,816,1674,3948,40,227
1421,464,6,1065,1051,4007,487,1010,55,777,1546,3875,40,228
1013,569,25,1156,1173,3936,461,947,96,847,1386,3737,40,229
332,464,36,1242,697,2771,138,721,144,817,931,2751,40,230
260,300,2,1115,580,2257,122,584,10,643,879,2238,40,231
1215,340,5,957,1065,3582,653,764,10,732,1381,3540,40,232
1532,377,1,1069,1200,4179,626,1049,26,784,1619,4104,40,233
1466,478,1,1132,1214,4291,691,1006,16,822,1682,4217,40,234
1480,443,1,1152,1193,4269,649,890,20,866,1564,3989,40,235
1092,596,36,1148,1320,4192,647,1029,117,886,1317,3996,40,236
374,528,30,1251,970,3153,170,962,140,843,949,3064,40,237
240,311,4,1103,553,2211,127,674,32,791,794,2418,40,238
1542,332,6,1113,1372,4365,1031,818,17,783,1609,4258,40,239
1864,401,11,1063,1609,4948,919,977,21,834,1953,4704,40,240
1830,402,1,1211,1449,4893,998,1049,10,854,1793,4704,40,241
1729,396,3,1176,1470,4774,1007,898,21,847,1770,4543,40,242
1194,478,24,1377,1527,4600,977,968,112,927,1368,4352,40,243
342,425,26,1179,841,2813,153,856,92,766,872,2739,40,244
294,369,6,998,646,2313,129,648,25,679,813,2294,40,245
252,295,7,892,623,2069,138,614,18,660,794,2224,40,246
1833,359,5,1014,1411,4622,1066,815,13,833,1850,4577,40,247
1879,400,2,1168,1454,4903,1005,873,11,849,1947,4685,40,248
1832,475,3,1159,1593,5062,1026,1000,13,885,1935,4859,40,249
1388,527,43,1118,1716,4792,919,953,107,865,1656,4500,40,250
362,472,20,1327,998,3179,179,973,130,962,1051,3295,40,251
260,291,1,1030,624,2206,127,650,13,753,747,2290,40,252
1658,397,9,1027,1436,4527,997,893,29,678,1699,4296,40,253
1993,559,4,1145,1584,5285,1089,1193,16,880,2028,5206,40,254
2001,444,13,1189,1599,5246,1040,1154,19,822,2002,5037,40,255
1888,526,4,1197,1718,5333,1044,1099,31,900,2047,5121,40,256
1451,648,42,1263,1743,5147,1011,1115,115,963,1759,4963,40,257
429,570,30,1417,1137,3583,178,1124,130,1088,1063,3583,40,258
313,311,2,1299,660,2585,133,614,22,837,1109,2715,40,259
1716,362,3,1075,1544,4700,1137,845,8,828,1766,4584,40,260
2055,356,1,1052,1599,5063,1125,953,12,876,2144,5110,40,261
2091,543,5,1259,1499,5397,1032,1234,28,954,1818,5066,40,262
1972,532,0,1206,1698,5408,1077,1132,27,884,1995,5115,40,263
1459,685,48,1415,1563,5170,904,1091,119,1070,1649,4833,40,264
413,500,39,1489,968,3409,173,1166,131,936,1074,3480,40,265
273,318,7,1080,611,2289,129,614,27,775,845,2390,40,266
1718,381,8,1116,1425,4648,1103,872,26,846,1703,4550,40,267
2051,420,12,1175,1683,5341,1124,1029,32,945,2164,5294,40,268
1992,474,10,1253,1727,5456,1120,1099,25,931,2124,5299,40,269
1907,437,4,1228,1632,5208,1054,940,37,882,1998,4911,40,270
1379,579,60,1182,1665,4865,915,1095,118,930,1563,4621,40,271
348,663,36,1399,1116,3562,184,1295,149,869,1123,3620,40,272
287,295,1,1182,557,2322,119,676,18,663,880,2356,40,273
1666,388,4,1132,1579,4769,1080,883,16,911,1775,4665,40,274
2041,444,4,1308,1559,5356,1116,978,22,921,2065,5102,40,275
1971,422,2,1296,1474,5165,1103,980,14,973,1971,5041,40,276
1752,477,9,1256,1722,5216,1010,1072,20,963,1888,4953,40,277
1449,644,32,1354,1548,5027,961,1053,108,932,1825,4879,40,278
432,524,25,1433,1052,3466,221,1004,119,1105,1185,3634,40,279
337,310,2,1105,694,2448,117,648,17,825,963,2570,40,280
1665,391,3,1122,1594,4775,1063,873,14,927,1889,4766,40,281
2078,398,7,1186,1615,5284,1124,1010,17,895,2059,5105,40,282
1958,467,1,1383,1486,5295,1102,1055,19,925,1978,5079,40,283
1682,453,5,1218,1347,4705,746,1067,28,944,1755,4540,40,284
1229,575,24,1288,1240,4356,500,1020,107,911,1548,4086,40,285
430,440,47,1449,910,3276,184,949,95,854,1023,3105,40,286
354,321,4,1173,784,2636,133,803,17,852,895,2700,40,287
691,284,1,1115,807,2898,278,730,14,748,1101,2871,40,288
2005,361,1,1203,1611,5181,1115,985,16,887,2086,5089,40,289
2047,495,10,1263,1756,5571,1136,1107,34,945,2276,5498,40,290
1909,448,10,1387,1742,5496,1079,1176,28,1032,1910,5225,40,291
1362,763,42,1271,1783,5221,923,1295,98,970,1767,5053,40,292
464,764,78,1460,1094,3860,168,1320,191,1147,1189,4015,40,293
285,320,5,1172,860,2642,112,868,17,805,920,2722,40,294
1661,368,3,1176,1633,4841,1133,903,25,897,1867,4825,40,295
2068,361,5,1239,1539,5212,1103,951,7,946,2092,5099,40,296
2069,412,6,1302,1576,5365,1111,1007,16,1007,1975,5116,40,297
1899,486,0,1355,1671,5411,1078,1180,23,888,2044,5213,40,298
1400,546,48,1363,1415,4772,851,1088,109,1097,1624,4769,40,299
458,543,82,1369,856,3308,197,1048,162,968,1000,3375,40,300
414,269,1,1132,686,2502,145,624,14,952,903,2638,40,301
1663,307,5,1099,1570,4644,1044,813,21,887,1789,4554,40,302
2039,373,3,1291,2037,5743,1125,1267,17,985,2110,5504,40,303
2035,468,5,1274,1639,5421,1156,1080,24,908,2229,5397,40,304
1821,640,5,1280,1630,5376,1158,1014,36,962,2089,5259,40,305
1421,549,50,1362,1632,5014,953,1029,94,1073,1596,4745,40,306
387,550,39,1268,969,3213,162,1053,122,872,933,3142,40,307
296,278,20,1094,603,2291,134,631,37,783,856,2441,40,308
1513,320,2,1152,1189,4176,697,861,9,901,1667,4135,40,309
1569,459,11,1230,1182,4451,658,916,39,1086,1695,4394,40,310
1683,338,8,1320,1626,4975,1055,824,20,1063,1944,4906,40,311
1855,381,0,1278,1598,5112,1099,906,13,952,1935,4905,40,312
1397,515,38,1338,1616,4904,1017,906,91,930,1625,4569,40,313
381,387,38,1250,824,2880,172,769,104,822,1059,2926,40,314
272,272,3,1270,594,2411,130,607,5,778,1096,2616,40,315
680,263,2,1140,797,2882,320,628,23,729,1097,2797,40,316
2096,340,5,1116,1538,5095,1133,948,14,909,2070,5074,40,317
2105,399,0,1370,1495,5369,1142,951,15,1001,2063,5172,40,318
1979,408,0,1140,1573,5100,1073,982,18,937,2043,5053,40,319
1499,547,24,1230,1541,4841,918,999,97,941,1638,4593,40,320
409,529,31,1605,902,3476,167,843,106,968,1298,3382,40,321
289,322,6,1057,794,2468,144,642,23,779,934,2522,40,322
1715,335,3,1120,1370,4543,1089,827,12,918,1761,4607,40,323
2128,365,8,1156,1582,5239,1066,947,19,881,2081,4994,40,324
2098,392,2,1414,1508,5414,1089,957,14,951,2085,5096,40,325
1985,399,3,1391,1574,5352,1112,982,12,1020,2055,5181,40,326
1478,477,24,1237,1558,4774,946,954,100,968,1652,4620,40,327
394,505,31,1356,985,3271,188,923,121,960,988,3180,40,328
289,269,18,1053,600,2229,115,526,21,681,873,2216,40,329
1504,360,12,1291,1354,4521,854,797,19,981,1640,4291,40,330
1496,337,19,1275,1435,4562,743,856,19,962,1744,4324,40,331
947,335,8,1283,985,3558,446,701,25,990,1053,3215,40,332
167,185,5,667,432,1456,90,360,8,425,394,1277,40,333
480,242,15,1169,757,2663,221,683,62,707,947,2620,40,334
272,283,20,983,665,2223,137,632,54,713,857,2393,40,335
223,223,1,992,592,2031,113,599,13,702,781,2208,40,336
1534,317,7,1082,1457,4397,933,804,17,869,1748,4371,40,337
1952,337,6,1314,1654,5263,1028,973,22,940,2134,5097,40,338
2080,350,20,1388,1435,5273,1061,1031,29,963,2085,5169,40,339
1864,343,1,1269,1752,5229,996,1035,15,910,2065,5021,40,340
1357,535,38,1183,1599,4712,769,966,119,868,1652,4374,40,341
345,500,47,1285,1063,3240,151,1046,124,857,1014,3192,40,342
292,296,5,1220,712,2525,118,713,18,747,1032,2628,40,343
1751,357,4,1090,1603,4805,987,1010,12,927,1847,4783,40,344
2225,371,7,1325,1599,5527,1052,1133,30,902,2254,5371,40,345
2157,362,15,1303,1462,5299,896,1085,22,959,1997,4959,40,346
2060,451,7,1365,1816,5699,962,1266,29,921,2194,5372,40,347
1501,517,39,1347,1687,5091,885,1036,132,973,1803,4829,40,348
409,526,52,1462,989,3438,147,1026,153,898,1215,3439,40,349
251,261,8,1080,611,2211,93,600,15,704,791,2203,40,350
1560,415,3,1125,1551,4654,973,780,22,835,1765,4375,40,351
1870,381,1,1277,1711,5240,981,976,22,869,1987,4835,40,352
1800,405,1,1321,1606,5133,989,929,17,943,2061,4939,40,353
1714,429,2,1391,1671,5207,1010,942,27,1039,1843,4861,40,354
1193,437,18,1235,1529,4412,805,854,80,902,1425,4066,40,355
314,374,33,1211,736,2668,118,688,66,737,857,2466,40,356
283,195,5,1004,607,2094,102,495,16,595,670,1878,40,357
738,258,2,1060,882,2940,362,568,10,773,921,2634,40,358
470,184,2,917,542,2115,260,343,2,643,628,1876,40,359
91,124,12,307,260,794,57,206,9,269,260,801,40,360
486,233,13,820,684,2236,254,559,24,571,791,2199,40,361
585,273,26,1026,875,2785,330,616,64,713,1058,2781,40,362
263,253,37,791,536,1880,108,543,60,487,557,1755,40,363
213,223,5,809,449,1699,97,471,20,541,631,1760,40,364
718,281,7,1056,821,2883,353,676,28,723,1162,2942,40,365
658,610,285,1145,773,3471,307,824,321,896,1063,3411,40,366
162,127,7,381,232,909,49,257,31,284,364,985,41,1
1521,138,9,663,393,2724,139,512,42,394,1572,2659,41,2
1905,145,18,699,513,3280,217,714,47,422,1763,3163,41,3
1807,138,5,653,395,2998,199,611,62,398,1676,2946,41,4
1263,155,9,640,635,2702,190,679,96,415,1197,2577,41,5
257,127,10,387,279,1060,45,340,60,260,320,1025,41,6
192,111,15,605,234,1157,49,355,50,226,439,1119,41,7
1723,120,5,614,413,2875,219,539,39,376,1610,2783,41,8
2061,103,16,604,233,3017,181,437,37,550,1643,2848,41,9
2241,139,7,716,433,3536,184,691,57,460,2006,3398,41,10
2124,154,3,668,570,3519,209,760,81,491,1850,3391,41,11
1336,145,8,691,481,2661,175,537,77,412,1268,2469,41,12
227,95,7,704,241,1274,48,263,51,211,383,956,41,13
132,72,9,305,140,658,40,145,40,177,189,591,41,14
447,115,11,496,266,1335,131,312,40,259,579,1321,41,15
671,107,19,488,345,1630,137,453,68,274,609,1541,41,16
1717,110,6,651,364,2848,146,607,55,373,1573,2754,41,17
2065,131,8,680,522,3406,186,803,46,416,1803,3254,41,18
677,101,5,546,287,1616,96,365,66,283,695,1505,41,19
286,129,18,586,370,1389,55,407,102,260,495,1319,41,20
232,143,20,567,305,1267,80,398,44,298,458,1278,41,21
1762,132,16,654,368,2932,215,523,61,432,1617,2848,41,22
2347,113,8,703,367,3538,214,639,55,434,2116,3458,41,23
2364,131,7,681,458,3641,210,772,47,443,2119,3591,41,24
2110,140,22,649,452,3373,199,727,58,415,1856,3255,41,25
1374,161,24,732,548,2839,179,668,89,472,1351,2759,41,26
34,19,12,16,15,96,36,13,16,20,22,107,41,27
23,15,12,22,18,90,17,16,16,23,16,88,41,28
1758,116,15,667,301,2857,166,526,41,393,1639,2765,41,29
2369,122,8,679,368,3546,218,654,51,427,2099,3449,41,30
2417,129,7,684,448,3685,201,807,49,454,2088,3599,41,31
2171,142,10,711,387,3421,244,665,53,433,1883,3278,41,32
1479,153,10,595,538,2775,187,591,95,412,1304,2589,41,33
324,149,5,758,417,1653,75,478,80,376,640,1649,41,34
240,103,11,695,306,1355,69,365,34,349,551,1368,41,35
1842,118,15,588,334,2897,195,511,44,388,1668,2806,41,36
2412,135,4,684,510,3745,202,833,29,429,2147,3640,41,37
2446,141,11,709,426,3733,203,724,53,485,2166,3631,41,38
2247,122,4,698,408,3479,224,675,41,494,1875,3309,41,39
1392,181,6,688,551,2818,175,582,108,484,1330,2679,41,40
272,93,3,611,338,1317,59,367,78,210,496,1210,41,41
148,89,16,442,210,905,42,220,44,175,373,854,41,42
1796,102,16,610,338,2862,197,520,46,361,1527,2651,41,43
2034,131,16,651,461,3293,171,900,47,411,1473,3002,41,44
2411,144,9,710,398,3672,218,617,66,486,2123,3510,41,45
2086,140,22,685,419,3352,199,694,45,429,1920,3287,41,46
1355,188,7,658,450,2658,183,545,75,440,1228,2471,41,47
275,144,11,652,354,1436,54,421,101,330,505,1411,41,48
236,128,10,583,249,1206,61,348,61,296,443,1209,41,49
591,118,7,646,335,1697,105,416,21,357,733,1632,41,50
2305,130,19,689,469,3612,200,770,48,426,2024,3468,41,51
2400,136,21,732,388,3677,241,705,54,465,2133,3598,41,52
2169,127,20,705,495,3516,209,803,55,396,1922,3385,41,53
1451,149,9,632,488,2729,196,601,94,433,1319,2643,41,54
369,169,16,849,501,1904,78,588,112,409,742,1929,41,55
239,130,19,682,347,1417,65,423,43,363,480,1374,41,56
1850,130,10,616,451,3057,204,685,39,405,1576,2909,41,57
2537,141,13,679,509,3879,217,768,43,577,2188,3793,41,58
2383,176,15,730,381,3685,187,735,51,499,2107,3579,41,59
2141,152,13,679,445,3430,200,748,50,438,1860,3296,41,60
1452,177,6,750,600,2985,195,795,89,426,1402,2907,41,61
307,174,7,708,378,1574,64,482,93,394,618,1651,41,62
235,129,11,807,253,1435,63,389,32,329,651,1464,41,63
1893,145,17,649,385,3089,206,549,62,416,1703,2936,41,64
2409,161,28,715,428,3741,200,744,75,447,2164,3630,41,65
2451,138,12,741,470,3812,248,877,41,473,2122,3761,41,66
2223,197,27,762,534,3743,216,824,107,490,1948,3585,41,67
1468,221,5,768,595,3057,204,710,104,518,1375,2911,41,68
395,176,5,868,493,1937,88,714,92,358,718,1970,41,69
291,144,26,798,339,1598,80,416,61,346,740,1643,41,70
1774,149,5,635,412,2975,188,609,38,410,1616,2861,41,71
2444,133,11,810,447,3845,231,874,55,461,2154,3775,41,72
2482,174,23,874,472,4025,232,850,63,475,2222,3842,41,73
2150,154,13,848,529,3694,219,830,72,464,2027,3612,41,74
1449,190,2,742,594,2977,184,671,116,484,1389,2844,41,75
533,274,18,1404,628,2857,97,844,147,583,1123,2794,41,76
346,195,6,928,436,1911,96,621,39,428,725,1909,41,77
1909,120,6,732,407,3174,201,598,32,446,1783,3060,41,78
2491,136,4,831,474,3936,204,816,50,514,2187,3771,41,79
2490,145,11,965,621,4232,229,1013,55,497,2337,4131,41,80
2286,145,17,879,500,3827,222,923,71,477,1996,3689,41,81
1546,166,9,900,696,3317,194,905,93,453,1578,3223,41,82
341,190,7,697,466,1701,55,641,97,285,692,1770,41,83
385,165,6,1245,374,2175,54,610,39,449,1013,2165,41,84
1842,159,12,934,464,3411,167,689,122,455,1829,3262,41,85
2352,156,17,1009,543,4077,178,966,56,505,2359,4064,41,86
2244,116,7,756,421,3544,175,786,41,498,2042,3542,41,87
1896,137,13,884,373,3303,167,753,63,465,1791,3239,41,88
1294,209,13,1035,555,3106,151,735,111,517,1482,2996,41,89
394,153,17,1398,622,2584,86,823,112,479,1033,2533,41,90
262,179,4,737,434,1616,77,524,35,433,642,1711,41,91
1650,167,11,966,420,3214,160,813,60,440,1575,3048,41,92
2420,126,17,757,412,3732,190,823,56,440,2146,3655,41,93
2412,137,14,760,501,3824,191,915,44,440,2040,3630,41,94
2275,143,22,869,559,3868,220,950,67,456,2062,3755,41,95
1575,194,22,752,592,3135,185,776,118,473,1413,2965,41,96
418,199,17,900,364,1898,75,615,75,439,645,1849,41,97
469,147,14,820,433,1883,102,659,37,489,544,1831,41,98
1855,150,12,683,361,3061,195,589,56,422,1652,2914,41,99
2532,205,17,746,543,4043,244,781,172,473,2222,3892,41,100
2500,156,28,796,439,3919,214,789,57,501,2246,3807,41,101
2285,157,15,733,422,3612,226,783,50,518,2038,3615,41,102
1570,224,11,674,547,3026,204,735,89,522,1445,2995,41,103
412,194,23,1074,596,2299,95,843,116,436,790,2280,41,104
327,161,7,958,377,1830,93,489,50,568,643,1843,41,105
1900,145,14,722,503,3284,209,826,67,413,1689,3204,41,106
2417,154,4,814,456,3845,213,876,64,490,2087,3730,41,107
2499,156,7,816,436,3914,217,899,63,452,2138,3769,41,108
2244,162,5,800,473,3684,208,843,58,509,1939,3557,41,109
1538,175,10,720,581,3024,185,744,101,496,1360,2886,41,110
375,190,15,1305,581,2466,68,951,117,366,892,2394,41,111
298,141,3,658,278,1378,60,412,34,375,565,1446,41,112
1832,146,17,675,355,3025,177,665,51,439,1670,3002,41,113
2463,151,11,745,534,3904,216,830,54,487,2144,3731,41,114
2464,166,21,785,490,3926,224,915,51,477,2092,3759,41,115
2445,148,14,863,464,3934,224,846,57,563,2165,3855,41,116
1508,191,12,756,712,3179,191,904,116,505,1468,3184,41,117
371,178,9,764,460,1782,80,623,96,392,630,1821,41,118
297,197,7,784,416,1701,84,564,86,364,662,1760,41,119
1914,148,2,681,394,3139,202,640,39,464,1755,3100,41,120
2527,168,16,741,433,3885,241,828,62,489,2116,3736,41,121
2515,154,15,787,500,3971,240,784,65,535,2180,3804,41,122
2288,162,13,783,465,3711,224,834,48,538,2018,3662,41,123
1553,227,10,736,625,3151,207,807,66,524,1446,3050,41,124
377,155,14,834,414,1794,80,602,100,358,644,1784,41,125
244,125,11,623,270,1273,61,449,47,336,480,1373,41,126
1909,150,11,710,377,3157,219,629,53,440,1699,3040,41,127
2478,159,17,759,540,3953,236,1005,60,477,2173,3951,41,128
2530,169,13,862,618,4192,212,1069,79,517,2177,4054,41,129
2190,153,18,680,434,3475,215,808,62,450,1871,3406,41,130
1519,186,18,696,465,2884,204,642,111,473,1376,2806,41,131
401,207,16,850,401,1875,78,518,78,499,727,1900,41,132
288,178,3,654,311,1434,84,424,37,476,509,1530,41,133
1907,157,13,650,365,3092,206,651,41,383,1657,2938,41,134
2445,147,7,745,418,3762,195,777,49,460,2166,3647,41,135
2442,156,13,734,455,3800,182,860,79,469,2138,3728,41,136
2245,187,6,808,460,3706,230,850,78,448,2074,3680,41,137
1498,221,19,773,502,3013,190,666,109,512,1418,2895,41,138
290,125,4,585,289,1293,71,346,116,263,427,1223,41,139
203,114,12,569,267,1165,54,345,57,264,386,1106,41,140
1883,174,3,627,417,3104,195,684,37,407,1661,2984,41,141
2540,174,29,748,453,3944,203,878,80,441,2268,3870,41,142
2557,189,28,797,469,4040,201,889,58,442,2294,3884,41,143
2188,157,19,776,424,3564,204,755,52,449,2037,3497,41,144
1328,168,8,679,551,2734,163,703,80,545,1154,2645,41,145
370,283,5,836,503,1997,75,738,125,342,675,1955,41,146
240,173,8,793,330,1544,65,480,101,358,583,1587,41,147
283,114,11,580,269,1257,76,301,53,310,516,1256,41,148
2247,148,8,737,389,3529,164,854,88,387,1799,3292,41,149
2324,126,6,749,368,3573,185,763,44,462,1981,3435,41,150
2190,130,5,679,474,3478,208,948,58,435,1772,3421,41,151
1415,200,26,680,419,2740,174,673,117,403,1289,2656,41,152
7,4,0,1,1,13,6,4,0,2,0,12,41,153
3,3,0,0,3,9,4,1,0,0,1,6,41,154
15,3,4,3,4,29,12,2,4,6,2,26,41,155
10,5,0,15,0,30,8,7,0,23,0,38,41,156
10,7,1,4,3,25,5,4,0,4,4,17,41,157
5,0,3,4,1,13,5,0,3,5,0,13,41,158
3,3,0,2,0,8,7,1,0,2,0,10,41,159
2,3,0,1,0,6,1,2,0,1,2,6,41,160
1,0,0,0,0,1,2,2,0,0,0,4,41,161
8,7,0,4,8,27,3,0,0,4,5,12,41,162
5,7,0,5,4,21,5,3,0,6,1,15,41,163
7,2,5,6,3,23,5,1,2,3,1,12,41,164
6,5,2,5,3,21,8,2,0,6,1,17,41,165
6,1,1,5,1,14,5,1,1,6,1,14,41,166
1,2,0,2,0,5,0,2,0,1,0,3,41,167
0,0,2,0,0,2,0,0,2,0,0,2,41,168
10,1,5,7,2,25,10,1,4,9,2,26,41,169
9,0,0,2,0,11,9,0,0,7,0,16,41,170
0,3,0,2,0,5,4,2,0,1,0,7,41,171
3,5,2,5,4,19,2,3,1,9,2,17,41,172
3,0,0,6,2,11,7,0,1,6,3,17,41,173
0,4,0,1,1,6,0,4,0,1,0,5,41,174
1,5,0,2,2,10,0,3,1,2,1,7,41,175
5,0,3,4,2,14,2,0,5,3,0,10,41,176
4,0,0,5,2,11,0,1,0,10,1,12,41,177
0,0,2,4,3,9,1,0,2,1,3,7,41,178
2,5,1,12,1,21,0,4,0,15,0,19,41,179
5,5,0,6,1,17,8,4,1,8,3,24,41,180
0,2,1,1,0,4,0,1,1,1,0,3,41,181
0,3,4,1,0,8,0,0,5,1,0,6,41,182
4,0,1,5,0,10,2,0,2,3,0,7,41,183
2,3,6,2,2,15,1,2,7,3,2,15,41,184
3,4,28,2,0,37,9,0,21,2,0,32,41,185
6,7,0,3,0,16,3,6,0,1,0,10,41,186
3,7,3,2,1,16,2,5,2,2,2,13,41,187
1,6,7,2,3,19,2,1,5,4,1,13,41,188
4,2,1,3,1,11,0,1,5,2,1,9,41,189
6,0,3,6,2,17,1,2,2,9,4,18,41,190
3,1,2,3,0,9,3,1,3,6,0,13,41,191
11,1,1,3,0,16,8,2,0,9,0,19,41,192
4,4,1,2,1,12,1,2,2,6,1,12,41,193
5,3,1,2,0,11,4,3,3,3,0,13,41,194
13,1,1,6,0,21,17,0,2,6,0,25,41,195
2,2,2,0,1,7,3,5,1,0,1,10,41,196
3,0,1,2,5,11,5,0,2,3,4,14,41,197
3,1,6,4,6,20,1,3,8,7,3,22,41,198
9,0,5,2,0,16,10,0,12,4,1,27,41,199
2,4,7,4,4,21,2,1,8,6,3,20,41,200
6,2,0,4,0,12,6,1,5,7,0,19,41,201
1,1,0,2,0,4,1,0,3,3,0,7,41,202
0,2,0,0,0,2,0,2,0,0,0,2,41,203
1,0,0,0,0,1,4,0,1,2,2,9,41,204
3,0,0,1,0,4,2,0,0,0,2,4,41,205
0,0,0,0,0,0,1,0,0,0,1,2,41,206
1,0,0,1,1,3,0,3,0,3,1,7,41,207
2,0,0,5,0,7,2,0,1,8,2,13,41,208
0,0,0,0,0,0,2,0,0,0,0,2,41,209
0,0,0,0,0,0,2,0,1,1,1,5,41,211
1,0,0,1,1,3,1,0,0,1,3,5,41,212
1,0,3,0,0,4,0,0,2,1,0,3,41,213
2,0,0,0,0,2,0,0,2,0,1,3,41,214
0,0,0,1,0,1,3,0,0,1,0,4,41,215
1,0,0,0,0,1,1,1,0,0,2,4,41,216
0,0,0,0,0,0,1,1,0,0,0,2,41,218
1,0,0,0,0,1,1,1,1,1,1,5,41,219
2,0,0,0,1,3,2,2,0,1,2,7,41,220
1,0,0,1,0,2,1,0,0,3,0,4,41,221
1,1,0,0,0,2,1,1,0,0,0,2,41,222
0,0,0,0,0,0,0,0,1,0,0,1,41,223
0,0,0,0,0,0,0,0,1,0,0,1,41,224
1,0,0,0,0,1,0,0,0,1,0,1,41,225
2,15,3,2,4,26,0,11,2,3,3,19,41,226
12,4,6,13,2,37,8,4,7,14,2,35,41,227
9,5,2,5,2,23,4,3,1,7,2,17,41,228
2,0,1,8,2,13,1,0,0,7,4,12,41,229
5,0,0,0,1,6,4,0,0,0,1,5,41,230
1,1,3,0,0,5,0,1,4,0,1,6,41,231
0,8,1,5,0,14,0,5,1,3,0,9,41,232
12,0,2,4,5,23,5,0,2,6,3,16,41,233
9,3,0,27,3,42,6,3,0,29,7,45,41,234
2,7,5,23,5,42,4,6,10,29,6,55,41,235
10,11,2,19,10,52,9,10,7,29,8,63,41,236
4,4,4,1,5,18,3,10,7,4,5,29,41,237
6,3,4,2,2,17,9,2,5,2,1,19,41,238
18,1,0,21,2,42,14,3,0,8,1,26,41,239
1,2,0,1,0,4,4,0,0,2,1,7,41,240
2,0,0,6,8,16,0,0,0,6,4,10,41,241
2,1,4,32,9,48,2,6,6,43,9,66,41,242
4,3,4,24,0,35,10,1,2,29,1,43,41,243
5,6,2,10,4,27,6,5,3,16,8,38,41,244
191,112,8,629,253,1193,78,370,34,312,520,1314,41,245
197,104,5,506,248,1060,51,306,27,288,442,1114,41,246
1326,105,15,565,306,2317,186,649,52,348,1704,2939,41,247
2066,123,8,591,297,3085,157,666,34,320,1914,3091,41,248
1909,120,11,675,345,3060,169,709,47,352,1778,3055,41,249
1270,195,6,583,415,2469,160,585,63,346,1205,2359,41,250
267,142,11,690,429,1539,65,533,146,326,523,1593,41,251
217,143,15,541,292,1208,62,427,34,299,450,1272,41,252
1720,111,5,587,367,2790,151,614,49,337,1562,2713,41,253
2246,124,11,610,417,3408,167,786,61,379,1917,3310,41,254
2255,130,6,663,417,3471,172,853,46,408,1894,3373,41,255
2008,117,14,669,428,3236,173,833,63,390,1730,3189,41,256
1352,210,15,616,544,2737,153,739,108,384,1215,2599,41,257
313,245,7,945,546,2056,74,807,142,374,683,2080,41,258
276,133,4,788,316,1517,60,477,42,384,705,1668,41,259
1755,104,7,635,352,2853,186,647,52,398,1606,2889,41,260
2219,104,27,679,341,3370,174,748,65,414,1979,3380,41,261
2194,130,24,634,361,3343,177,817,92,391,1820,3297,41,262
2085,150,58,712,488,3493,172,896,102,411,1844,3425,41,263
1437,218,12,663,538,2868,187,714,140,437,1318,2796,41,264
333,161,10,924,438,1866,72,688,148,355,672,1935,41,265
230,123,7,624,291,1275,59,425,34,330,564,1412,41,266
1743,128,13,651,340,2875,164,626,65,415,1560,2830,41,267
2262,126,14,716,431,3549,185,829,65,459,1999,3537,41,268
2273,151,15,687,498,3624,170,957,61,427,1948,3563,41,269
2005,148,7,773,454,3387,191,801,83,435,1853,3363,41,270
1350,172,4,711,533,2770,164,751,115,493,1169,2692,41,271
350,221,17,1015,553,2156,89,915,124,387,672,2187,41,272
226,132,3,837,311,1509,48,523,33,331,668,1603,41,273
1760,131,5,603,338,2837,162,635,36,397,1555,2785,41,274
2270,132,11,630,375,3418,169,764,57,423,1990,3403,41,275
2252,127,9,669,397,3454,197,789,50,410,2008,3454,41,276
1937,139,10,735,361,3182,158,751,75,419,1751,3154,41,277
1356,185,6,651,461,2659,181,628,101,385,1271,2566,41,278
384,172,8,724,494,1782,63,646,116,384,602,1811,41,279
264,150,4,658,294,1370,67,459,35,356,574,1491,41,280
1814,127,3,630,336,2910,182,579,47,396,1650,2854,41,281
2385,114,6,676,397,3578,192,842,29,471,2046,3580,41,282
2370,172,4,672,428,3646,187,825,62,458,2084,3616,41,283
2068,138,7,697,474,3384,184,891,53,488,1864,3480,41,284
1377,186,8,682,555,2808,170,733,70,508,1272,2753,41,285
439,226,16,917,597,2195,91,843,108,426,719,2187,41,286
312,147,2,688,368,1517,66,536,35,462,535,1634,41,287
907,136,4,635,384,2066,189,550,35,386,922,2082,41,288
2341,130,6,712,488,3677,202,872,52,434,2056,3616,41,289
2403,150,22,728,375,3678,201,860,69,456,2061,3647,41,290
2116,140,31,760,530,3577,200,978,82,458,1839,3557,41,291
1440,187,24,724,519,2894,166,757,140,426,1381,2870,41,292
376,197,26,881,536,2016,85,729,157,398,681,2050,41,293
262,111,9,783,326,1491,94,546,38,395,576,1649,41,294
1767,127,6,657,376,2933,172,681,44,401,1658,2956,41,295
2297,121,14,741,355,3528,210,804,46,404,2041,3505,41,296
2352,138,9,745,486,3730,187,956,73,469,2055,3740,41,297
2124,132,19,710,478,3463,194,941,69,472,1815,3491,41,298
1448,184,22,716,454,2824,209,673,106,524,1337,2849,41,299
398,176,12,877,515,1978,89,669,125,460,659,2002,41,300
391,165,18,669,384,1627,82,469,144,477,550,1722,41,301
1838,128,6,636,360,2968,199,670,48,423,1626,2966,41,302
2257,149,5,804,680,3895,206,1168,48,494,1956,3872,41,303
2427,128,2,742,403,3702,206,893,37,469,2081,3686,41,304
1945,157,25,649,469,3245,186,749,67,475,1800,3277,41,305
1366,219,25,667,519,2796,165,637,119,441,1310,2672,41,306
371,163,21,900,613,2068,96,774,110,405,738,2123,41,307
265,125,17,604,361,1372,90,437,40,375,508,1450,41,308
1786,104,5,635,418,2948,179,644,44,437,1692,2996,41,309
1806,163,9,652,381,3011,182,569,54,550,1652,3007,41,310
1964,131,18,629,451,3193,194,762,50,390,1794,3190,41,311
2015,134,33,721,448,3351,171,724,83,469,1868,3315,41,312
1406,158,6,655,632,2857,208,806,102,475,1269,2860,41,313
385,165,13,824,406,1793,89,554,101,415,697,1856,41,314
291,122,7,740,297,1457,84,398,46,331,686,1545,41,315
907,115,2,622,366,2012,168,480,45,423,911,2027,41,316
2366,110,7,682,412,3577,201,781,49,439,2052,3522,41,317
2395,114,36,678,514,3737,183,942,74,457,2031,3687,41,318
2158,105,18,683,392,3356,190,755,81,444,1870,3340,41,319
1496,152,16,630,486,2780,196,639,108,444,1320,2707,41,320
362,134,25,826,360,1707,75,439,117,407,588,1626,41,321
212,92,13,526,256,1099,71,323,49,277,389,1109,41,322
1890,123,6,638,399,3056,190,697,38,418,1706,3049,41,323
2422,131,16,697,402,3668,195,875,62,382,2146,3660,41,324
2461,114,16,700,412,3703,184,810,66,461,2119,3640,41,325
2155,119,14,723,509,3520,209,906,50,445,1903,3513,41,326
1452,136,7,565,423,2583,172,566,129,429,1356,2652,41,327
346,159,14,746,546,1811,70,643,137,364,571,1785,41,328
230,113,6,632,289,1270,58,400,51,326,535,1370,41,329
1639,125,6,701,338,2809,170,601,55,487,1605,2918,41,330
1806,123,7,808,482,3226,186,798,34,497,1810,3325,41,331
1177,130,3,761,459,2530,145,665,40,652,1185,2687,41,332
157,184,5,320,186,852,61,163,28,373,436,1061,41,333
557,122,6,975,372,2032,83,505,68,373,853,1882,41,334
297,151,29,780,386,1643,67,495,79,324,625,1590,41,335
232,124,15,642,381,1394,73,432,30,309,508,1352,41,336
1789,84,28,666,358,2925,167,612,52,364,1582,2777,41,337
2400,121,14,736,507,3778,175,913,61,459,2108,3716,41,338
2400,103,8,731,399,3641,168,924,43,451,2044,3630,41,339
2063,91,13,767,468,3402,175,882,58,438,1813,3366,41,340
1353,172,11,674,480,2690,155,638,126,377,1275,2571,41,341
323,183,10,760,492,1768,66,661,124,348,588,1787,41,342
232,115,11,655,352,1365,56,463,72,285,527,1403,41,343
1789,116,15,608,352,2880,172,671,52,345,1596,2836,41,344
2478,113,6,713,399,3709,162,841,44,444,2182,3673,41,345
2399,104,11,727,361,3602,157,877,50,405,2061,3550,41,346
2300,139,13,808,486,3746,188,995,68,489,1957,3697,41,347
1506,175,7,710,505,2903,168,722,107,428,1391,2816,41,348
382,180,7,810,558,1937,77,717,142,378,607,1921,41,349
234,118,3,546,367,1268,64,524,38,346,433,1405,41,350
1749,124,0,670,340,2883,172,623,35,450,1570,2850,41,351
2283,126,4,751,466,3630,204,856,97,447,2074,3678,41,352
2177,123,21,797,429,3547,184,825,60,462,1960,3491,41,353
1916,123,18,863,551,3471,207,912,62,501,1720,3402,41,354
1289,164,5,771,623,2852,182,774,113,479,1206,2754,41,355
309,146,4,782,447,1688,62,565,94,346,632,1699,41,356
230,94,4,717,412,1457,58,580,45,304,612,1599,41,357
1029,103,0,881,440,2453,148,691,37,396,1287,2559,41,358
531,98,3,503,272,1407,126,337,33,459,623,1578,41,359
99,88,2,248,177,614,48,166,14,172,259,659,41,360
769,117,10,756,415,2067,107,522,54,347,923,1953,41,361
827,153,2,923,429,2334,136,546,76,466,1028,2252,41,362
242,156,4,690,392,1484,50,535,79,292,552,1508,41,363
226,108,0,740,308,1382,54,426,40,292,567,1379,41,364
1048,138,2,849,463,2500,123,622,42,396,1220,2403,41,365
891,354,67,821,354,2487,124,426,216,504,1057,2327,41,366
137,90,4,403,218,852,70,197,27,270,425,989,42,1
1197,151,6,621,382,2357,247,400,28,389,1214,2278,42,2
1522,132,7,620,637,2918,300,640,34,410,1537,2921,42,3
1447,143,0,639,427,2656,315,477,27,417,1381,2617,42,4
1141,171,11,622,699,2644,274,673,70,412,1218,2647,42,5
202,103,14,517,307,1143,67,392,50,262,381,1152,42,6
181,86,10,878,239,1394,67,359,28,317,639,1410,42,7
1401,145,0,586,509,2641,313,545,23,391,1311,2583,42,8
1596,92,2,466,317,2473,277,372,30,500,1355,2534,42,9
1767,151,6,611,454,2989,301,545,33,425,1630,2934,42,10
1624,164,3,655,756,3202,318,785,31,512,1455,3101,42,11
1192,184,12,691,487,2566,292,466,78,484,1117,2437,42,12
287,153,15,1899,396,2750,76,627,90,429,1475,2697,42,13
189,113,10,651,239,1202,60,296,51,334,566,1307,42,14
347,144,16,650,282,1439,145,308,36,301,593,1383,42,15
441,123,10,378,468,1420,168,532,38,244,440,1422,42,16
1321,149,13,571,369,2423,212,464,31,358,1288,2353,42,17
1562,146,10,586,686,2990,283,805,45,370,1504,3007,42,18
540,149,21,471,276,1457,159,363,74,260,567,1423,42,19
265,145,23,691,417,1541,70,518,87,327,496,1498,42,20
186,89,6,633,311,1225,56,324,16,288,525,1209,42,21
1370,148,0,537,398,2453,255,425,27,358,1338,2403,42,22
1717,155,2,626,475,2975,325,532,29,423,1674,2983,42,23
1791,167,1,643,496,3098,290,610,50,389,1708,3047,42,24
1665,158,2,625,555,3005,327,638,34,425,1583,3007,42,25
1177,223,10,732,599,2741,299,625,87,499,1227,2737,42,26
299,175,11,1295,528,2308,92,644,96,482,1029,2343,42,27
223,134,4,694,267,1322,75,310,23,321,610,1339,42,28
1461,151,0,555,396,2563,291,430,17,381,1361,2480,42,29
1786,181,4,557,440,2968,297,502,36,438,1696,2969,42,30
1827,158,12,610,534,3141,311,676,45,398,1631,3061,42,31
1635,129,0,585,438,2787,310,462,33,416,1446,2667,42,32
1091,187,8,620,678,2584,251,627,102,427,1172,2579,42,33
263,198,14,926,421,1822,81,512,96,407,718,1814,42,34
181,106,8,764,291,1350,64,307,30,340,666,1407,42,35
1400,158,3,553,445,2559,272,473,21,420,1382,2568,42,36
1795,172,6,609,654,3236,316,652,31,411,1704,3114,42,37
1819,151,3,609,559,3141,294,631,28,441,1667,3061,42,38
1662,184,5,594,469,2914,295,551,30,471,1528,2875,42,39
1228,253,13,694,581,2769,243,598,111,457,1255,2664,42,40
304,214,15,1228,674,2435,97,830,141,438,930,2436,42,41
187,92,6,964,275,1524,52,303,44,329,898,1626,42,42
1383,163,13,541,461,2561,278,469,39,403,1346,2535,42,43
1668,178,2,611,634,3093,293,783,41,405,1563,3085,42,44
1928,176,6,671,558,3339,318,600,48,482,1756,3204,42,45
1689,170,3,576,516,2954,306,542,52,459,1630,2989,42,46
1114,220,22,737,667,2760,242,597,107,507,1128,2581,42,47
269,178,8,772,386,1613,81,460,101,349,646,1637,42,48
212,103,1,732,301,1349,55,377,34,334,665,1465,42,49
542,162,0,815,391,1910,178,376,23,450,848,1875,42,50
1744,178,11,670,679,3282,278,753,35,470,1690,3226,42,51
1902,159,8,622,468,3159,280,585,61,418,1797,3141,42,52
1637,183,7,639,584,3050,310,668,29,461,1523,2991,42,53
1286,217,7,705,555,2770,266,525,97,504,1269,2661,42,54
330,205,18,1004,651,2208,80,697,126,443,781,2127,42,55
195,121,8,698,383,1405,56,470,33,356,558,1473,42,56
1483,183,14,552,612,2844,299,680,46,413,1403,2841,42,57
1853,167,8,645,616,3289,308,772,39,476,1705,3300,42,58
1845,172,6,600,435,3058,280,560,40,430,1692,3002,42,59
1746,202,8,657,534,3147,329,640,40,478,1629,3116,42,60
1324,276,20,742,985,3347,327,946,145,477,1331,3226,42,61
280,221,13,870,444,1828,74,597,107,413,684,1875,42,62
236,168,1,1095,354,1854,75,423,36,399,1021,1954,42,63
1475,226,1,703,466,2871,314,596,31,456,1443,2840,42,64
1840,176,9,673,503,3201,307,650,34,470,1699,3160,42,65
1885,197,11,629,547,3269,342,710,38,457,1747,3294,42,66
1712,300,9,735,612,3368,342,794,87,515,1723,3461,42,67
1300,260,14,870,691,3135,314,824,141,490,1344,3113,42,68
480,200,23,1253,644,2600,92,1058,115,464,879,2608,42,69
270,105,0,908,299,1582,82,382,39,362,800,1665,42,70
1500,194,2,646,418,2760,275,547,26,378,1518,2744,42,71
1871,208,9,799,552,3439,303,814,62,437,1832,3448,42,72
1924,171,4,849,565,3513,309,765,87,498,1901,3560,42,73
1762,180,3,1041,631,3617,308,867,79,530,1840,3624,42,74
1206,258,11,821,761,3057,305,706,128,482,1428,3049,42,75
520,334,16,1787,683,3340,105,1127,169,620,1331,3352,42,76
268,162,12,1045,539,2026,66,724,46,382,820,2038,42,77
1572,170,3,837,516,3098,329,621,31,470,1607,3058,42,78
2046,216,12,939,645,3858,351,907,39,529,2000,3826,42,79
2090,223,17,1176,930,4436,377,1189,45,654,2150,4415,42,80
1790,212,15,999,769,3785,340,1195,69,525,1653,3782,42,81
1386,266,18,1243,1030,3943,293,1153,139,592,1713,3890,42,82
345,209,16,1228,624,2422,111,936,120,382,979,2528,42,83
485,152,2,2564,552,3755,87,915,33,615,2210,3860,42,84
1633,207,6,1458,702,4006,297,830,144,602,2134,4007,42,85
1931,176,0,1324,805,4236,309,970,37,565,2389,4270,42,86
1908,182,5,922,539,3556,309,750,41,547,2034,3681,42,87
1633,206,6,1019,548,3412,295,702,55,521,1829,3402,42,88
1281,275,11,1755,763,4085,235,994,87,647,2036,3999,42,89
498,215,17,2484,994,4208,117,1504,109,622,1947,4299,42,90
314,152,5,1254,472,2197,87,652,33,415,1085,2272,42,91
1338,187,1,1142,535,3203,262,864,56,457,1544,3183,42,92
1948,160,1,861,536,3506,306,710,29,435,2044,3524,42,93
1907,152,8,752,638,3457,287,834,40,428,1946,3535,42,94
1928,179,1,1015,847,3970,351,1124,35,546,1913,3969,42,95
1272,239,9,986,773,3279,311,855,125,516,1446,3253,42,96
459,198,25,1580,553,2815,125,949,119,556,1062,2811,42,97
387,114,0,1202,589,2292,102,885,30,486,871,2374,42,98
1545,172,1,696,424,2838,332,593,51,492,1450,2918,42,99
2017,258,2,725,537,3539,331,738,89,491,1878,3527,42,100
1954,177,6,814,532,3483,339,696,49,505,2026,3615,42,101
1793,173,9,761,523,3259,350,680,64,487,1671,3252,42,102
1342,294,11,729,742,3118,325,776,137,517,1377,3132,42,103
652,215,18,1973,911,3769,115,1331,139,754,1518,3857,42,104
330,155,2,1244,397,2128,79,581,21,475,1017,2173,42,105
1510,194,0,770,677,3151,314,802,35,460,1605,3216,42,106
1839,228,2,803,531,3403,342,731,39,470,1785,3367,42,107
1981,183,1,812,523,3500,344,859,65,470,1637,3375,42,108
1864,250,20,779,577,3490,368,807,70,517,1760,3522,42,109
1334,248,12,790,674,3058,293,700,111,497,1423,3024,42,110
456,245,13,2374,839,3927,115,1396,166,487,1787,3951,42,111
233,152,4,894,355,1638,75,502,56,395,762,1790,42,112
1588,198,4,744,485,3019,337,616,33,468,1562,3016,42,113
2053,248,0,722,702,3725,351,880,55,469,1926,3681,42,114
2011,169,1,753,676,3610,331,884,40,493,1918,3666,42,115
2025,179,11,900,728,3843,374,931,67,570,1891,3833,42,116
1400,287,17,779,1056,3539,328,1180,133,580,1448,3669,42,117
431,205,13,1066,692,2407,129,880,156,452,866,2483,42,118
279,188,3,1096,590,2156,92,718,80,386,966,2242,42,119
1619,188,3,620,465,2895,336,572,32,464,1528,2932,42,120
2118,196,1,766,544,3625,341,642,68,579,1980,3610,42,121
2113,171,2,712,581,3579,341,709,69,514,1939,3572,42,122
1880,196,7,744,525,3352,358,704,59,554,1704,3379,42,123
1379,256,6,837,698,3176,290,799,125,514,1441,3169,42,124
393,207,12,1044,621,2277,102,832,150,462,827,2373,42,125
241,141,2,821,384,1589,88,598,35,351,602,1674,42,126
1614,217,4,623,451,2909,332,625,38,424,1516,2935,42,127
2083,205,3,769,1038,4098,357,1244,47,502,1914,4064,42,128
2074,205,1,812,1060,4152,368,1208,57,528,1966,4127,42,129
1905,177,9,742,529,3362,357,657,65,500,1807,3386,42,130
1334,275,12,741,608,2970,344,672,128,486,1366,2996,42,131
452,201,10,1076,454,2193,122,579,115,525,950,2291,42,132
252,132,2,748,279,1413,59,407,31,386,647,1530,42,133
1621,213,6,726,472,3038,344,609,44,471,1587,3055,42,134
2033,184,1,773,502,3493,310,655,35,559,1920,3479,42,135
2107,223,2,757,564,3653,362,818,60,461,1914,3615,42,136
1922,241,5,846,546,3560,365,769,57,538,1884,3613,42,137
1422,297,18,881,650,3268,340,721,110,535,1441,3147,42,138
380,233,5,963,662,2243,105,854,126,413,833,2331,42,139
360,193,5,889,312,1759,73,494,46,374,756,1743,42,140
1657,225,6,732,532,3152,319,671,33,464,1635,3122,42,141
2019,232,3,752,586,3592,350,779,47,500,1929,3605,42,142
2073,220,0,837,544,3674,365,709,33,543,2086,3736,42,143
1859,245,3,673,587,3367,329,708,37,538,1778,3390,42,144
1300,299,18,895,763,3275,335,822,107,623,1356,3243,42,145
369,299,19,1308,779,2774,126,1207,150,540,926,2949,42,146
329,184,3,1168,409,2093,90,729,56,434,879,2188,42,147
355,161,2,823,269,1610,110,393,25,374,764,1666,42,148
1852,213,7,786,561,3419,367,650,90,541,1814,3462,42,149
2072,171,7,811,517,3578,332,687,52,542,2022,3635,42,150
1952,217,18,815,580,3582,374,816,61,538,1849,3638,42,151
1448,282,15,758,587,3090,314,672,109,544,1491,3130,42,152
402,256,18,1201,630,2507,126,890,100,541,948,2605,42,153
292,167,14,972,381,1826,89,525,44,408,856,1922,42,154
1818,202,2,788,609,3419,342,735,56,495,1823,3451,42,155
2275,206,2,874,630,3987,387,876,52,571,2126,4012,42,156
2389,196,3,824,568,3980,382,811,67,546,2191,3997,42,157
2267,224,0,879,894,4264,320,1197,61,639,2096,4313,42,158
1587,316,6,962,1010,3881,315,1212,124,613,1611,3875,42,159
471,391,22,2619,1444,4947,136,2279,327,613,1463,4818,42,160
335,225,10,1629,590,2789,115,995,70,569,1154,2903,42,161
1880,212,1,913,582,3588,369,780,37,585,1904,3675,42,162
2423,237,2,1051,695,4408,382,1019,56,574,2353,4384,42,163
2603,274,8,1129,711,4725,393,1113,114,635,2460,4715,42,164
2166,207,4,920,634,3931,387,904,58,536,2047,3932,42,165
1547,340,4,911,974,3776,308,1054,166,625,1584,3737,42,166
500,310,15,1363,888,3076,136,1189,182,537,1083,3127,42,167
302,187,5,941,358,1793,99,495,49,460,926,2029,42,168
1784,248,5,785,511,3333,374,683,45,521,1682,3305,42,169
2222,256,5,943,701,4127,386,948,52,630,2094,4110,42,170
777,275,9,1119,714,2894,247,982,51,533,1077,2890,42,171
1968,283,3,1081,539,3874,327,778,58,575,2086,3824,42,172
1496,301,23,861,622,3303,327,782,111,575,1500,3295,42,173
486,303,17,1197,791,2794,128,1085,196,512,834,2755,42,174
298,201,2,787,424,1712,93,505,118,389,642,1747,42,175
1760,221,9,830,492,3312,320,666,44,547,1791,3368,42,176
2229,193,4,779,486,3691,325,737,40,538,2098,3738,42,177
2316,214,5,776,586,3897,348,867,55,527,2177,3974,42,178
2094,225,2,882,572,3775,331,794,66,534,2054,3779,42,179
1497,269,10,914,591,3281,321,766,106,582,1602,3377,42,180
460,221,11,1169,653,2514,98,879,125,523,974,2599,42,181
232,142,0,765,354,1493,66,480,51,373,600,1570,42,182
1700,159,0,870,642,3371,279,843,43,484,1775,3424,42,183
2065,205,11,898,707,3886,310,967,66,532,2053,3928,42,184
1794,247,2,820,951,3814,311,1140,77,680,1638,3846,42,185
581,1445,38,1631,1535,5230,123,2294,109,722,981,4229,42,186
971,235,17,955,590,2768,244,814,80,571,1146,2855,42,187
368,194,18,1150,445,2175,103,702,110,431,900,2246,42,188
254,125,2,885,304,1570,75,490,26,344,771,1706,42,189
1559,209,19,797,462,3046,291,608,50,453,1660,3062,42,190
1940,180,8,713,459,3300,347,644,32,518,1808,3349,42,191
1944,164,4,766,467,3345,347,638,51,523,1859,3418,42,192
1819,180,8,841,494,3342,354,716,53,504,1778,3405,42,193
1314,261,4,731,820,3130,316,881,128,461,1338,3124,42,194
461,193,16,1373,1510,3553,85,2000,118,460,925,3588,42,195
223,143,4,761,391,1522,90,529,40,377,635,1671,42,196
1646,142,5,670,401,2864,284,501,36,431,1653,2905,42,197
2078,200,19,758,707,3762,314,960,45,515,1918,3752,42,198
2148,147,3,783,498,3579,341,644,28,548,2029,3590,42,199
1986,205,3,833,525,3552,343,754,34,534,1928,3593,42,200
1424,312,14,958,938,3646,311,936,251,539,1484,3521,42,201
381,288,16,1169,1087,2941,122,1313,138,486,950,3009,42,202
252,167,1,937,344,1701,88,520,31,364,772,1775,42,203
1668,189,4,749,597,3207,332,731,38,495,1642,3238,42,204
2134,202,3,894,591,3824,303,805,34,559,2070,3771,42,205
2000,179,3,964,749,3895,341,879,61,549,2051,3881,42,206
1859,192,2,1038,553,3644,330,782,38,568,1993,3711,42,207
1289,262,24,927,597,3099,282,692,128,554,1436,3092,42,208
398,315,14,1475,896,3098,97,1205,287,497,1010,3096,42,209
293,164,4,833,510,1804,76,646,124,406,707,1959,42,210
1657,180,6,830,1174,3847,300,1121,307,471,1665,3864,42,211
2101,210,1,823,530,3665,312,746,38,541,2040,3677,42,212
2051,154,6,773,491,3475,325,696,38,467,1969,3495,42,213
1861,220,12,813,652,3558,297,769,61,523,1794,3444,42,214
1487,241,6,1249,985,3968,289,1359,176,535,1460,3819,42,215
645,203,14,1837,521,3220,99,1215,171,452,1302,3239,42,216
353,132,4,1050,312,1851,74,408,32,559,1112,2185,42,217
1566,166,12,618,490,2852,273,579,31,486,1530,2899,42,218
2000,217,5,911,760,3893,344,1053,48,502,2022,3969,42,219
2044,175,10,776,531,3536,290,688,47,549,1993,3567,42,220
1749,195,14,743,566,3267,274,705,57,526,1730,3292,42,221
1148,262,9,667,602,2688,246,651,146,501,1134,2678,42,222
336,193,5,1067,704,2305,99,843,90,444,864,2340,42,223
274,154,2,957,421,1808,85,559,28,403,858,1933,42,224
1478,175,5,741,450,2849,283,478,33,472,1611,2877,42,225
1930,208,5,857,594,3594,336,791,47,540,1901,3615,42,226
1958,179,5,760,551,3453,336,685,55,540,1943,3559,42,227
1808,219,4,846,626,3503,332,677,108,492,1855,3464,42,228
1290,361,8,824,682,3165,314,792,192,487,1395,3180,42,229
343,280,12,1204,565,2404,112,685,170,450,995,2412,42,230
254,154,27,836,346,1617,67,466,82,331,744,1690,42,231
1504,149,8,690,453,2804,293,510,35,467,1519,2824,42,232
1985,272,10,785,698,3750,347,891,66,519,1913,3736,42,233
1973,232,6,827,600,3638,337,805,102,498,1975,3717,42,234
1828,211,0,857,515,3411,319,712,31,531,1909,3502,42,235
1342,304,8,836,811,3301,303,847,112,582,1441,3285,42,236
617,217,9,1374,733,2950,118,1083,120,522,1189,3032,42,237
269,148,2,933,360,1712,61,600,34,413,744,1852,42,238
1648,180,4,643,672,3147,301,771,25,450,1599,3146,42,239
2109,224,9,665,747,3754,331,1025,43,488,1873,3760,42,240
2138,164,2,727,608,3639,352,869,21,476,1955,3673,42,241
1858,322,3,732,634,3549,321,912,49,490,1737,3509,42,242
1318,245,22,807,769,3161,288,803,141,664,1230,3126,42,243
387,223,16,1419,505,2550,96,843,99,514,1025,2577,42,244
233,149,0,1053,388,1823,63,571,33,371,891,1929,42,245
271,166,0,724,336,1497,109,425,15,371,645,1565,42,246
1894,165,1,671,481,3212,343,637,28,417,1800,3225,42,247
2081,176,7,664,555,3483,340,683,40,515,1929,3507,42,248
1869,159,3,699,553,3283,418,667,34,525,1756,3400,42,249
1426,230,10,653,641,2960,325,653,98,472,1398,2946,42,250
345,216,10,1071,684,2326,98,703,250,464,906,2421,42,251
246,178,2,746,351,1523,69,484,21,385,640,1599,42,252
1655,198,9,632,522,3016,324,640,55,407,1556,2982,42,253
2049,190,6,691,584,3520,352,748,45,476,2008,3629,42,254
2181,155,4,692,601,3633,376,883,40,564,1923,3786,42,255
1939,187,1,732,585,3444,357,808,38,541,1807,3551,42,256
1473,280,12,696,823,3284,336,828,144,519,1468,3295,42,257
413,234,21,1163,845,2676,104,1091,198,483,870,2746,42,258
269,180,0,1031,399,1879,73,509,55,347,995,1979,42,259
1707,148,0,685,459,2999,309,596,32,463,1628,3028,42,260
2109,171,10,687,516,3493,362,764,53,506,1920,3605,42,261
2154,168,11,686,519,3538,350,792,57,469,1865,3533,42,262
2020,202,0,731,757,3710,340,935,54,508,1912,3749,42,263
1467,292,8,758,698,3223,332,819,129,542,1452,3274,42,264
429,309,7,1600,896,3241,114,1467,270,496,1014,3361,42,265
241,151,1,807,416,1616,72,497,44,440,715,1768,42,266
1612,151,0,620,495,2878,299,549,76,446,1592,2962,42,267
2169,190,3,724,711,3797,373,867,50,481,2029,3800,42,268
2160,245,27,710,830,3972,338,1088,75,517,1954,3972,42,269
1911,202,3,864,647,3627,350,811,77,544,1945,3727,42,270
1418,212,16,711,856,3213,317,951,111,488,1337,3204,42,271
386,253,20,1603,896,3158,115,1462,149,531,991,3248,42,272
238,146,2,1038,456,1880,63,587,47,430,861,1988,42,273
1621,144,8,683,477,2933,321,566,59,485,1568,2999,42,274
2034,170,28,663,518,3413,315,682,68,451,1961,3477,42,275
2154,169,3,698,502,3526,354,679,35,550,2005,3623,42,276
1910,162,2,710,570,3354,324,684,86,525,1831,3450,42,277
1433,257,17,709,694,3110,316,756,137,509,1341,3059,42,278
368,206,7,1279,677,2537,94,907,124,488,986,2599,42,279
249,153,2,803,348,1555,74,485,27,401,688,1675,42,280
1788,171,4,708,472,3143,311,608,42,515,1735,3211,42,281
2238,177,3,771,589,3778,353,763,35,498,2130,3779,42,282
2207,216,0,751,546,3720,370,804,65,580,2045,3864,42,283
1932,209,5,805,661,3612,335,849,51,585,1834,3654,42,284
1297,298,8,793,740,3136,302,827,133,512,1423,3197,42,285
467,242,6,1427,831,2973,121,1066,132,505,1159,2983,42,286
346,195,2,852,556,1951,95,664,57,527,705,2048,42,287
869,185,2,792,452,2300,242,517,37,509,1036,2341,42,288
2256,178,1,786,703,3924,394,951,40,547,2067,3999,42,289
2223,180,2,870,600,3875,352,827,48,636,2136,3999,42,290
1972,223,17,835,885,3932,338,1049,80,558,1891,3916,42,291
1440,340,20,936,778,3514,309,995,111,554,1584,3553,42,292
411,372,16,1488,811,3098,116,1160,223,447,1118,3064,42,293
274,159,1,899,575,1908,86,780,40,379,659,1944,42,294
1692,141,4,705,554,3096,313,619,50,464,1688,3134,42,295
2178,177,0,726,502,3583,361,698,41,541,2059,3700,42,296
2159,197,4,780,753,3893,349,900,51,580,2073,3953,42,297
2007,211,1,781,771,3771,344,926,45,568,1868,3751,42,298
1392,257,14,752,608,3023,302,728,121,547,1420,3118,42,299
417,295,8,1112,773,2605,108,873,179,449,916,2525,42,300
564,167,0,800,557,2088,86,618,123,551,787,2165,42,301
1658,166,2,624,521,2971,318,554,53,481,1598,3004,42,302
2069,211,0,810,1008,4098,356,1309,38,569,2001,4273,42,303
2174,169,2,796,657,3798,347,768,42,547,2131,3835,42,304
1852,249,1,699,701,3502,353,715,45,541,1782,3436,42,305
1352,270,16,754,600,2992,272,667,123,552,1359,2973,42,306
383,248,20,1328,815,2794,111,1193,179,475,928,2886,42,307
257,123,4,659,364,1407,79,438,28,412,599,1556,42,308
1648,147,1,612,592,3000,340,657,29,469,1573,3068,42,309
1574,215,7,659,543,2998,326,502,102,597,1492,3019,42,310
1804,163,5,708,742,3422,377,819,45,504,1740,3485,42,311
1885,156,15,647,564,3267,337,623,53,512,1805,3330,42,312
1393,260,2,719,897,3271,304,914,131,525,1408,3282,42,313
350,157,11,1002,475,1995,108,580,98,482,822,2090,42,314
261,112,2,896,417,1688,66,500,74,359,830,1829,42,315
751,140,1,669,419,1980,240,457,38,411,920,2066,42,316
2096,135,1,723,532,3487,349,613,38,524,2013,3537,42,317
2247,151,1,793,680,3872,364,810,53,549,2138,3914,42,318
1997,156,0,620,524,3297,331,608,32,513,1863,3347,42,319
1446,217,6,749,725,3143,304,741,104,550,1477,3176,42,320
492,208,8,1346,547,2601,107,682,148,485,1227,2649,42,321
219,126,2,727,489,1563,60,617,28,350,614,1669,42,322
1674,134,0,675,501,2984,328,563,38,441,1726,3096,42,323
2187,169,3,665,589,3613,365,707,51,523,2082,3728,42,324
2218,137,3,671,572,3601,376,656,36,540,2106,3714,42,325
1972,171,1,642,868,3654,335,964,41,517,1872,3729,42,326
1367,241,17,632,792,3049,287,834,115,474,1361,3071,42,327
301,206,19,1106,791,2423,86,870,145,481,862,2444,42,328
224,136,1,819,324,1504,83,402,38,485,680,1688,42,329
1510,160,3,737,469,2879,314,557,45,476,1608,3000,42,330
1584,189,1,781,583,3138,336,667,27,538,1666,3234,42,331
1150,167,2,877,574,2770,273,605,32,801,1201,2912,42,332
181,129,0,260,170,740,100,159,13,368,318,958,42,333
542,150,5,1201,371,2269,174,508,68,437,1096,2283,42,334
287,157,6,964,409,1823,86,546,64,379,800,1875,42,335
191,154,3,642,347,1337,58,409,25,322,554,1368,42,336
1571,153,10,568,492,2794,310,506,31,437,1540,2824,42,337
2092,145,6,646,709,3598,388,827,32,524,1963,3734,42,338
2123,158,1,648,519,3449,358,652,35,478,1999,3522,42,339
1861,132,4,720,702,3419,349,820,48,470,1793,3480,42,340
1332,188,11,638,554,2723,296,557,97,462,1368,2780,42,341
319,201,7,1064,871,2462,99,997,130,379,873,2478,42,342
215,139,0,807,536,1697,65,644,49,386,628,1772,42,343
1842,141,5,657,489,3134,297,630,33,453,1755,3168,42,344
2377,145,0,845,532,3899,340,824,44,515,2247,3970,42,345
2356,148,3,815,538,3860,374,843,29,535,2138,3919,42,346
2185,206,7,821,670,3889,370,890,54,586,2027,3927,42,347
1585,205,16,771,655,3232,333,746,94,526,1603,3302,42,348
379,257,7,1271,895,2809,102,1161,144,456,982,2845,42,349
213,134,10,693,443,1493,71,587,51,357,588,1654,42,350
1586,143,0,565,431,2725,336,491,30,424,1493,2774,42,351
1939,163,4,784,693,3583,346,708,128,524,1974,3680,42,352
1923,163,5,730,574,3395,346,689,50,507,1901,3493,42,353
1698,188,4,823,683,3396,331,750,38,527,1690,3336,42,354
1141,173,7,771,829,2921,284,881,101,479,1210,2955,42,355
253,169,1,904,500,1827,103,571,66,429,743,1912,42,356
175,113,1,841,497,1627,63,705,24,300,604,1696,42,357
1023,124,12,1066,651,2876,246,725,28,542,1414,2955,42,358
542,107,0,527,266,1442,190,280,16,490,607,1583,42,359
84,89,0,209,113,495,55,130,12,161,234,592,42,360
716,131,1,860,473,2181,212,567,31,399,1041,2250,42,361
769,200,11,1058,513,2551,239,545,83,486,1211,2564,42,362
245,142,5,945,472,1809,84,633,82,336,759,1894,42,363
190,104,1,809,298,1402,70,394,41,333,647,1485,42,364
1023,149,2,1125,612,2911,259,672,23,512,1517,2983,42,365
822,364,77,1056,493,2812,208,421,238,607,1275,2749,42,366
17,57,7,105,82,268,31,43,7,113,77,271,43,1
229,89,6,192,356,872,282,72,5,212,309,880,43,2
226,79,3,197,449,954,338,94,3,192,311,938,43,3
217,90,2,194,466,969,363,95,9,257,292,1016,43,4
121,112,5,164,276,678,176,95,14,173,225,683,43,5
27,69,4,92,114,306,48,70,11,114,98,341,43,6
22,91,4,150,110,377,34,60,6,157,143,400,43,7
189,92,4,181,370,836,282,100,7,200,251,840,43,8
245,77,0,161,349,832,342,66,2,180,255,845,43,9
302,137,1,192,488,1120,444,100,4,224,343,1115,43,10
275,121,0,188,588,1172,442,135,3,250,339,1169,43,11
122,72,4,145,223,566,152,75,6,138,171,542,43,12
25,103,1,168,144,441,30,72,9,143,132,386,43,13
10,84,3,83,97,277,32,53,8,115,91,299,43,14
29,80,17,101,127,354,65,61,17,115,106,364,43,15
103,87,6,112,236,544,209,77,8,154,114,562,43,16
243,107,1,170,429,950,409,86,7,195,275,972,43,17
255,122,3,162,534,1076,393,135,11,202,363,1104,43,18
95,90,6,149,161,501,112,111,20,130,165,538,43,19
30,103,6,106,159,404,48,102,22,152,126,450,43,20
19,86,5,109,137,356,26,50,9,127,139,351,43,21
200,103,4,150,372,829,282,88,6,180,259,815,43,22
280,113,0,183,476,1052,417,114,2,225,337,1095,43,23
275,141,2,154,474,1046,439,119,3,173,327,1061,43,24
235,128,1,204,537,1105,448,149,4,238,307,1146,43,25
157,133,6,223,266,785,176,131,9,195,295,806,43,26
36,114,4,192,198,544,58,100,6,207,206,577,43,27
20,106,5,142,119,392,31,101,10,158,119,419,43,28
231,115,4,727,371,1448,406,113,5,245,508,1277,43,29
296,154,1,172,539,1162,468,117,3,241,387,1216,43,30
310,140,2,194,514,1160,421,120,1,235,360,1137,43,31
300,180,4,195,486,1165,419,137,8,273,332,1169,43,32
165,120,7,204,347,843,269,101,18,224,222,834,43,33
35,105,3,210,207,560,50,88,13,224,171,546,43,34
21,88,6,167,131,413,37,95,12,138,141,423,43,35
225,95,5,162,368,855,297,81,8,195,271,852,43,36
328,131,2,219,516,1196,427,150,5,249,374,1205,43,37
314,143,0,197,518,1172,444,137,5,232,382,1200,43,38
276,130,0,186,511,1103,445,107,1,243,326,1122,43,39
149,114,5,184,291,743,204,101,20,193,259,777,43,40
44,144,4,222,177,591,42,110,14,188,239,593,43,41
27,84,14,155,132,412,35,69,14,148,192,458,43,42
204,91,12,167,348,822,276,113,9,189,253,840,43,43
238,118,2,216,492,1066,415,134,4,242,299,1094,43,44
316,120,3,180,475,1094,341,118,12,259,366,1096,43,45
270,128,5,210,515,1128,434,128,11,247,300,1120,43,46
146,117,16,171,294,744,198,94,19,191,238,740,43,47
22,101,3,173,170,469,55,92,13,153,159,472,43,48
30,105,8,134,122,399,42,75,10,151,145,423,43,49
63,102,6,189,232,592,152,66,8,178,185,589,43,50
299,135,0,161,497,1092,419,122,6,211,375,1133,43,51
303,149,0,170,505,1127,444,97,1,216,381,1139,43,52
255,140,3,199,535,1132,463,123,3,239,311,1139,43,53
143,119,4,140,284,690,191,111,16,148,240,706,43,54
31,111,4,221,167,534,57,76,11,187,188,519,43,55
26,97,4,156,153,436,36,100,5,161,138,440,43,56
225,85,7,158,405,880,288,101,9,194,290,882,43,57
304,116,1,186,512,1119,423,120,1,236,366,1146,43,58
301,121,0,196,505,1123,434,110,4,237,370,1155,43,59
283,152,1,196,594,1226,483,121,7,253,363,1227,43,60
156,124,2,196,332,810,206,128,22,205,266,827,43,61
20,133,0,147,181,481,41,85,14,198,173,511,43,62
53,123,2,193,152,523,45,126,5,167,220,563,43,63
243,135,4,172,371,925,287,115,4,204,299,909,43,64
327,120,7,203,497,1154,352,127,8,288,363,1138,43,65
290,143,0,240,536,1209,449,140,4,282,366,1241,43,66
278,190,4,246,585,1303,510,144,7,276,378,1315,43,67
159,150,6,257,299,871,184,125,20,216,286,831,43,68
28,131,12,187,150,508,51,124,10,171,145,501,43,69
38,126,3,163,159,489,24,81,6,174,185,470,43,70
217,130,5,172,383,907,292,132,8,215,281,928,43,71
285,143,2,199,491,1120,412,135,4,211,384,1146,43,72
292,139,1,211,529,1172,424,108,11,250,368,1161,43,73
273,152,1,223,637,1286,449,152,11,301,378,1291,43,74
155,138,5,198,296,792,194,117,21,219,242,793,43,75
80,140,3,272,252,747,57,174,32,251,239,753,43,76
25,127,7,210,158,527,27,122,13,160,210,532,43,77
213,113,1,227,384,938,292,122,2,239,308,963,43,78
310,125,1,188,487,1111,405,123,2,223,396,1149,43,79
309,140,0,270,545,1264,443,144,5,263,405,1260,43,80
308,159,3,220,529,1219,427,121,6,269,365,1188,43,81
173,133,4,207,350,867,183,167,18,199,325,892,43,82
26,118,3,188,170,505,51,112,9,139,215,526,43,83
34,112,4,306,162,618,35,119,4,201,270,629,43,84
180,140,6,233,374,933,269,126,11,223,305,934,43,85
261,138,0,259,483,1141,358,133,5,264,382,1142,43,86
247,133,0,209,495,1084,412,104,5,233,347,1101,43,87
217,135,1,217,484,1054,397,120,2,240,320,1079,43,88
153,160,19,237,325,894,176,155,12,191,313,847,43,89
70,164,2,394,255,885,60,208,11,239,302,820,43,90
31,100,3,179,125,438,33,103,5,170,164,475,43,91
169,108,4,221,327,829,247,138,5,204,254,848,43,92
257,130,3,186,461,1037,381,136,5,219,316,1057,43,93
253,137,1,178,490,1059,406,135,3,201,327,1072,43,94
297,147,1,268,569,1282,484,177,5,269,373,1308,43,95
166,142,7,272,315,902,209,140,17,244,324,934,43,96
56,114,2,222,216,610,51,142,13,226,211,643,43,97
58,117,20,181,146,522,33,107,16,201,180,537,43,98
225,116,6,205,325,877,289,100,10,228,280,907,43,99
307,162,1,195,474,1139,359,144,5,269,390,1167,43,100
300,157,2,205,514,1178,430,147,5,239,373,1194,43,101
278,132,1,210,489,1110,441,144,6,250,296,1137,43,102
160,172,0,223,336,891,195,132,13,244,300,884,43,103
51,156,5,241,242,695,56,162,20,224,217,679,43,104
20,136,3,195,168,522,26,106,6,215,213,566,43,105
216,121,5,211,414,967,272,141,9,261,246,929,43,106
308,160,3,216,559,1246,428,178,4,288,387,1285,43,107
326,152,5,200,521,1204,454,142,6,268,365,1235,43,108
301,169,4,204,623,1301,504,146,10,317,365,1342,43,109
164,136,14,193,348,855,189,139,16,224,293,861,43,110
54,120,13,364,202,753,44,222,18,226,263,773,43,111
29,117,2,169,159,476,31,83,6,186,156,462,43,112
203,106,6,167,413,895,291,105,8,242,283,929,43,113
303,147,1,204,545,1200,438,154,7,275,374,1248,43,114
327,158,0,201,574,1260,448,162,7,246,391,1254,43,115
290,172,2,235,553,1252,463,166,7,280,343,1259,43,116
163,140,4,199,317,823,177,146,12,218,279,832,43,117
40,141,10,227,214,632,36,119,28,215,208,606,43,118
33,135,5,143,167,483,32,123,19,141,192,507,43,119
220,131,4,214,384,953,302,112,10,240,284,948,43,120
297,160,1,233,510,1201,430,169,3,246,370,1218,43,121
298,167,0,205,546,1216,457,123,6,245,398,1229,43,122
286,176,2,218,603,1285,509,132,6,302,337,1286,43,123
175,134,7,215,347,878,223,149,23,208,279,882,43,124
45,129,17,207,169,567,34,133,21,192,185,565,43,125
32,104,6,197,129,468,40,102,5,193,151,491,43,126
222,140,5,184,367,918,295,96,7,248,302,948,43,127
312,147,1,204,539,1203,399,155,2,276,386,1218,43,128
293,149,3,225,568,1238,445,194,5,230,355,1229,43,129
272,170,1,221,557,1221,450,146,7,279,351,1233,43,130
166,124,7,192,288,777,196,128,17,215,237,793,43,131
61,133,2,244,188,628,45,105,3,211,256,620,43,132
30,125,3,160,170,488,39,90,4,188,166,487,43,133
211,129,12,192,377,921,270,119,12,259,297,957,43,134
292,170,0,224,487,1173,433,139,2,273,360,1207,43,135
286,156,1,211,526,1180,496,151,4,265,338,1254,43,136
285,172,3,232,630,1322,469,180,8,279,392,1328,43,137
177,154,10,270,299,910,208,159,15,230,263,875,43,138
47,115,5,193,154,514,46,82,19,183,181,511,43,139
46,137,5,221,154,563,53,127,7,184,208,579,43,140
216,119,4,200,414,953,294,136,13,234,346,1023,43,141
316,141,1,210,504,1172,407,181,3,255,375,1221,43,142
308,162,1,239,543,1253,448,134,4,277,373,1236,43,143
261,150,4,213,580,1208,449,116,16,279,336,1196,43,144
162,146,12,214,309,843,208,143,21,200,247,819,43,145
31,142,10,225,205,613,52,141,28,216,199,636,43,146
36,116,3,171,199,525,50,119,14,164,215,562,43,147
43,112,14,133,123,425,49,88,21,152,152,462,43,148
298,186,3,214,439,1140,356,149,14,269,361,1149,43,149
331,155,3,211,498,1198,434,126,4,281,377,1222,43,150
286,161,2,211,568,1228,487,142,3,296,341,1269,43,151
166,167,14,199,275,821,209,137,17,222,285,870,43,152
39,157,8,209,174,587,57,147,15,198,201,618,43,153
31,133,1,189,161,515,41,115,1,174,191,522,43,154
258,140,1,183,409,991,309,154,5,231,314,1013,43,155
363,167,6,218,565,1319,480,177,6,263,418,1344,43,156
336,150,2,234,567,1289,461,146,6,295,410,1318,43,157
318,189,10,244,655,1416,513,164,18,288,381,1364,43,158
184,178,4,247,477,1090,272,215,32,222,307,1048,43,159
51,173,15,375,251,865,58,229,37,257,292,873,43,160
34,132,2,230,169,567,56,112,5,186,232,591,43,161
264,142,3,177,432,1018,363,118,11,232,326,1050,43,162
314,177,1,234,555,1281,467,171,6,287,377,1308,43,163
316,163,2,214,574,1269,477,159,10,284,373,1303,43,164
326,230,0,270,643,1469,543,164,8,304,422,1441,43,165
187,162,4,240,360,953,231,167,29,242,290,959,43,166
44,148,20,245,224,681,60,152,21,220,214,667,43,167
25,133,2,160,140,460,39,114,5,165,147,470,43,168
252,119,3,204,418,996,319,125,8,193,326,971,43,169
312,207,1,205,575,1300,462,184,7,286,378,1317,43,170
109,155,1,217,356,838,249,115,7,228,224,823,43,171
287,196,1,241,581,1306,515,142,4,313,360,1334,43,172
181,173,12,221,245,832,218,140,31,200,238,827,43,173
68,169,10,218,226,691,47,222,27,239,170,705,43,174
30,114,6,169,139,458,47,131,11,178,136,503,43,175
240,122,2,183,427,974,338,116,4,214,309,981,43,176
359,165,0,218,580,1322,471,167,1,283,405,1327,43,177
309,159,2,206,629,1305,514,149,6,279,401,1349,43,178
305,212,3,231,606,1357,508,182,2,312,388,1392,43,179
175,175,8,238,317,913,211,155,9,205,280,860,43,180
62,163,5,189,207,626,52,146,25,209,196,628,43,181
47,97,3,169,148,464,43,70,6,200,168,487,43,182
226,108,5,196,433,968,307,132,5,200,350,994,43,183
297,176,1,229,509,1212,373,201,1,265,381,1221,43,184
226,177,2,293,426,1124,306,190,11,291,329,1127,43,185
53,352,6,302,320,1033,45,553,24,249,197,1068,43,186
99,118,4,190,189,600,109,132,12,227,205,685,43,187
43,136,4,160,170,513,37,113,18,206,166,540,43,188
32,150,5,181,135,503,51,131,6,182,189,559,43,189
222,125,2,176,420,945,327,131,7,259,285,1009,43,190
255,167,3,199,573,1197,451,161,3,252,330,1197,43,191
290,161,0,278,598,1327,509,140,9,302,381,1341,43,192
274,195,1,245,613,1328,542,164,5,293,365,1369,43,193
151,155,11,226,309,852,189,147,26,221,250,833,43,194
52,197,10,233,224,716,44,191,39,205,214,693,43,195
38,113,4,155,142,452,41,103,6,180,193,523,43,196
224,131,3,203,401,962,325,118,4,220,298,965,43,197
272,152,2,172,543,1141,412,140,3,255,351,1161,43,198
285,152,7,221,594,1259,507,114,9,289,348,1267,43,199
287,194,3,255,608,1347,521,162,7,304,362,1356,43,200
170,148,6,204,322,850,202,144,53,220,302,921,43,201
50,157,13,253,224,697,52,191,24,235,237,739,43,202
27,126,3,224,140,520,48,129,5,172,197,551,43,203
216,138,2,178,416,950,304,156,9,216,285,970,43,204
287,145,2,236,591,1261,463,169,3,275,398,1308,43,205
276,151,3,245,571,1246,504,173,13,276,364,1330,43,206
263,200,1,221,595,1280,516,168,8,297,359,1348,43,207
184,165,14,186,315,864,210,122,19,237,296,884,43,208
48,151,5,214,206,624,44,157,17,221,220,659,43,209
44,138,3,167,168,520,53,147,9,209,161,579,43,210
193,124,3,178,456,954,316,115,37,246,295,1009,43,211
302,161,1,231,517,1212,489,149,3,238,383,1262,43,212
288,164,4,250,553,1259,514,131,8,263,381,1297,43,213
264,196,0,272,597,1329,536,168,5,296,346,1351,43,214
157,157,10,209,359,892,216,190,49,186,254,895,43,215
67,124,9,232,166,598,42,141,15,220,171,589,43,216
21,118,5,201,184,529,41,114,4,180,211,550,43,217
226,138,3,171,415,953,299,142,7,217,276,941,43,218
297,180,0,208,500,1185,458,131,4,268,346,1207,43,219
264,137,5,224,538,1168,472,136,5,238,378,1229,43,220
218,148,1,221,485,1073,438,105,12,275,295,1125,43,221
111,150,12,164,244,681,174,106,23,181,217,701,43,222
43,140,11,220,207,621,50,124,17,229,192,612,43,223
29,128,8,201,147,513,30,104,9,209,195,547,43,224
206,130,7,209,414,966,316,109,18,246,282,971,43,225
266,162,7,204,537,1176,421,122,17,259,339,1158,43,226
253,151,2,200,560,1166,459,135,8,275,309,1186,43,227
242,195,2,184,575,1198,491,123,14,288,359,1275,43,228
162,178,3,184,309,836,244,147,18,216,253,878,43,229
44,145,8,202,208,607,55,140,18,207,195,615,43,230
29,121,3,153,161,467,44,86,5,193,158,486,43,231
192,129,3,166,366,856,316,101,8,213,279,917,43,232
258,154,6,212,545,1175,416,152,13,260,384,1225,43,233
274,157,0,193,602,1226,466,135,7,280,357,1245,43,234
245,169,6,199,571,1190,461,143,13,242,377,1236,43,235
176,150,4,187,336,853,248,125,15,217,258,863,43,236
42,179,12,247,245,725,50,165,22,235,244,716,43,237
27,162,11,242,161,603,35,130,17,168,248,598,43,238
218,117,3,191,419,948,310,138,5,209,275,937,43,239
276,148,1,210,543,1178,440,150,5,250,349,1194,43,240
257,172,4,186,563,1182,448,141,7,236,376,1208,43,241
245,144,7,229,506,1131,439,137,19,248,348,1191,43,242
142,144,10,251,327,874,224,129,18,234,265,870,43,243
51,150,7,229,197,634,65,139,15,231,213,663,43,244
29,140,3,174,137,483,44,92,5,206,189,536,43,245
42,135,3,186,180,546,59,124,7,190,190,570,43,246
278,167,1,202,464,1112,400,135,4,249,344,1132,43,247
299,128,1,206,528,1162,431,120,8,260,323,1142,43,248
270,153,1,198,556,1178,449,133,6,278,330,1196,43,249
142,143,4,167,306,762,205,115,15,210,274,819,43,250
50,134,7,202,183,576,60,94,37,206,193,590,43,251
42,129,0,170,155,496,35,101,4,215,163,518,43,252
220,138,4,189,523,1074,409,119,6,261,311,1106,43,253
312,187,2,192,644,1337,530,131,1,346,374,1382,43,254
318,163,1,198,489,1169,398,151,4,249,367,1169,43,255
278,156,1,228,563,1226,512,161,5,306,355,1339,43,256
167,187,9,230,315,908,238,134,19,218,310,919,43,257
50,173,6,200,217,646,53,146,17,217,231,664,43,258
25,102,5,231,151,514,30,75,8,217,201,531,43,259
227,124,3,196,508,1058,373,109,7,247,336,1072,43,260
315,153,1,204,619,1292,492,129,6,292,362,1281,43,261
309,169,2,208,555,1243,442,128,4,257,385,1216,43,262
285,170,2,219,625,1301,492,148,7,311,329,1287,43,263
172,154,9,259,336,930,235,144,33,227,279,918,43,264
59,147,6,255,199,666,61,150,19,256,196,682,43,265
32,111,3,155,170,471,33,89,5,186,147,460,43,266
209,102,2,158,439,910,312,80,9,230,308,939,43,267
322,155,1,210,545,1233,462,152,4,239,353,1210,43,268
291,165,2,188,637,1283,489,141,9,234,373,1246,43,269
264,160,3,229,604,1260,461,173,5,282,347,1268,43,270
162,153,2,185,322,824,213,136,21,199,294,863,43,271
43,172,6,241,235,697,52,194,14,213,194,667,43,272
23,111,3,154,175,466,28,80,8,231,171,518,43,273
210,123,2,165,408,908,300,105,9,211,318,943,43,274
297,148,1,213,540,1199,448,123,9,260,369,1209,43,275
316,145,0,216,496,1173,434,151,2,269,379,1235,43,276
301,153,3,210,529,1196,420,173,6,272,369,1240,43,277
154,167,12,225,327,885,233,133,29,243,231,869,43,278
39,142,3,213,264,661,39,155,26,239,208,667,43,279
29,123,3,194,149,498,44,111,4,166,204,529,43,280
200,116,4,178,449,947,340,109,10,234,333,1026,43,281
292,166,1,234,546,1239,476,153,3,256,364,1252,43,282
291,174,2,234,616,1317,543,127,6,274,362,1312,43,283
270,162,2,197,593,1224,471,145,12,297,361,1286,43,284
149,165,5,213,339,871,232,134,13,239,278,896,43,285
56,121,4,234,220,635,54,184,9,200,230,677,43,286
37,126,3,197,157,520,37,111,16,196,216,576,43,287
91,120,3,205,335,754,230,110,8,215,217,780,43,288
316,153,1,217,537,1224,440,175,7,254,373,1249,43,289
288,151,2,212,643,1296,561,129,3,271,387,1351,43,290
278,159,6,202,605,1250,500,174,14,265,338,1291,43,291
158,155,2,224,346,885,232,145,13,235,253,878,43,292
56,165,6,267,236,730,65,160,32,240,243,740,43,293
28,99,3,249,158,537,33,99,8,219,219,578,43,294
213,121,3,160,454,951,347,120,8,197,273,945,43,295
303,152,9,204,571,1239,480,159,9,261,369,1278,43,296
307,191,6,226,627,1357,495,181,11,253,361,1301,43,297
283,164,9,228,652,1336,491,168,17,316,349,1341,43,298
154,136,7,216,301,814,212,120,16,213,265,826,43,299
44,156,6,230,240,676,54,132,20,243,228,677,43,300
83,111,5,242,161,602,45,95,15,248,200,603,43,301
233,133,0,179,395,940,318,96,6,208,312,940,43,302
290,157,1,234,661,1343,507,204,12,285,388,1396,43,303
282,143,2,264,602,1293,515,165,5,281,360,1326,43,304
248,135,4,199,590,1176,486,120,13,293,313,1225,43,305
141,161,1,201,315,819,219,110,15,226,239,809,43,306
37,145,8,224,208,622,51,146,11,209,219,636,43,307
42,113,3,170,173,501,26,92,5,204,202,529,43,308
225,112,5,219,439,1000,341,129,10,229,299,1008,43,309
240,122,1,218,471,1052,385,89,6,288,301,1069,43,310
248,140,2,208,567,1165,449,122,7,251,342,1171,43,311
284,154,1,223,616,1278,516,98,4,271,404,1293,43,312
169,163,7,196,359,894,249,133,17,201,265,865,43,313
50,166,6,223,204,649,57,97,20,224,240,638,43,314
36,84,1,196,140,457,39,74,4,186,173,476,43,315
100,112,3,214,359,788,245,97,5,224,227,798,43,316
307,134,2,190,572,1205,456,126,6,270,372,1230,43,317
303,159,4,204,675,1345,541,158,12,273,395,1379,43,318
264,131,1,242,643,1281,540,141,6,288,358,1333,43,319
145,134,3,211,330,823,226,114,9,220,268,837,43,320
29,129,8,259,212,637,39,135,24,242,202,642,43,321
24,117,4,163,160,468,36,86,9,178,174,483,43,322
207,115,13,204,435,974,350,106,19,239,286,1000,43,323
329,139,0,232,588,1288,525,127,3,302,402,1359,43,324
305,101,0,217,650,1273,540,94,2,265,384,1285,43,325
249,130,1,256,608,1244,520,144,8,284,349,1305,43,326
151,148,14,166,351,830,250,121,30,207,219,827,43,327
35,135,8,206,192,576,48,88,13,264,179,592,43,328
23,100,3,179,143,448,27,75,9,207,153,471,43,329
189,109,3,181,366,848,283,74,7,202,294,860,43,330
207,131,3,192,401,934,286,111,7,226,318,948,43,331
138,125,2,242,272,779,179,101,9,218,309,816,43,332
20,35,1,47,58,161,23,27,1,57,74,182,43,333
63,135,2,234,218,652,90,121,5,201,269,686,43,334
21,102,4,189,162,478,43,80,14,195,166,498,43,335
31,97,7,170,151,456,40,95,9,168,143,455,43,336
180,114,3,156,378,831,333,84,9,183,236,845,43,337
240,136,1,161,538,1076,410,149,5,236,343,1143,43,338
270,141,1,193,596,1201,486,110,2,287,353,1238,43,339
234,151,0,216,614,1215,488,139,7,282,281,1197,43,340
122,139,6,199,319,785,240,111,19,181,253,804,43,341
34,128,7,226,230,625,53,156,19,200,177,605,43,342
34,107,4,193,171,509,42,83,8,217,202,552,43,343
183,133,5,146,423,890,333,100,7,188,267,895,43,344
290,143,0,201,590,1224,510,130,5,283,342,1270,43,345
255,138,1,167,544,1105,500,98,3,245,303,1149,43,346
273,150,1,216,577,1217,467,136,10,308,334,1255,43,347
128,137,7,192,291,755,221,122,22,202,236,803,43,348
45,131,12,237,201,626,52,139,29,231,230,681,43,349
23,98,4,144,133,402,39,90,8,165,128,430,43,350
197,129,4,129,401,860,301,112,8,200,273,894,43,351
260,160,2,190,554,1166,420,166,18,257,341,1202,43,352
263,135,1,216,510,1125,424,125,4,267,304,1124,43,353
236,167,1,215,543,1162,388,186,1,271,294,1140,43,354
127,142,6,164,280,719,181,112,14,158,198,663,43,355
19,105,5,151,148,428,34,103,9,176,153,475,43,356
36,77,4,153,137,407,22,91,6,137,172,428,43,357
87,96,3,156,244,586,136,73,7,186,166,568,43,358
44,48,3,141,171,407,90,46,3,164,130,433,43,359
16,33,1,54,45,149,8,51,1,38,59,157,43,360
63,98,2,120,198,481,102,85,4,142,147,480,43,361
67,101,2,204,191,565,109,83,12,137,200,541,43,362
29,93,1,128,137,388,38,69,7,153,137,404,43,363
24,91,6,171,145,437,27,74,11,167,159,438,43,364
97,92,4,165,249,607,146,100,9,197,198,650,43,365
84,114,27,176,192,593,127,80,59,186,155,607,43,366
38,48,3,243,85,417,13,103,7,180,212,515,44,1
974,47,4,464,244,1733,95,253,10,263,1088,1709,44,2
1213,72,7,461,461,2214,122,466,17,256,1263,2124,44,3
1154,68,22,466,295,2005,137,345,29,255,1204,1970,44,4
707,126,9,418,506,1766,111,439,59,228,744,1581,44,5
68,74,8,288,267,705,21,269,33,140,190,653,44,6
72,52,5,534,218,881,14,158,9,259,457,897,44,7
1119,58,4,388,308,1877,134,314,11,212,1107,1778,44,8
1430,37,11,394,184,2056,138,252,17,406,1145,1958,44,9
1545,90,5,533,345,2518,132,424,13,286,1546,2401,44,10
1418,168,10,526,513,2635,146,668,22,300,1396,2532,44,11
782,79,9,451,430,1751,148,308,29,281,806,1572,44,12
106,101,10,909,317,1443,36,309,54,297,716,1412,44,13
72,82,39,448,150,791,13,163,60,259,315,810,44,14
137,63,24,439,190,853,69,160,30,194,381,834,44,15
358,43,6,270,264,941,77,276,7,145,344,849,44,16
1107,72,4,415,293,1891,118,414,8,185,1122,1847,44,17
1427,107,1,467,481,2483,154,657,13,212,1369,2405,44,18
371,90,14,335,230,1040,54,270,37,174,470,1005,44,19
91,131,9,416,278,925,23,305,39,185,330,882,44,20
77,41,1,343,218,680,18,222,4,189,279,712,44,21
1187,54,1,402,280,1924,147,337,7,203,1160,1854,44,22
1636,47,6,510,378,2577,157,470,9,250,1583,2469,44,23
1674,74,8,481,394,2631,162,563,25,293,1515,2558,44,24
1486,73,2,497,417,2475,144,586,11,256,1397,2394,44,25
807,218,9,534,478,2046,138,497,71,286,866,1858,44,26
169,179,4,787,404,1543,45,392,43,304,624,1408,44,27
80,59,3,512,158,812,24,179,8,227,415,853,44,28
1172,46,5,476,286,1985,156,325,10,255,1161,1907,44,29
1716,49,24,525,362,2676,171,456,19,307,1600,2553,44,30
1615,65,21,487,436,2624,171,600,27,221,1498,2517,44,31
1490,85,20,456,384,2435,185,520,30,246,1387,2368,44,32
807,129,24,380,480,1820,145,405,60,253,810,1673,44,33
98,125,20,414,218,875,33,272,30,178,326,839,44,34
76,48,1,378,138,641,18,128,4,202,260,612,44,35
1227,51,9,368,325,1980,148,333,18,234,1179,1912,44,36
1732,64,2,517,505,2820,179,640,4,266,1584,2673,44,37
1662,66,7,498,416,2649,153,535,12,256,1587,2543,44,38
1581,143,3,465,374,2566,151,582,13,275,1432,2453,44,39
843,173,3,437,443,1899,158,399,62,302,906,1827,44,40
169,161,6,776,422,1534,38,436,68,358,556,1456,44,41
90,74,4,623,185,976,23,175,15,205,562,980,44,42
1166,58,6,430,241,1901,133,337,13,211,1123,1817,44,43
1379,54,15,519,409,2376,126,600,14,233,1321,2294,44,44
1627,152,2,512,404,2697,162,513,10,302,1629,2616,44,45
1512,69,2,484,358,2425,144,497,19,306,1375,2341,44,46
727,146,33,445,478,1829,133,458,71,272,752,1686,44,47
104,163,3,513,266,1049,25,291,72,178,379,945,44,48
88,41,1,556,196,882,16,232,4,253,444,949,44,49
269,60,14,485,196,1024,90,172,16,236,466,980,44,50
1716,57,6,518,444,2741,167,556,12,254,1536,2525,44,51
1615,64,2,552,392,2625,166,593,4,253,1521,2537,44,52
1631,121,20,528,511,2811,153,693,28,351,1446,2671,44,53
809,180,2,445,416,1852,145,426,44,322,871,1808,44,54
107,113,4,410,214,848,45,190,25,152,281,693,44,55
59,30,6,249,157,501,14,110,12,115,196,447,44,56
1191,55,10,428,431,2115,153,496,13,233,1142,2037,44,57
1708,62,4,539,443,2756,162,622,12,270,1565,2631,44,58
1577,80,6,491,334,2488,142,473,7,271,1480,2373,44,59
1515,87,6,454,437,2499,165,575,15,277,1403,2435,44,60
796,232,7,452,584,2071,144,636,57,225,846,1908,44,61
106,162,1,490,340,1099,34,373,66,227,376,1076,44,62
80,57,8,701,215,1061,19,213,14,249,568,1063,44,63
1182,70,3,408,279,1942,148,344,7,251,1169,1919,44,64
1699,60,16,483,369,2627,161,508,11,275,1523,2478,44,65
1636,78,4,494,491,2703,173,640,10,255,1550,2628,44,66
1473,136,4,535,466,2614,157,692,22,274,1380,2525,44,67
838,210,10,530,485,2073,126,578,66,288,919,1977,44,68
196,1299,160,797,1270,3722,620,395,25,1801,1078,3919,44,69
122,693,65,725,1099,2704,366,283,24,1356,700,2729,44,70
1136,46,10,446,313,1951,139,368,8,226,1112,1853,44,71
1692,61,6,621,411,2791,164,611,8,298,1588,2669,44,72
1690,95,5,780,507,3077,154,646,33,430,1680,2943,44,73
1546,180,4,687,556,2973,175,744,35,309,1581,2844,44,74
857,180,9,553,556,2155,147,493,96,347,923,2006,44,75
219,1591,271,924,2037,5042,655,522,26,3018,1213,5434,44,76
137,1110,70,746,1419,3482,394,291,13,1805,917,3420,44,77
1351,150,4,526,330,2361,160,431,8,392,1247,2238,44,78
1819,59,29,633,416,2956,154,622,29,444,1604,2853,44,79
1874,86,5,773,615,3353,180,818,15,542,1680,3235,44,80
1654,74,9,685,508,2930,156,752,22,403,1513,2846,44,81
881,139,21,678,675,2394,127,707,79,313,961,2187,44,82
115,146,20,581,350,1212,43,413,49,175,461,1141,44,83
174,83,5,1084,308,1654,31,313,5,438,845,1632,44,84
1046,122,15,738,413,2334,124,449,100,290,1277,2240,44,85
1452,51,4,858,499,2864,141,659,9,392,1518,2719,44,86
1307,64,9,654,365,2399,138,583,9,312,1299,2341,44,87
1145,91,6,708,352,2302,137,509,23,298,1237,2204,44,88
681,139,2,890,472,2184,117,482,53,397,1043,2092,44,89
161,136,7,1297,534,2135,29,644,71,355,934,2033,44,90
103,92,9,614,250,1068,30,267,17,371,428,1113,44,91
971,69,4,792,329,2165,107,546,4,258,1114,2029,44,92
1619,56,4,641,364,2684,158,550,6,312,1533,2559,44,93
1597,156,2,547,405,2707,175,673,9,281,1512,2650,44,94
1534,74,4,650,576,2838,181,763,14,332,1430,2720,44,95
870,187,5,612,510,2184,145,548,59,313,945,2010,44,96
267,122,7,807,361,1564,32,470,71,373,510,1456,44,97
309,154,2,813,305,1583,32,398,8,428,659,1525,44,98
1157,70,3,529,310,2069,158,371,20,284,1158,1991,44,99
1757,277,2,647,395,3078,188,722,57,299,1659,2925,44,100
1577,91,4,693,400,2765,178,624,6,393,1525,2726,44,101
1571,93,16,551,413,2644,170,591,29,296,1451,2537,44,102
927,184,14,487,502,2114,150,491,62,326,960,1989,44,103
259,255,7,819,625,1965,51,734,54,360,662,1861,44,104
112,112,4,753,253,1234,29,305,4,337,569,1244,44,105
1242,76,11,517,447,2293,150,559,19,261,1212,2201,44,106
1719,74,3,611,396,2803,178,606,24,292,1575,2675,44,107
1714,80,7,627,389,2817,165,666,14,308,1565,2718,44,108
1585,153,4,587,486,2815,179,752,10,322,1462,2725,44,109
912,154,19,552,564,2201,141,534,52,334,951,2012,44,110
143,186,8,1170,476,1983,59,772,49,323,719,1922,44,111
90,77,4,521,232,924,28,213,11,287,416,955,44,112
1101,104,4,571,313,2093,155,361,5,270,1268,2059,44,113
1704,96,7,572,518,2897,169,638,9,326,1603,2745,44,114
1613,84,2,626,522,2847,164,695,10,301,1505,2675,44,115
1746,91,2,729,528,3096,168,772,18,425,1572,2955,44,116
874,218,11,592,782,2477,162,800,58,326,968,2314,44,117
154,132,3,612,366,1267,39,476,63,285,359,1222,44,118
126,130,13,575,468,1312,39,389,35,422,428,1313,44,119
1178,73,5,470,332,2058,154,384,9,289,1106,1942,44,120
1732,67,9,588,412,2808,177,545,22,309,1595,2648,44,121
1715,96,2,612,379,2804,175,613,13,345,1574,2720,44,122
1562,129,2,677,431,2801,178,654,15,378,1478,2703,44,123
903,238,9,542,514,2206,156,551,64,333,939,2043,44,124
203,113,26,818,361,1521,40,492,63,291,629,1515,44,125
76,83,4,533,185,881,26,279,13,250,341,909,44,126
1197,95,5,418,313,2028,146,387,7,296,1203,2039,44,127
1783,96,10,560,522,2971,166,689,19,316,1601,2791,44,128
1648,112,7,614,615,2996,200,786,16,322,1600,2924,44,129
1556,117,4,553,422,2652,171,630,11,321,1460,2593,44,130
854,150,18,462,404,1888,155,421,61,320,872,1829,44,131
207,228,12,848,318,1613,35,423,54,376,703,1591,44,132
94,80,3,513,203,893,37,222,4,303,393,959,44,133
1211,82,14,466,354,2127,152,420,19,270,1193,2054,44,134
1641,77,2,634,356,2710,165,523,9,389,1547,2633,44,135
1648,92,5,557,413,2715,147,616,19,315,1528,2625,44,136
1544,131,8,632,447,2762,169,658,36,341,1445,2649,44,137
850,199,12,527,444,2032,168,475,44,349,917,1953,44,138
140,181,16,565,399,1301,31,458,39,266,451,1245,44,139
189,101,8,642,269,1209,38,286,18,356,534,1232,44,140
1212,80,2,529,388,2211,164,459,10,283,1173,2089,44,141
1775,84,8,536,486,2889,169,668,18,328,1613,2796,44,142
1731,89,4,677,396,2897,177,563,16,374,1650,2780,44,143
1527,131,15,526,409,2608,153,569,51,333,1411,2517,44,144
708,170,6,542,551,1977,147,540,57,365,760,1869,44,145
148,163,9,841,437,1598,35,651,69,291,477,1523,44,146
98,106,3,739,250,1196,30,330,10,266,550,1186,44,147
119,71,3,466,193,852,34,166,8,284,371,863,44,148
1654,91,6,560,314,2625,145,484,29,316,1545,2519,44,149
1689,80,3,570,347,2689,162,565,5,332,1548,2612,44,150
1632,122,12,644,448,2858,172,655,11,370,1506,2714,44,151
870,203,8,567,482,2130,138,485,55,364,920,1962,44,152
176,233,7,827,537,1780,35,670,49,395,583,1732,44,153
100,94,0,667,243,1104,47,275,10,304,497,1133,44,154
1435,85,2,533,408,2463,162,535,6,320,1393,2416,44,155
2055,97,1,655,487,3295,164,769,13,362,1848,3156,44,156
1957,91,10,715,423,3196,171,564,16,363,1835,2949,44,157
1877,150,7,690,577,3301,204,852,15,403,1663,3137,44,158
1024,202,9,678,897,2810,151,905,114,363,1076,2609,44,159
187,171,8,1513,760,2639,53,1137,93,340,913,2536,44,160
142,138,4,943,298,1525,36,390,16,327,765,1534,44,161
1477,74,7,590,347,2495,181,463,9,342,1428,2423,44,162
2074,102,8,649,388,3221,170,645,3,372,1917,3107,44,163
1975,130,5,756,436,3302,165,753,28,410,1843,3199,44,164
1843,101,6,653,476,3079,167,777,18,371,1522,2855,44,165
1053,207,22,706,624,2612,196,663,86,423,993,2361,44,166
171,234,10,808,556,1779,66,728,59,342,585,1780,44,167
105,117,10,713,211,1156,39,297,17,338,547,1238,44,168
1524,82,8,541,322,2477,171,447,9,308,1382,2317,44,169
2003,125,18,643,530,3319,182,773,27,398,1735,3115,44,170
452,95,4,697,424,1672,120,516,11,396,526,1569,44,171
1769,123,2,759,488,3141,160,690,14,406,1677,2947,44,172
971,184,7,597,473,2232,184,528,69,369,943,2093,44,173
187,237,4,742,494,1664,75,634,104,377,450,1640,44,174
117,100,4,486,213,920,42,216,19,311,398,986,44,175
1432,82,7,593,336,2450,171,413,20,306,1423,2333,44,176
1997,108,2,716,402,3225,181,647,11,361,1897,3097,44,177
2018,95,4,691,389,3197,167,690,14,351,1874,3096,44,178
1815,146,14,705,488,3168,170,752,25,373,1702,3022,44,179
917,178,16,602,507,2220,124,525,68,369,1021,2107,44,180
195,182,10,797,404,1588,48,501,60,352,547,1508,44,181
125,78,1,562,236,1002,42,324,10,330,383,1089,44,182
1336,103,3,656,483,2581,141,657,9,293,1422,2522,44,183
1731,92,8,722,477,3030,145,658,20,373,1673,2869,44,184
1301,106,9,702,694,2812,124,791,40,454,1273,2682,44,185
218,854,10,868,965,2915,32,1734,104,485,499,2854,44,186
508,162,6,536,402,1614,92,449,55,320,627,1543,44,187
128,165,8,620,282,1203,30,424,68,271,425,1218,44,188
136,112,3,630,202,1083,28,241,10,265,523,1067,44,189
1258,80,7,562,298,2205,135,460,14,255,1274,2138,44,190
1720,103,13,590,338,2764,139,605,17,356,1521,2638,44,191
1594,98,11,622,372,2697,148,569,20,349,1557,2643,44,192
1600,119,8,595,412,2734,162,667,15,374,1441,2659,44,193
884,163,4,558,484,2093,127,552,68,379,882,2008,44,194
157,208,2,663,617,1647,46,685,80,348,468,1627,44,195
118,101,3,483,221,926,37,277,15,266,374,969,44,196
1370,69,7,479,282,2207,124,431,7,336,1267,2165,44,197
1858,109,6,592,378,2943,155,632,15,373,1723,2898,44,198
1868,91,3,564,300,2826,160,558,10,358,1729,2815,44,199
1714,126,8,669,421,2938,174,706,14,378,1587,2859,44,200
911,208,3,602,707,2431,131,580,208,337,987,2243,44,201
166,210,6,679,587,1648,51,690,76,324,471,1612,44,202
109,101,1,671,240,1122,25,382,17,288,438,1150,44,203
1325,87,1,583,381,2377,126,565,13,308,1308,2320,44,204
1836,93,2,701,487,3119,167,727,10,337,1771,3012,44,205
1718,114,9,766,497,3104,158,727,13,381,1716,2995,44,206
1598,112,10,766,404,2890,142,662,18,331,1647,2800,44,207
896,182,7,612,481,2178,119,483,78,421,899,2000,44,208
164,201,8,791,463,1627,58,533,107,322,521,1541,44,209
109,118,2,581,259,1069,36,309,22,301,463,1131,44,210
1308,80,1,567,534,2490,140,580,123,282,1311,2436,44,211
1854,77,8,656,371,2966,129,609,12,288,1805,2843,44,212
1672,130,3,673,345,2823,268,619,17,341,1545,2790,44,213
1528,126,26,674,420,2774,139,710,47,344,1426,2666,44,214
942,155,2,589,592,2280,135,645,77,343,917,2117,44,215
214,128,10,967,328,1647,40,570,69,320,562,1561,44,216
152,90,4,616,215,1077,52,280,10,307,524,1173,44,217
1188,83,7,505,334,2117,143,425,18,269,1164,2019,44,218
1686,109,6,618,420,2839,125,629,18,330,1602,2704,44,219
1606,146,10,600,457,2819,132,620,25,297,1617,2691,44,220
1383,125,26,661,313,2508,141,535,43,356,1435,2510,44,221
733,165,6,419,392,1715,128,409,79,284,685,1585,44,222
216,197,15,713,509,1650,86,553,78,350,489,1556,44,223
154,86,3,685,237,1165,53,310,8,357,544,1272,44,224
1150,107,3,596,267,2123,119,437,6,323,1173,2058,44,225
1700,113,17,687,375,2892,135,587,25,340,1643,2730,44,226
1601,152,14,670,434,2871,118,617,23,359,1647,2764,44,227
1349,164,39,667,432,2651,127,618,51,348,1386,2530,44,228
800,219,10,561,423,2013,123,426,78,309,864,1800,44,229
133,229,9,687,331,1389,58,384,87,309,513,1351,44,230
110,93,11,672,255,1141,27,312,26,401,524,1290,44,231
1162,68,2,502,287,2021,123,348,10,279,1131,1891,44,232
1662,114,6,736,507,3025,149,681,34,326,1652,2842,44,233
1615,178,5,725,529,3052,169,749,22,372,1630,2942,44,234
1358,140,5,689,441,2633,125,631,17,351,1470,2594,44,235
758,170,4,586,507,2025,95,529,55,356,893,1928,44,236
215,160,10,874,487,1746,50,624,73,373,604,1724,44,237
97,109,9,596,238,1049,36,275,19,274,444,1048,44,238
1298,64,6,491,443,2302,160,535,12,294,1242,2243,44,239
1899,103,5,643,540,3190,153,756,27,325,1739,3000,44,240
1826,92,5,585,597,3105,171,710,18,311,1745,2955,44,241
1579,116,4,602,453,2754,184,537,33,332,1541,2627,44,242
825,175,8,602,546,2156,139,535,69,448,859,2050,44,243
151,158,4,875,399,1587,55,584,54,306,518,1517,44,244
110,120,3,770,234,1237,29,311,16,306,607,1269,44,245
98,108,8,473,199,886,32,189,12,268,401,902,44,246
1732,69,2,535,328,2666,173,483,4,268,1673,2601,44,247
1768,90,3,564,413,2838,170,537,13,340,1692,2752,44,248
1589,102,6,554,406,2657,165,560,19,274,1568,2586,44,249
953,146,6,430,461,1996,138,456,67,300,864,1825,44,250
138,192,10,708,705,1753,44,596,220,362,485,1707,44,251
314,108,8,1010,255,1695,54,301,19,372,433,1179,44,252
1343,108,3,474,406,2334,165,446,16,283,1295,2205,44,253
1878,105,15,589,453,3040,164,683,33,342,1730,2952,44,254
1875,102,4,623,515,3119,197,728,12,368,1719,3024,44,255
1702,109,5,597,545,2958,172,740,20,343,1574,2849,44,256
964,238,18,539,603,2362,190,628,102,360,989,2269,44,257
265,1749,273,1313,1767,5367,766,669,31,2797,1642,5905,44,258
190,853,81,964,1675,3763,528,345,31,2194,870,3968,44,259
1400,77,10,518,345,2350,168,438,18,337,1283,2244,44,260
1940,67,20,554,417,2998,189,602,20,327,1766,2904,44,261
1778,106,22,613,385,2904,173,595,40,308,1680,2796,44,262
1727,103,15,631,573,3049,187,811,29,338,1566,2931,44,263
1013,259,20,557,550,2399,162,603,66,408,1071,2310,44,264
150,196,11,882,414,1653,52,523,105,376,518,1574,44,265
109,158,16,527,206,1016,45,322,19,270,414,1070,44,266
1375,93,2,499,339,2308,164,421,18,315,1294,2212,44,267
1901,90,2,564,480,3037,191,690,15,308,1757,2961,44,268
1831,129,3,607,614,3184,190,799,10,337,1762,3098,44,269
1581,94,3,726,425,2829,187,620,21,354,1583,2765,44,270
924,157,10,522,660,2273,159,618,63,405,916,2161,44,271
132,252,6,859,653,1902,68,820,70,329,515,1802,44,272
83,100,2,684,196,1065,42,322,9,281,490,1144,44,273
1356,84,9,488,336,2273,174,428,29,274,1328,2233,44,274
1884,83,10,582,394,2953,187,563,25,339,1723,2837,44,275
1704,119,8,620,426,2877,170,555,28,376,1717,2846,44,276
1501,205,5,677,432,2820,191,686,27,394,1407,2705,44,277
930,220,5,579,520,2254,152,546,50,381,948,2077,44,278
169,258,7,761,442,1637,46,569,72,317,583,1587,44,279
119,97,7,586,245,1054,29,283,11,306,426,1055,44,280
1303,96,5,520,423,2347,182,513,9,295,1322,2321,44,281
1920,105,15,576,375,2991,175,649,15,329,1721,2889,44,282
1876,266,11,706,451,3310,184,826,19,381,1868,3278,44,283
1615,167,7,614,520,2923,161,744,30,371,1574,2880,44,284
861,181,4,532,545,2123,150,466,47,414,927,2004,44,285
1145,719,27,3503,2079,7473,332,2719,313,1705,2881,7950,44,286
710,555,4,2479,1313,5061,249,1697,78,1467,1954,5445,44,287
2087,439,15,2233,1355,6129,783,1379,89,1380,2813,6444,44,288
1798,86,3,688,560,3135,176,800,7,370,1758,3111,44,289
1828,105,2,737,434,3106,172,636,20,382,1817,3027,44,290
1633,126,6,651,683,3099,173,941,33,333,1480,2960,44,291
891,280,8,732,580,2491,156,666,67,386,1063,2338,44,292
193,262,17,708,625,1805,49,655,80,329,614,1727,44,293
92,166,11,616,323,1208,31,438,12,281,497,1259,44,294
1322,88,12,588,366,2376,183,484,19,299,1337,2322,44,295
1897,123,14,637,413,3084,181,691,22,357,1730,2981,44,296
1899,136,12,635,588,3270,195,876,11,378,1747,3207,44,297
1690,141,8,668,546,3053,169,784,13,424,1553,2943,44,298
964,268,18,615,544,2409,155,586,63,395,1084,2283,44,299
176,212,24,741,462,1615,70,457,100,372,528,1527,44,300
358,164,8,635,298,1463,57,351,46,454,531,1439,44,301
1320,82,7,550,350,2309,158,464,14,296,1374,2306,44,302
1870,108,11,678,881,3548,185,1157,26,383,1696,3447,44,303
1884,130,7,706,574,3301,185,769,22,360,1872,3208,44,304
1518,177,13,573,539,2820,177,580,49,362,1553,2721,44,305
916,265,9,564,574,2328,164,526,66,381,966,2103,44,306
180,228,6,797,621,1832,49,676,94,335,567,1721,44,307
115,90,11,574,295,1085,35,272,14,355,451,1127,44,308
1310,84,2,546,419,2361,183,469,9,374,1328,2363,44,309
1408,116,4,613,390,2531,186,397,29,458,1348,2418,44,310
1541,95,5,566,540,2747,172,596,14,333,1505,2620,44,311
1669,104,11,637,417,2838,166,555,14,345,1636,2716,44,312
908,155,8,612,695,2378,145,599,67,387,956,2154,44,313
283,1061,190,1136,1700,4370,824,553,39,2262,1128,4806,44,314
164,867,81,779,1371,3262,505,306,9,1696,785,3301,44,315
592,905,68,941,2207,4713,2250,330,21,1650,1005,5256,44,316
1909,74,3,605,421,3012,164,557,8,297,1799,2825,44,317
1895,139,4,614,540,3192,183,744,16,351,1777,3071,44,318
1642,81,3,638,446,2810,164,580,16,365,1609,2734,44,319
962,173,3,540,531,2209,157,475,64,386,983,2065,44,320
160,211,7,792,379,1549,50,378,74,313,677,1492,44,321
132,75,6,632,341,1186,35,278,15,389,518,1235,44,322
1376,82,2,525,380,2365,143,448,14,293,1387,2285,44,323
1988,81,13,645,438,3165,170,632,17,359,1842,3020,44,324
1945,99,4,637,423,3108,178,644,12,369,1752,2955,44,325
1725,111,2,677,610,3125,162,799,14,372,1600,2947,44,326
907,173,12,451,536,2079,151,532,63,324,960,2030,44,327
105,242,10,659,633,1649,35,616,93,346,502,1592,44,328
100,72,4,552,275,1003,31,292,12,268,458,1061,44,329
1189,117,23,630,331,2290,133,429,21,353,1338,2274,44,330
1375,97,8,695,511,2686,129,642,14,392,1529,2706,44,331
725,169,16,656,420,1986,86,484,36,539,906,2051,44,332
63,150,4,230,110,557,27,84,4,251,271,637,44,333
261,111,17,1047,344,1780,43,374,39,355,804,1615,44,334
106,152,5,739,388,1390,33,385,27,281,559,1285,44,335
93,77,4,540,309,1023,32,289,9,208,426,964,44,336
1237,70,12,508,359,2186,134,374,14,248,1266,2036,44,337
1870,68,2,534,602,3076,157,736,10,321,1723,2947,44,338
1788,161,9,628,410,2996,155,756,17,334,1608,2870,44,339
1604,126,2,656,612,3000,152,847,12,337,1544,2892,44,340
926,169,9,490,498,2092,143,512,62,326,984,2027,44,341
120,243,12,828,680,1883,28,715,109,311,668,1831,44,342
101,104,3,701,346,1255,36,384,25,326,527,1298,44,343
1265,75,3,491,324,2158,130,427,12,273,1260,2102,44,344
1988,76,9,769,449,3291,177,692,13,394,1861,3137,44,345
1880,102,14,642,496,3134,162,684,27,369,1716,2958,44,346
1775,184,7,727,569,3262,169,883,27,388,1719,3186,44,347
934,218,11,605,605,2373,161,573,71,341,1034,2180,44,348
239,279,6,848,720,2092,47,718,72,395,624,1856,44,349
94,90,10,484,371,1049,35,288,15,350,442,1130,44,350
1227,75,11,593,296,2202,151,419,19,286,1235,2110,44,351
1723,100,13,778,627,3241,156,738,107,380,1766,3147,44,352
1683,121,13,730,407,2954,144,661,32,344,1670,2851,44,353
1432,117,18,716,620,2903,159,751,29,376,1405,2720,44,354
759,130,8,547,727,2171,106,624,59,324,871,1984,44,355
124,146,9,734,419,1432,33,437,44,306,551,1371,44,356
81,46,1,639,457,1224,36,475,6,252,513,1282,44,357
539,67,2,679,428,1715,83,451,10,276,785,1605,44,358
256,77,3,380,157,873,67,135,13,301,402,918,44,359
39,51,7,161,86,344,14,101,10,87,131,343,44,360
313,83,5,631,431,1463,63,469,20,220,575,1347,44,361
344,119,2,788,345,1598,61,406,33,262,762,1524,44,362
83,112,3,593,346,1137,27,360,45,236,434,1102,44,363
82,55,6,672,324,1139,25,250,27,272,563,1137,44,364
534,67,3,755,500,1859,92,498,12,320,853,1775,44,365
451,313,66,746,304,1880,81,238,217,363,773,1672,44,366
45,22,0,58,58,183,29,68,4,68,103,272,45,1
444,37,0,147,93,721,88,110,3,96,458,755,45,2
551,29,0,143,140,863,103,167,4,99,517,890,45,3
513,36,0,173,86,808,84,133,4,109,539,869,45,4
312,44,0,191,162,709,84,165,11,107,343,710,45,5
50,35,5,165,79,334,29,120,18,76,113,356,45,6
48,29,0,157,70,304,19,118,1,84,121,343,45,7
454,25,0,151,137,767,85,162,2,110,459,818,45,8
581,20,3,121,88,813,74,122,7,116,495,814,45,9
632,49,0,156,125,962,94,205,2,121,577,999,45,10
553,38,0,168,162,921,65,211,2,110,545,933,45,11
271,35,0,134,100,540,69,124,12,91,252,548,45,12
49,21,5,277,123,475,20,147,18,83,188,456,45,13
38,19,0,131,63,251,14,89,6,65,112,286,45,14
59,18,1,109,75,262,50,80,1,60,106,297,45,15
168,19,0,93,93,373,84,92,5,66,143,390,45,16
461,37,0,140,127,765,98,163,2,113,401,777,45,17
594,26,0,171,144,935,85,184,7,95,549,920,45,18
179,29,0,148,89,445,60,102,17,81,189,449,45,19
47,26,1,185,120,379,36,130,21,101,132,420,45,20
41,14,0,128,70,253,16,88,2,74,116,296,45,21
413,43,0,149,104,709,64,123,2,79,436,704,45,22
630,35,0,175,122,962,85,155,9,115,587,951,45,23
650,36,2,169,127,984,95,197,13,111,558,974,45,24
653,35,0,172,133,993,82,178,4,127,548,939,45,25
351,46,5,224,174,800,73,200,24,156,355,808,45,26
91,39,5,318,112,565,30,154,24,122,255,585,45,27
54,31,0,153,85,323,14,91,6,99,161,371,45,28
463,22,0,135,112,732,80,141,3,92,447,763,45,29
661,46,1,155,126,989,106,196,5,135,597,1039,45,30
647,31,0,200,144,1022,93,208,5,105,625,1036,45,31
646,41,0,170,113,970,98,188,4,115,570,975,45,32
312,53,1,188,153,707,75,170,23,135,312,715,45,33
89,59,5,254,116,523,35,121,21,144,204,525,45,34
58,27,0,198,70,353,16,108,6,103,141,374,45,35
463,31,0,158,118,770,69,141,6,132,455,803,45,36
658,40,1,180,161,1040,96,197,5,156,612,1066,45,37
660,44,0,173,144,1021,110,220,9,122,569,1030,45,38
615,43,0,169,137,964,87,198,7,119,553,964,45,39
315,56,0,220,161,752,81,173,34,156,334,778,45,40
89,48,3,293,145,578,43,164,33,131,207,578,45,41
39,27,0,198,65,329,12,86,23,77,175,373,45,42
459,34,1,177,108,779,71,151,4,138,405,769,45,43
530,36,3,198,145,912,104,191,8,110,529,942,45,44
672,43,1,171,143,1030,102,193,9,120,591,1015,45,45
617,31,0,187,127,962,115,186,8,109,536,954,45,46
313,62,4,173,150,702,91,158,23,147,311,730,45,47
56,43,2,237,116,454,23,113,18,105,166,425,45,48
38,30,0,240,69,377,17,104,5,102,216,444,45,49
145,27,1,142,115,430,58,108,3,105,189,463,45,50
666,41,2,158,180,1047,124,206,5,115,612,1062,45,51
678,32,1,177,126,1014,97,199,4,113,658,1071,45,52
606,38,0,161,133,938,119,214,10,121,522,986,45,53
319,60,0,144,147,670,90,126,11,114,321,662,45,54
70,39,5,232,139,485,33,149,34,102,205,523,45,55
58,32,0,177,74,341,17,104,7,102,168,398,45,56
466,24,0,134,129,753,79,199,3,143,399,823,45,57
671,29,1,141,128,970,103,202,7,128,582,1022,45,58
665,29,0,139,119,952,85,170,3,98,601,957,45,59
625,39,5,161,114,944,91,205,5,112,538,951,45,60
324,49,0,159,175,707,69,180,33,123,335,740,45,61
70,48,4,184,118,424,30,136,26,109,173,474,45,62
50,12,5,226,63,356,18,102,20,93,166,399,45,63
485,26,0,135,115,761,62,179,6,94,425,766,45,64
650,35,0,167,133,985,92,208,9,106,614,1029,45,65
691,37,2,161,153,1044,92,212,3,131,615,1053,45,66
660,40,0,174,139,1013,111,198,13,130,574,1026,45,67
369,48,0,206,138,761,86,188,15,151,326,766,45,68
117,52,2,255,113,539,31,173,28,126,187,545,45,69
62,40,3,290,86,481,29,127,8,111,225,500,45,70
463,38,0,152,124,777,66,150,9,106,447,778,45,71
680,41,1,222,130,1074,102,232,4,144,633,1115,45,72
697,58,2,255,185,1197,97,273,14,150,644,1178,45,73
620,51,0,292,165,1128,88,257,20,136,620,1121,45,74
352,68,2,221,195,838,80,202,46,140,359,827,45,75
157,80,3,456,182,878,45,283,54,189,325,896,45,76
69,47,2,286,79,483,24,184,7,128,230,573,45,77
502,27,1,186,140,856,74,155,6,140,489,864,45,78
676,42,1,165,158,1042,80,277,9,108,601,1075,45,79
712,41,1,295,199,1248,79,279,10,165,704,1237,45,80
687,34,1,209,159,1090,89,216,15,145,589,1054,45,81
371,65,3,301,231,971,108,258,19,175,431,991,45,82
77,43,2,264,171,557,21,195,31,135,213,595,45,83
148,37,1,537,129,852,16,257,9,145,467,894,45,84
502,45,3,339,219,1108,107,226,19,124,573,1049,45,85
660,41,1,318,246,1266,93,272,8,158,715,1246,45,86
587,29,1,213,167,997,84,215,4,116,574,993,45,87
516,50,1,289,146,1002,80,245,14,132,537,1008,45,88
333,59,2,326,210,930,66,216,34,170,470,956,45,89
149,64,1,921,183,1318,33,421,33,177,693,1357,45,90
61,41,0,306,83,491,18,177,4,115,239,553,45,91
455,33,1,316,121,926,78,266,5,93,452,894,45,92
603,45,2,210,163,1023,97,238,6,111,596,1048,45,93
662,32,1,215,169,1079,92,229,4,140,613,1078,45,94
630,42,1,256,192,1121,93,292,14,152,566,1117,45,95
383,57,3,255,190,888,84,190,33,156,434,897,45,96
105,83,1,400,129,718,27,215,30,174,266,712,45,97
102,43,0,270,103,518,32,177,3,151,210,573,45,98
452,30,2,175,113,772,73,147,7,121,433,781,45,99
656,37,4,205,149,1051,119,199,15,131,598,1062,45,100
617,41,1,208,158,1025,98,208,12,133,575,1026,45,101
630,48,1,175,135,989,103,194,0,138,596,1031,45,102
370,45,2,186,160,763,86,188,17,140,350,781,45,103
126,65,2,377,198,768,31,299,33,164,260,787,45,104
52,33,0,270,97,452,16,153,3,130,201,503,45,105
500,34,2,153,169,858,84,176,10,130,450,850,45,106
669,34,1,198,152,1054,89,242,9,134,618,1092,45,107
687,38,6,205,148,1084,95,277,15,138,626,1151,45,108
632,53,2,205,155,1047,111,243,12,138,561,1065,45,109
377,59,1,211,204,852,102,225,23,151,355,856,45,110
88,70,0,571,161,890,31,356,32,159,288,866,45,111
63,39,0,234,79,415,16,137,7,146,189,495,45,112
497,45,1,193,127,863,88,182,1,129,451,851,45,113
670,40,1,186,176,1073,118,229,1,118,599,1065,45,114
675,31,2,170,213,1091,115,258,4,121,602,1100,45,115
707,32,3,258,162,1162,106,253,9,156,633,1157,45,116
373,46,4,219,223,865,90,262,24,137,348,861,45,117
81,60,1,296,202,640,30,224,54,180,205,693,45,118
65,34,0,351,178,628,24,187,63,122,235,631,45,119
499,48,1,151,123,822,99,148,2,109,476,834,45,120
692,52,0,219,150,1113,120,202,7,115,668,1112,45,121
668,51,2,164,153,1038,115,200,11,112,605,1043,45,122
645,40,3,197,176,1061,126,229,14,121,580,1070,45,123
372,71,4,226,205,878,96,225,21,158,369,869,45,124
102,46,0,265,134,547,30,181,27,123,228,589,45,125
43,43,0,185,77,348,14,174,3,88,130,409,45,126
461,29,1,197,128,816,105,181,1,147,456,890,45,127
733,50,1,182,211,1177,114,240,7,135,651,1147,45,128
692,51,1,189,212,1145,128,239,19,121,632,1139,45,129
625,45,1,203,162,1036,105,191,11,158,574,1039,45,130
330,53,4,217,166,770,84,199,23,141,328,775,45,131
115,60,0,374,159,708,34,196,30,158,332,750,45,132
52,59,0,219,84,414,19,146,6,131,162,464,45,133
539,42,1,151,131,864,76,170,6,135,466,853,45,134
724,50,2,164,152,1092,99,183,9,136,647,1074,45,135
694,50,1,209,165,1119,100,278,11,133,609,1131,45,136
689,57,1,226,170,1143,105,229,7,124,590,1055,45,137
404,73,2,284,170,933,108,207,24,166,411,916,45,138
82,63,4,296,120,565,36,172,19,140,222,589,45,139
85,48,0,255,63,451,27,170,4,117,198,516,45,140
527,37,1,218,153,936,97,187,4,111,506,905,45,141
718,50,1,201,201,1171,112,263,13,113,654,1155,45,142
683,43,2,234,162,1124,97,226,6,153,649,1131,45,143
638,47,3,213,142,1043,95,189,6,148,583,1021,45,144
315,62,3,228,219,827,84,203,35,156,301,779,45,145
125,62,0,459,168,814,39,294,43,165,261,802,45,146
75,71,1,321,140,608,38,219,33,141,199,630,45,147
60,41,2,248,82,433,28,132,11,116,225,512,45,148
647,32,3,185,151,1018,108,178,34,149,606,1075,45,149
677,43,1,204,138,1063,101,194,10,146,638,1089,45,150
623,56,2,232,172,1085,115,208,15,130,624,1092,45,151
390,82,5,224,188,889,102,188,48,138,397,873,45,152
95,62,3,323,168,651,31,251,31,154,235,702,45,153
66,42,0,297,90,495,32,136,5,128,238,539,45,154
537,35,3,202,174,951,110,196,5,118,544,973,45,155
770,57,1,179,179,1186,116,255,8,131,674,1184,45,156
765,27,0,249,156,1197,123,199,9,158,714,1203,45,157
664,47,0,256,187,1154,109,241,12,135,660,1157,45,158
408,103,4,256,312,1083,90,304,72,170,400,1036,45,159
112,92,0,593,239,1036,41,497,48,151,321,1058,45,160
74,51,1,341,114,581,29,232,12,140,261,674,45,161
549,30,0,201,156,936,109,162,4,153,569,997,45,162
761,41,0,253,170,1225,127,294,6,136,698,1261,45,163
766,46,0,223,203,1238,122,273,13,159,694,1261,45,164
709,41,1,217,154,1122,109,276,9,131,586,1111,45,165
395,74,0,229,241,939,88,260,50,149,357,904,45,166
86,64,3,412,180,745,37,340,32,147,260,816,45,167
61,42,0,272,112,487,30,151,7,127,227,542,45,168
521,51,0,202,127,901,105,157,3,144,480,889,45,169
733,52,1,239,223,1248,129,282,24,168,641,1244,45,170
223,45,0,285,170,723,93,206,8,145,262,714,45,171
675,59,3,278,175,1190,114,238,19,156,639,1166,45,172
369,74,3,205,181,832,102,185,36,140,353,816,45,173
108,93,9,296,220,726,32,272,62,122,233,721,45,174
59,57,0,231,124,471,30,153,22,142,173,520,45,175
541,38,1,187,133,900,99,158,6,123,495,881,45,176
518,49,0,215,161,943,194,226,10,130,547,1107,45,177
828,39,2,244,168,1281,128,262,6,160,781,1337,45,178
732,57,1,254,192,1236,126,249,22,154,689,1240,45,179
424,55,2,205,199,885,100,181,34,180,415,910,45,180
76,69,3,352,196,696,32,250,38,158,243,721,45,181
66,52,1,271,62,452,26,166,8,130,225,555,45,182
536,56,0,232,233,1057,108,259,9,128,523,1027,45,183
631,58,2,242,199,1132,120,249,15,118,618,1120,45,184
515,71,2,257,261,1106,109,256,17,173,523,1078,45,185
139,378,12,457,491,1477,42,788,93,190,297,1410,45,186
262,61,2,323,168,816,91,234,32,175,277,809,45,187
118,51,2,360,135,666,42,244,21,161,234,702,45,188
58,40,0,274,88,460,39,157,3,127,235,561,45,189
443,37,0,180,126,786,98,164,4,118,455,839,45,190
619,49,1,172,149,990,130,197,1,125,593,1046,45,191
681,36,2,183,167,1069,98,165,8,123,642,1036,45,192
624,47,3,227,173,1074,114,235,13,148,556,1066,45,193
336,55,2,198,175,766,90,179,32,132,351,784,45,194
91,90,1,318,214,714,36,267,36,145,223,707,45,195
71,41,0,248,99,459,34,175,8,111,174,502,45,196
490,27,2,183,115,817,102,159,12,126,474,873,45,197
751,38,0,169,174,1132,130,222,10,119,627,1108,45,198
733,41,2,209,154,1139,117,177,9,147,678,1128,45,199
660,50,2,244,176,1132,134,224,10,144,586,1098,45,200
411,76,1,261,277,1026,98,273,62,159,415,1007,45,201
76,59,0,352,307,794,38,317,30,170,206,761,45,202
78,48,0,340,94,560,28,138,7,189,262,624,45,203
532,46,0,212,180,970,93,232,15,123,484,947,45,204
771,44,2,235,171,1223,118,252,9,147,699,1225,45,205
700,46,1,267,197,1211,113,220,24,136,710,1203,45,206
693,45,2,277,161,1178,101,201,8,146,670,1126,45,207
370,71,2,252,185,880,93,178,38,151,400,860,45,208
83,75,0,387,207,752,49,299,74,176,239,837,45,209
67,55,0,306,103,531,35,184,14,118,216,567,45,210
523,32,3,257,204,1019,107,204,64,128,512,1015,45,211
755,44,0,228,173,1200,110,287,4,142,692,1235,45,212
738,47,1,205,157,1148,123,225,1,124,701,1174,45,213
692,49,0,228,177,1146,134,224,6,135,613,1112,45,214
393,63,0,281,274,1011,94,315,43,147,388,987,45,215
89,52,0,374,139,654,47,235,33,149,237,701,45,216
97,52,1,326,97,573,39,165,14,155,262,635,45,217
514,49,1,209,144,917,93,191,4,158,505,951,45,218
716,49,2,227,223,1217,132,244,20,145,654,1195,45,219
684,53,3,240,191,1171,130,217,8,171,652,1178,45,220
625,52,4,249,161,1091,122,190,19,181,567,1079,45,221
304,85,0,172,189,750,81,174,42,139,334,770,45,222
93,80,1,320,187,681,61,227,41,151,225,705,45,223
96,47,1,269,120,533,30,175,5,138,229,577,45,224
495,37,0,219,155,906,96,159,5,131,503,894,45,225
702,54,0,192,172,1120,133,191,4,130,678,1136,45,226
684,53,0,244,173,1154,108,186,1,170,667,1132,45,227
645,57,0,245,223,1170,123,236,11,157,576,1103,45,228
401,81,3,229,167,881,125,198,25,167,372,887,45,229
77,77,0,326,141,621,48,193,50,156,207,654,45,230
45,59,1,233,97,435,31,118,12,126,189,476,45,231
490,43,11,188,159,891,127,147,15,120,483,892,45,232
705,36,2,203,208,1154,131,204,21,137,709,1202,45,233
714,59,0,217,202,1192,117,217,13,170,656,1173,45,234
649,65,0,259,187,1160,123,213,5,145,633,1119,45,235
412,66,1,222,185,886,123,204,16,165,365,873,45,236
97,56,5,366,164,688,36,276,32,157,239,740,45,237
64,42,2,244,127,479,28,161,16,108,238,551,45,238
500,46,0,179,248,973,100,253,3,119,477,952,45,239
742,48,2,208,215,1215,128,236,12,130,670,1176,45,240
696,43,2,191,218,1150,124,238,10,130,656,1158,45,241
686,73,1,231,226,1217,133,211,49,164,652,1209,45,242
331,77,1,268,205,882,101,207,36,152,334,830,45,243
113,38,3,461,136,751,41,233,18,152,314,758,45,244
70,45,0,326,110,551,26,146,11,134,284,601,45,245
84,66,1,171,102,424,30,158,7,109,146,450,45,246
715,34,3,209,161,1122,124,199,6,135,692,1156,45,247
737,36,1,183,172,1129,111,235,5,150,684,1185,45,248
730,56,2,218,175,1181,127,224,10,145,677,1183,45,249
430,62,4,160,170,826,106,197,14,151,366,834,45,250
83,69,4,308,190,654,32,201,72,148,222,675,45,251
60,46,17,227,100,450,27,152,19,136,179,513,45,252
560,66,7,189,151,973,97,209,31,128,533,998,45,253
788,70,4,216,180,1258,121,264,15,136,723,1259,45,254
754,33,2,238,192,1219,116,241,12,154,696,1219,45,255
735,62,1,234,185,1217,105,278,11,146,665,1205,45,256
388,69,2,196,232,887,116,233,18,131,404,902,45,257
129,67,3,346,195,740,46,267,32,184,215,744,45,258
88,43,0,323,102,556,27,148,5,116,284,580,45,259
578,45,2,208,145,978,108,216,1,164,532,1021,45,260
784,35,7,200,178,1204,132,219,9,117,714,1191,45,261
739,44,5,179,172,1139,112,255,3,113,638,1121,45,262
732,65,26,221,193,1237,121,278,38,143,645,1225,45,263
392,43,3,217,201,856,102,198,21,141,386,848,45,264
95,82,0,376,181,734,48,262,52,127,246,735,45,265
62,38,0,255,98,453,35,157,4,119,218,533,45,266
527,33,2,181,153,896,94,208,3,105,511,921,45,267
771,39,2,195,187,1194,126,236,9,132,710,1213,45,268
783,35,0,197,195,1210,102,275,16,132,696,1221,45,269
744,43,2,260,189,1238,133,257,12,140,703,1245,45,270
392,43,2,183,245,865,104,204,59,141,373,881,45,271
120,49,2,417,209,797,44,275,66,170,243,798,45,272
73,50,0,247,102,472,25,217,12,141,157,552,45,273
542,48,1,184,155,930,92,183,15,133,514,937,45,274
736,41,0,198,149,1124,133,189,13,146,721,1202,45,275
755,31,2,240,174,1202,117,229,10,133,701,1190,45,276
735,24,0,267,215,1241,122,298,11,185,648,1264,45,277
373,47,0,249,197,866,114,188,25,163,387,877,45,278
95,51,6,350,154,656,39,258,30,154,231,712,45,279
86,45,0,275,91,497,40,139,6,138,215,538,45,280
551,32,0,197,166,946,87,186,5,144,536,958,45,281
797,38,1,224,175,1235,123,238,12,154,718,1245,45,282
768,41,1,194,171,1175,100,236,9,122,699,1166,45,283
728,59,0,247,210,1244,109,283,4,174,712,1282,45,284
384,66,0,279,211,940,107,229,20,177,405,938,45,285
132,63,1,397,196,789,35,298,18,137,334,822,45,286
78,58,0,259,129,524,20,150,28,146,211,555,45,287
222,43,1,244,139,649,71,141,10,115,295,632,45,288
809,47,1,205,186,1248,125,270,13,141,739,1288,45,289
803,51,10,238,168,1270,131,217,11,171,780,1310,45,290
716,58,11,193,226,1204,106,314,22,126,678,1246,45,291
361,73,4,228,198,864,89,229,29,137,370,854,45,292
122,94,2,367,185,770,45,249,41,176,285,796,45,293
58,40,0,299,134,531,21,215,7,119,203,565,45,294
537,43,2,191,158,931,88,162,14,143,546,953,45,295
813,42,0,198,164,1217,121,195,0,150,765,1231,45,296
763,36,2,222,212,1235,117,261,9,142,723,1252,45,297
738,53,2,245,229,1267,139,301,12,140,702,1294,45,298
434,57,2,220,220,933,119,226,22,170,405,942,45,299
99,65,1,359,182,706,41,238,43,170,235,727,45,300
214,46,6,276,129,671,29,159,26,223,255,692,45,301
534,37,1,160,179,911,87,178,7,112,551,935,45,302
761,51,0,242,303,1357,112,385,11,155,691,1354,45,303
775,41,1,234,190,1241,115,269,13,135,741,1273,45,304
634,57,1,187,240,1119,112,227,27,145,611,1122,45,305
400,62,1,226,190,879,97,183,24,160,409,873,45,306
102,70,3,313,181,669,35,239,31,163,219,687,45,307
49,48,2,200,90,389,23,120,10,120,180,453,45,308
538,36,4,159,166,903,111,168,6,144,541,970,45,309
560,42,1,213,160,976,97,132,8,150,602,989,45,310
660,31,0,186,162,1039,81,213,7,136,629,1066,45,311
689,49,0,190,158,1086,109,216,7,155,643,1130,45,312
371,55,1,202,221,850,84,228,43,151,288,794,45,313
78,68,3,331,140,620,43,183,24,162,236,648,45,314
62,34,3,290,120,509,21,112,24,115,247,519,45,315
265,21,1,174,133,594,86,135,4,117,293,635,45,316
781,40,0,203,184,1208,123,197,2,158,756,1236,45,317
753,29,2,234,214,1232,117,265,11,140,744,1277,45,318
714,51,0,194,174,1133,128,225,14,160,654,1181,45,319
392,39,0,191,177,799,82,150,15,133,380,760,45,320
83,54,3,288,131,559,25,166,29,127,221,568,45,321
52,33,0,216,108,409,24,118,5,111,183,441,45,322
554,30,0,164,155,903,86,188,5,137,527,943,45,323
803,43,1,186,158,1191,128,204,2,136,727,1197,45,324
791,40,2,179,151,1163,110,204,10,142,741,1207,45,325
699,48,0,209,203,1159,142,244,11,138,663,1198,45,326
368,62,3,159,168,760,106,163,29,120,374,792,45,327
80,55,4,265,141,545,35,163,38,110,183,529,45,328
51,47,0,234,106,438,24,153,2,108,231,518,45,329
507,43,0,196,130,876,87,162,16,100,524,889,45,330
551,51,0,233,187,1022,90,202,3,179,565,1039,45,331
332,49,0,248,153,782,85,178,10,198,331,802,45,332
39,36,1,118,48,242,29,48,3,126,139,345,45,333
151,49,0,379,130,709,45,199,19,175,271,709,45,334
69,39,3,312,142,565,51,141,23,138,220,573,45,335
49,33,1,235,105,423,23,122,12,114,200,471,45,336
487,23,0,173,161,844,114,169,3,112,463,861,45,337
747,46,0,228,198,1219,121,253,3,131,701,1209,45,338
735,25,0,165,142,1067,100,229,6,126,667,1128,45,339
663,24,1,196,176,1060,113,251,12,130,576,1082,45,340
379,33,1,190,167,770,84,168,21,139,351,763,45,341
68,43,1,287,209,608,35,232,30,127,196,620,45,342
48,40,0,224,76,388,27,125,9,93,184,438,45,343
556,41,0,152,142,891,89,180,3,121,518,911,45,344
819,39,0,188,174,1220,123,250,8,101,768,1250,45,345
767,35,0,175,145,1122,96,230,14,130,671,1141,45,346
724,44,0,225,166,1159,86,279,17,142,632,1156,45,347
406,51,1,206,166,830,102,192,32,124,348,798,45,348
89,66,1,345,187,688,30,237,25,180,242,714,45,349
46,39,0,191,101,377,20,150,5,114,151,440,45,350
489,35,1,169,129,823,91,173,4,138,489,895,45,351
738,49,2,201,194,1184,103,226,29,156,725,1239,45,352
706,36,0,201,169,1112,130,201,13,137,660,1141,45,353
612,43,1,191,194,1041,88,219,15,114,586,1022,45,354
288,54,1,193,177,713,96,211,37,110,280,734,45,355
65,57,8,293,131,554,33,194,28,112,185,552,45,356
43,33,0,219,102,397,17,145,2,108,138,410,45,357
224,29,1,221,146,621,51,159,13,104,284,611,45,358
155,24,0,175,67,421,73,72,8,108,162,423,45,359
23,23,0,90,34,170,15,54,0,63,66,198,45,360
208,38,0,275,114,635,60,147,2,96,309,614,45,361
173,34,0,279,136,622,72,161,11,128,247,619,45,362
47,59,4,202,133,445,27,154,32,96,151,460,45,363
50,24,0,224,100,398,21,139,16,107,187,470,45,364
250,34,0,255,160,699,64,167,9,109,357,706,45,365
238,126,30,245,142,781,68,130,80,136,286,700,45,366
146,91,12,428,232,909,70,257,27,323,357,1034,46,1
1533,105,12,684,375,2709,196,500,22,436,1641,2795,46,2
2091,116,8,648,446,3309,184,615,30,478,2038,3345,46,3
1991,108,5,621,360,3085,217,480,25,439,1958,3119,46,4
1537,151,7,686,584,2965,207,619,46,533,1608,3013,46,5
250,137,11,501,264,1163,67,388,58,324,384,1221,46,6
202,124,11,724,265,1326,71,439,31,333,600,1474,46,7
1954,109,6,575,417,3061,225,594,29,446,1873,3167,46,8
2279,91,4,522,273,3169,235,462,29,583,1902,3211,46,9
2367,110,7,644,367,3495,235,676,38,466,2140,3555,46,10
2245,150,19,648,540,3602,214,740,39,479,2077,3549,46,11
1447,170,8,663,447,2735,235,499,66,491,1360,2651,46,12
333,167,17,1259,373,2149,76,485,98,463,1055,2177,46,13
206,99,19,627,234,1185,70,313,44,357,453,1237,46,14
386,129,10,652,262,1439,133,365,25,391,586,1500,46,15
648,116,12,438,336,1550,178,454,27,323,612,1594,46,16
2050,132,8,671,353,3214,184,561,32,456,1981,3214,46,17
2310,104,6,638,478,3536,207,766,33,470,2082,3558,46,18
967,119,5,628,325,2044,175,451,61,446,881,2014,46,19
275,124,12,638,387,1436,52,472,94,367,513,1498,46,20
193,112,19,532,256,1112,57,357,38,298,411,1161,46,21
1979,134,23,584,352,3072,216,529,53,431,1865,3094,46,22
2520,117,16,664,398,3715,233,665,43,516,2342,3799,46,23
2498,117,8,687,482,3792,233,760,35,503,2223,3754,46,24
2228,124,11,635,464,3462,216,707,44,482,2051,3500,46,25
1661,175,5,821,515,3177,224,630,73,804,1598,3329,46,26
300,210,18,1021,453,2002,94,572,95,452,915,2128,46,27
201,118,11,730,207,1267,69,353,38,393,537,1390,46,28
2044,115,15,619,358,3151,238,538,34,395,1926,3131,46,29
2551,113,7,681,393,3745,222,644,35,510,2357,3768,46,30
2548,116,13,660,401,3738,263,713,31,509,2210,3726,46,31
2332,136,1,620,461,3550,216,646,37,475,2101,3475,46,32
1750,157,5,613,518,3043,243,588,68,488,1595,2982,46,33
320,160,19,789,378,1666,89,432,94,408,709,1732,46,34
248,119,8,620,244,1239,106,369,34,352,476,1337,46,35
1979,122,4,623,366,3094,208,504,17,485,1907,3121,46,36
2509,119,0,646,474,3748,249,751,24,518,2239,3781,46,37
2536,158,27,694,449,3864,235,739,52,485,2227,3738,46,38
2365,137,3,660,393,3558,272,659,27,467,2100,3525,46,39
1759,198,6,716,532,3211,241,612,69,667,1548,3137,46,40
326,184,20,899,555,1984,100,646,102,452,717,2017,46,41
220,127,5,695,262,1309,84,363,30,334,675,1486,46,42
1947,109,2,612,383,3053,226,532,22,474,1843,3097,46,43
2325,139,6,614,477,3561,209,730,41,446,2169,3595,46,44
2462,143,22,650,430,3707,238,643,44,525,2280,3730,46,45
2302,131,3,665,452,3553,231,659,24,492,2065,3471,46,46
1462,193,12,688,489,2844,275,572,72,598,1281,2798,46,47
298,141,15,821,432,1707,97,465,77,434,649,1722,46,48
258,144,4,759,274,1439,74,426,25,390,647,1562,46,49
638,122,5,756,361,1882,212,433,21,449,825,1940,46,50
2472,111,3,649,525,3760,245,727,27,534,2299,3832,46,51
2483,127,2,671,421,3704,211,696,25,520,2238,3690,46,52
2185,112,3,590,436,3326,279,640,30,503,2051,3503,46,53
1528,150,5,541,381,2605,205,536,58,474,1487,2760,46,54
257,158,11,861,460,1747,74,513,94,417,714,1812,46,55
180,80,3,556,312,1131,70,391,22,334,475,1292,46,56
1896,87,2,511,375,2871,202,564,27,435,1807,3035,46,57
2370,78,0,565,385,3398,196,648,17,485,2131,3477,46,58
2275,91,4,552,298,3220,161,642,23,438,2013,3277,46,59
2158,102,2,560,347,3169,185,683,28,393,1951,3240,46,60
1502,163,3,604,550,2822,181,679,56,478,1487,2881,46,61
258,155,11,684,405,1513,65,512,92,379,579,1627,46,62
240,108,8,786,228,1370,64,355,39,354,692,1504,46,63
1795,89,7,603,285,2779,180,521,32,383,1720,2836,46,64
2420,105,4,720,410,3659,212,627,33,522,2257,3651,46,65
2378,97,2,586,415,3478,192,638,28,419,2205,3482,46,66
2140,131,6,642,439,3358,191,665,61,538,1958,3413,46,67
1726,238,7,907,672,3550,233,852,85,657,1709,3536,46,68
402,151,10,1030,480,2073,110,754,82,446,745,2137,46,69
264,141,8,897,336,1646,111,433,36,460,726,1766,46,70
2038,118,1,772,435,3364,234,647,20,540,1951,3392,46,71
2515,149,2,868,453,3987,220,823,26,566,2425,4060,46,72
2603,144,15,881,544,4187,267,811,44,613,2510,4245,46,73
2383,148,18,972,626,4147,281,889,69,598,2308,4145,46,74
1722,172,11,883,659,3447,259,674,115,686,1706,3440,46,75
529,311,14,1317,625,2796,130,980,129,698,1016,2953,46,76
282,161,15,884,441,1783,96,633,51,461,632,1873,46,77
2150,135,12,791,491,3579,243,724,31,589,1973,3560,46,78
2702,137,28,803,498,4168,239,807,54,514,2521,4135,46,79
2585,188,53,956,708,4490,226,1090,55,624,2461,4456,46,80
2470,146,22,882,579,4099,236,917,39,601,2280,4073,46,81
1805,213,7,995,832,3852,241,873,120,685,1838,3757,46,82
294,216,29,914,491,1944,74,677,97,356,798,2002,46,83
394,183,21,1386,487,2471,162,642,48,603,1081,2536,46,84
2048,172,7,1147,528,3902,250,722,42,699,2193,3906,46,85
2512,165,2,1238,660,4577,304,896,29,676,2604,4509,46,86
2290,128,7,889,458,3772,245,733,25,575,2229,3807,46,87
2169,183,0,1008,465,3825,210,800,21,636,2152,3819,46,88
1494,236,8,1144,702,3584,266,766,82,745,1649,3508,46,89
350,192,9,1732,739,3022,118,973,93,666,1230,3080,46,90
288,136,5,861,393,1683,116,520,23,514,687,1860,46,91
1959,137,4,1222,528,3850,250,938,30,576,2004,3798,46,92
2540,129,4,910,532,4115,247,766,35,565,2561,4174,46,93
2523,121,11,916,505,4076,265,901,40,528,2408,4142,46,94
2528,154,18,990,699,4389,315,1107,53,579,2350,4404,46,95
1868,220,12,1106,765,3971,288,848,94,670,1896,3796,46,96
596,196,14,1248,548,2602,130,813,106,614,946,2609,46,97
484,166,11,978,451,2090,101,689,30,559,817,2196,46,98
2027,146,6,777,449,3405,269,648,32,607,1909,3465,46,99
2489,212,14,781,553,4049,288,863,77,605,2371,4204,46,100
2505,157,11,879,485,4037,249,776,40,604,2394,4063,46,101
2498,161,10,728,437,3834,274,734,34,570,2183,3795,46,102
1870,217,7,837,576,3507,279,752,80,691,1695,3497,46,103
459,210,8,1269,762,2708,132,936,108,577,931,2684,46,104
318,155,2,1012,364,1851,94,514,26,546,844,2024,46,105
2068,131,14,751,550,3514,273,770,30,479,1949,3501,46,106
2604,135,12,776,433,3960,287,839,29,517,2401,4073,46,107
2614,120,9,816,532,4091,331,921,37,574,1994,3857,46,108
2454,156,2,744,540,3896,268,852,38,573,2168,3899,46,109
1802,205,17,783,740,3547,329,791,84,625,1692,3521,46,110
395,228,7,1593,678,2901,143,1182,96,499,1031,2951,46,111
290,139,12,878,274,1593,89,522,25,435,695,1766,46,112
2079,136,14,739,394,3362,238,585,42,525,1999,3389,46,113
2606,144,1,754,607,4112,290,920,31,526,2368,4135,46,114
2539,158,7,773,643,4120,271,961,29,601,2360,4222,46,115
2676,148,5,866,563,4258,256,898,26,777,2228,4185,46,116
1820,224,32,832,842,3750,297,893,117,655,1708,3670,46,117
402,192,10,944,551,2099,133,649,145,535,733,2195,46,118
291,175,10,881,453,1810,88,653,31,518,743,2033,46,119
2045,166,18,694,464,3387,269,664,41,506,1966,3446,46,120
2587,144,13,736,445,3925,267,779,36,593,2332,4007,46,121
2600,171,29,760,539,4099,268,788,47,568,2340,4011,46,122
2440,164,14,776,527,3921,321,804,57,561,2210,3953,46,123
1793,226,8,830,792,3649,283,920,91,672,1701,3667,46,124
401,192,15,1053,518,2179,131,799,90,494,749,2263,46,125
278,169,5,796,325,1573,95,645,32,383,574,1729,46,126
2137,149,19,685,421,3411,241,640,45,515,2049,3490,46,127
2675,169,10,758,575,4187,294,951,33,614,2352,4244,46,128
2577,166,27,695,687,4152,256,1008,50,582,2316,4212,46,129
2335,161,17,781,555,3849,249,779,44,604,2191,3867,46,130
1765,175,12,717,587,3256,281,675,64,556,1671,3247,46,131
464,194,8,1077,437,2180,116,577,74,616,880,2263,46,132
243,182,16,760,329,1530,109,491,45,466,565,1676,46,133
2110,169,7,690,444,3420,242,704,31,490,2040,3507,46,134
2612,200,35,698,484,4029,272,770,62,625,2426,4155,46,135
2523,174,11,681,532,3921,285,871,25,500,2266,3947,46,136
2430,184,5,781,565,3965,300,865,47,569,2172,3953,46,137
1791,216,5,764,669,3445,310,735,77,670,1683,3475,46,138
361,201,10,842,474,1888,160,623,98,435,692,2008,46,139
351,178,9,887,378,1803,98,549,29,499,691,1866,46,140
2081,155,4,725,518,3483,279,740,25,535,2021,3600,46,141
2646,177,1,792,537,4153,290,922,27,611,2399,4249,46,142
2574,162,9,873,539,4157,275,828,35,596,2467,4201,46,143
2326,177,33,778,502,3816,298,764,62,590,2148,3862,46,144
1411,219,21,844,784,3279,282,937,99,731,1290,3339,46,145
436,259,12,1102,679,2488,121,968,115,529,770,2503,46,146
385,266,2,1116,427,2196,131,688,52,590,892,2353,46,147
331,135,8,871,275,1620,101,429,39,529,721,1819,46,148
2549,139,2,766,447,3903,296,724,23,624,2304,3971,46,149
2672,147,17,797,447,4080,361,680,45,599,2469,4154,46,150
2478,165,3,876,550,4072,277,856,35,644,2244,4056,46,151
1848,281,2,843,624,3598,284,816,70,718,1668,3556,46,152
434,267,10,931,576,2218,146,743,90,564,805,2348,46,153
313,182,5,815,368,1683,128,551,23,510,668,1880,46,154
2247,197,3,790,572,3809,318,820,33,596,2128,3895,46,155
2848,145,3,808,601,4405,348,887,33,686,2530,4484,46,156
2716,130,2,852,486,4186,298,875,28,575,2454,4230,46,157
2604,196,6,904,837,4547,290,1111,55,636,2414,4506,46,158
1957,305,4,902,1001,4169,297,1195,135,714,1721,4062,46,159
458,273,25,1724,921,3401,121,1586,151,585,1023,3466,46,160
355,218,15,1274,492,2354,140,728,54,576,1027,2525,46,161
2279,167,10,828,510,3794,301,735,35,585,2184,3840,46,162
2791,187,3,892,558,4431,377,885,34,631,2592,4519,46,163
2754,217,11,866,639,4487,291,948,87,628,2586,4540,46,164
2602,219,8,814,621,4264,299,929,42,608,2334,4212,46,165
1897,269,16,900,801,3883,314,944,119,684,1815,3876,46,166
470,254,12,1074,654,2464,160,955,98,560,774,2547,46,167
345,161,9,890,356,1761,116,514,35,489,746,1900,46,168
2136,166,8,770,474,3554,273,711,31,552,2096,3663,46,169
2657,215,6,880,657,4415,258,970,64,723,2404,4419,46,170
862,182,13,954,613,2624,227,806,44,585,929,2591,46,171
2277,219,5,953,542,3996,283,976,46,486,1978,3769,46,172
1783,253,14,838,601,3489,259,772,109,713,1699,3552,46,173
414,310,27,997,583,2331,138,856,139,541,764,2438,46,174
327,159,17,777,398,1678,137,592,107,505,612,1953,46,175
2129,160,2,761,453,3505,262,694,35,541,2073,3605,46,176
2746,153,4,816,501,4220,303,841,31,658,2433,4266,46,177
2683,178,3,827,488,4179,313,864,36,570,2381,4164,46,178
2546,184,5,932,542,4209,289,858,58,623,2366,4194,46,179
1864,270,5,936,622,3697,303,775,86,669,1809,3642,46,180
441,256,26,956,556,2235,128,766,92,561,736,2283,46,181
314,155,14,775,308,1566,94,498,33,437,644,1706,46,182
2188,148,2,895,621,3854,268,816,29,675,2127,3915,46,183
2512,176,2,830,605,4125,279,907,38,580,2318,4122,46,184
2157,274,12,954,940,4337,304,1117,81,876,1865,4243,46,185
497,1311,48,1533,1426,4815,153,2766,131,856,883,4789,46,186
1039,200,6,984,638,2867,234,781,72,600,1155,2842,46,187
423,230,26,945,473,2097,149,714,67,591,726,2247,46,188
312,170,3,806,310,1601,136,527,33,474,665,1835,46,189
2067,179,5,710,415,3376,259,773,29,513,1964,3538,46,190
2489,166,10,849,414,3928,296,858,38,599,2302,4093,46,191
2506,169,11,799,458,3943,271,821,36,582,2236,3946,46,192
2331,199,8,895,513,3946,258,834,39,549,2259,3939,46,193
1774,242,11,805,647,3479,245,818,92,607,1657,3419,46,194
363,277,12,1092,783,2527,126,1038,100,542,725,2531,46,195
345,161,8,773,345,1632,112,506,32,493,631,1774,46,196
2109,183,4,716,375,3387,231,825,48,505,1760,3369,46,197
2526,167,15,732,503,3943,236,926,34,541,2294,4031,46,198
2557,199,7,790,405,3958,262,740,29,575,2401,4007,46,199
2409,213,8,891,541,4062,249,899,53,534,2251,3986,46,200
1805,261,11,847,837,3761,267,952,202,658,1631,3710,46,201
406,237,10,985,833,2471,100,1084,109,586,721,2600,46,202
328,183,8,935,361,1815,115,570,40,478,811,2014,46,203
2111,146,15,788,437,3497,238,745,53,555,1989,3580,46,204
2659,154,12,894,557,4276,256,898,36,617,2564,4371,46,205
2489,197,11,880,629,4206,293,969,41,602,2370,4275,46,206
2390,224,14,971,479,4078,243,825,46,584,2403,4101,46,207
1772,249,5,980,597,3603,252,791,107,692,1792,3634,46,208
406,234,23,1081,714,2458,103,818,190,694,755,2560,46,209
309,181,9,685,383,1567,108,605,53,439,558,1763,46,210
2116,216,17,807,666,3822,246,891,136,606,1991,3870,46,211
2630,161,3,872,423,4089,311,772,44,628,2441,4196,46,212
2544,169,10,827,450,4000,255,792,38,580,2318,3983,46,213
2375,173,4,843,596,3991,246,858,32,610,2236,3982,46,214
1786,246,7,902,861,3802,262,1013,137,642,1638,3692,46,215
435,192,9,1211,497,2344,96,919,88,481,880,2464,46,216
336,177,6,871,335,1725,91,543,30,512,704,1880,46,217
2057,157,3,806,455,3478,242,774,25,505,1941,3487,46,218
2446,122,6,859,601,4034,257,917,37,577,2276,4064,46,219
2431,168,14,813,477,3903,223,796,38,624,2249,3930,46,220
2149,172,6,853,503,3683,242,730,66,497,2160,3695,46,221
1492,203,6,648,587,2936,216,718,148,485,1332,2899,46,222
388,196,8,899,611,2102,124,747,102,518,687,2178,46,223
304,181,1,857,383,1726,112,572,23,481,694,1882,46,224
2076,118,9,736,447,3386,247,648,31,568,1988,3482,46,225
2468,173,21,816,466,3944,266,724,55,584,2288,3917,46,226
2415,135,5,836,433,3824,241,702,35,556,2199,3733,46,227
2285,176,6,772,450,3689,269,787,45,556,1996,3653,46,228
1734,196,4,787,594,3315,277,705,80,638,1512,3212,46,229
407,241,22,891,453,2014,98,656,93,496,709,2052,46,230
307,131,13,827,334,1612,101,516,36,442,658,1753,46,231
2009,177,29,728,402,3345,232,671,58,546,1919,3426,46,232
2549,183,17,721,518,3988,253,858,48,551,2327,4037,46,233
2489,174,4,776,534,3977,278,827,68,545,2285,4003,46,234
2259,162,20,898,477,3816,263,775,42,537,2225,3842,46,235
1723,183,6,748,697,3357,261,775,82,558,1584,3260,46,236
451,185,4,1072,573,2285,106,784,91,592,841,2414,46,237
283,145,6,767,291,1492,95,543,39,428,562,1667,46,238
2145,119,6,705,566,3541,233,792,25,543,2036,3629,46,239
2546,138,19,704,600,4007,252,978,51,521,2244,4046,46,240
2471,132,11,772,597,3983,250,940,37,567,2184,3978,46,241
2303,164,7,752,535,3761,234,748,43,580,2059,3664,46,242
1414,191,11,826,664,3106,218,737,99,686,1288,3028,46,243
391,184,6,1027,542,2150,130,779,70,448,750,2177,46,244
283,189,5,1001,358,1836,103,627,34,412,777,1953,46,245
297,123,1,756,290,1467,107,479,12,471,620,1689,46,246
2512,157,0,739,451,3859,265,740,21,580,2337,3943,46,247
2640,139,2,768,480,4029,253,789,27,572,2408,4049,46,248
2465,189,4,745,515,3918,267,811,39,533,2266,3916,46,249
1837,211,8,772,551,3379,250,717,78,579,1691,3315,46,250
360,189,14,983,649,2195,111,692,196,559,743,2301,46,251
280,179,7,722,330,1518,110,532,39,436,555,1672,46,252
2252,148,29,738,413,3580,236,741,57,475,2050,3559,46,253
2774,143,24,737,494,4172,273,863,55,560,2447,4198,46,254
2721,154,20,793,535,4223,263,920,38,525,2425,4171,46,255
2580,154,11,789,624,4158,261,892,42,574,2329,4098,46,256
1918,213,2,765,767,3665,257,848,100,626,1746,3577,46,257
432,192,15,1207,649,2495,121,872,112,628,810,2543,46,258
284,157,3,933,416,1793,92,566,36,507,817,2018,46,259
2165,125,6,777,468,3541,235,702,28,579,2007,3551,46,260
2761,138,11,769,425,4104,283,787,36,548,2490,4144,46,261
2669,144,3,747,476,4039,221,915,29,592,2204,3961,46,262
2570,126,2,801,675,4174,271,1027,32,613,2233,4176,46,263
1868,249,11,791,636,3555,295,766,124,576,1728,3489,46,264
401,175,11,1119,577,2283,120,892,143,512,759,2426,46,265
270,133,13,771,328,1515,99,515,43,435,712,1804,46,266
2268,144,7,690,419,3528,257,676,72,559,2041,3605,46,267
2748,127,10,735,535,4155,294,897,40,593,2420,4244,46,268
2772,165,12,796,577,4322,284,954,44,590,2434,4306,46,269
2557,182,9,935,587,4270,270,983,65,641,2227,4186,46,270
1911,191,14,763,709,3588,279,913,76,599,1719,3586,46,271
449,245,10,1264,715,2683,133,1125,101,525,835,2719,46,272
277,140,5,937,366,1725,90,584,34,400,810,1918,46,273
2144,134,5,720,413,3416,228,688,43,570,2047,3576,46,274
2763,123,4,738,457,4085,257,776,37,518,2502,4090,46,275
2700,155,2,837,487,4181,236,837,31,605,2467,4176,46,276
2436,184,13,900,559,4092,263,802,54,684,2230,4033,46,277
1783,232,1,853,607,3476,254,776,83,668,1694,3475,46,278
379,199,8,1037,551,2174,107,734,101,517,804,2263,46,279
283,144,7,863,317,1614,109,489,49,473,736,1856,46,280
2218,137,3,733,484,3575,263,768,33,599,2059,3722,46,281
2824,151,5,841,526,4347,282,846,31,673,2602,4434,46,282
2719,188,7,859,494,4267,265,847,51,649,2479,4291,46,283
2525,178,3,838,623,4167,285,904,44,567,2377,4177,46,284
1635,237,6,937,673,3488,296,796,74,730,1539,3435,46,285
506,243,19,1343,659,2770,138,939,134,636,982,2829,46,286
636,169,8,905,446,2164,140,668,53,821,770,2452,46,287
914,135,12,944,498,2503,243,590,34,567,1197,2631,46,288
2894,130,17,889,591,4521,292,964,40,653,2584,4533,46,289
2807,164,22,783,484,4260,267,838,48,571,2590,4314,46,290
2575,192,16,874,643,4300,267,973,53,680,2348,4321,46,291
1926,214,15,875,670,3700,295,809,62,645,1766,3577,46,292
432,229,16,1017,585,2279,136,733,163,576,787,2395,46,293
285,175,8,827,394,1689,108,651,48,479,611,1897,46,294
2219,150,10,747,507,3633,259,744,42,530,2119,3694,46,295
2759,161,11,825,474,4230,322,868,43,590,2540,4363,46,296
2714,200,13,846,705,4478,254,986,51,605,2626,4522,46,297
2528,162,17,825,614,4146,274,914,57,599,2329,4173,46,298
1825,242,14,822,678,3581,257,780,105,642,1813,3597,46,299
415,211,22,1020,694,2362,112,705,147,602,914,2480,46,300
1013,145,12,1041,419,2630,148,634,49,915,947,2693,46,301
2131,129,13,760,442,3475,248,694,45,529,2099,3615,46,302
2687,176,7,882,929,4681,269,1279,45,653,2456,4702,46,303
2703,168,12,867,494,4244,258,947,42,545,2566,4358,46,304
2351,178,2,754,632,3917,255,737,34,685,2245,3956,46,305
1702,213,7,814,588,3324,219,725,74,610,1642,3270,46,306
404,214,7,1035,717,2377,130,867,109,557,814,2477,46,307
296,129,2,678,344,1449,107,457,28,466,596,1654,46,308
2164,134,8,764,472,3542,260,654,40,626,2078,3658,46,309
2286,136,1,778,402,3603,265,535,71,663,2101,3635,46,310
2318,105,10,698,522,3653,246,736,42,488,2177,3689,46,311
2483,204,31,739,494,3951,270,835,76,531,2237,3949,46,312
1628,200,13,763,741,3345,275,787,102,670,1492,3326,46,313
395,168,12,936,448,1959,123,558,65,555,807,2108,46,314
264,122,10,814,289,1499,94,445,33,403,767,1742,46,315
860,110,1,784,385,2140,219,514,33,567,991,2324,46,316
2760,113,18,745,472,4108,270,780,55,565,2564,4234,46,317
2762,149,7,799,592,4309,263,873,38,565,2530,4269,46,318
2553,150,10,733,462,3908,261,797,56,540,2274,3928,46,319
1871,179,8,775,583,3416,263,703,79,644,1720,3409,46,320
400,183,4,1011,441,2039,94,532,98,535,901,2160,46,321
245,110,6,685,389,1435,77,489,29,391,591,1577,46,322
2226,124,3,675,461,3489,241,665,40,566,2068,3580,46,323
2853,130,5,757,456,4201,273,724,47,564,2585,4193,46,324
2736,135,9,751,447,4078,265,755,38,561,2500,4119,46,325
2566,145,5,719,607,4042,258,868,52,569,2292,4039,46,326
1812,179,10,645,579,3225,236,693,77,604,1594,3204,46,327
333,179,12,957,689,2170,113,819,89,461,730,2212,46,328
266,93,13,733,286,1391,92,402,38,369,655,1556,46,329
2042,130,0,784,420,3376,251,628,40,574,1915,3408,46,330
2173,158,10,886,565,3792,254,713,31,637,2083,3718,46,331
1416,157,2,864,541,2980,221,563,21,888,1212,2905,46,332
198,119,1,385,161,864,60,176,25,383,365,1009,46,333
661,126,5,1108,454,2354,151,552,49,567,1088,2407,46,334
268,150,8,862,425,1713,88,518,76,443,789,1914,46,335
247,93,15,678,357,1390,91,487,31,388,586,1583,46,336
2080,119,12,698,402,3311,256,586,30,568,1946,3386,46,337
2732,131,7,669,558,4097,263,857,22,514,2507,4163,46,338
2610,115,8,697,448,3878,221,775,30,493,2356,3875,46,339
2445,110,1,629,577,3762,239,856,32,471,2168,3766,46,340
1802,182,3,693,533,3213,240,666,72,566,1573,3117,46,341
359,194,19,1010,710,2292,113,863,120,505,803,2404,46,342
256,118,9,795,388,1566,86,521,38,455,668,1768,46,343
2151,118,13,707,428,3417,228,635,50,478,2052,3443,46,344
2784,152,9,793,448,4186,275,835,25,542,2607,4284,46,345
2767,116,4,756,431,4074,246,847,28,518,2383,4022,46,346
2603,161,1,809,656,4230,248,1014,52,626,2228,4168,46,347
1804,191,4,793,641,3433,231,781,89,609,1682,3392,46,348
514,166,5,1126,683,2494,111,942,95,681,830,2659,46,349
232,134,3,682,392,1443,68,550,34,410,552,1614,46,350
2128,125,11,650,383,3297,233,598,34,468,2048,3381,46,351
2610,121,6,778,585,4100,243,792,63,554,2491,4143,46,352
2448,145,4,745,518,3860,226,794,44,502,2267,3833,46,353
2244,155,2,786,524,3711,230,785,32,637,2043,3727,46,354
1541,171,6,737,748,3203,224,771,80,644,1405,3124,46,355
306,154,7,951,431,1849,83,543,79,468,722,1895,46,356
235,107,9,840,476,1667,83,645,23,401,691,1843,46,357
1263,153,6,1030,512,2964,201,684,26,669,1331,2911,46,358
565,102,3,590,274,1534,155,320,16,479,564,1534,46,359
121,62,3,277,136,599,49,189,15,232,168,653,46,360
847,103,3,830,503,2286,156,628,31,474,1023,2312,46,361
932,118,4,948,489,2491,185,585,37,572,1147,2526,46,362
283,131,5,813,361,1593,93,572,65,418,678,1826,46,363
262,130,11,910,319,1632,102,457,50,440,770,1819,46,364
1246,129,3,958,586,2922,189,685,25,652,1469,3020,46,365
1064,439,101,857,417,2878,189,485,278,685,1249,2886,46,366
175,154,4,393,413,1139,81,272,20,356,442,1171,47,1
987,305,5,739,655,2691,231,469,24,758,1235,2717,47,2
1179,265,6,727,711,2888,287,524,23,640,1390,2864,47,3
1216,286,5,665,742,2914,297,501,28,646,1437,2909,47,4
964,279,8,693,689,2633,246,555,78,631,1182,2692,47,5
304,213,16,520,360,1413,105,378,82,437,424,1426,47,6
240,203,6,645,458,1552,80,396,46,584,554,1660,47,7
1173,250,3,641,622,2689,301,503,28,579,1343,2754,47,8
1281,149,5,588,431,2454,261,422,26,587,1120,2416,47,9
1410,262,12,794,651,3129,305,538,41,690,1525,3099,47,10
1343,300,4,790,779,3216,299,627,43,637,1509,3115,47,11
1101,276,11,768,715,2871,298,508,62,723,1264,2855,47,12
322,312,15,917,643,2209,121,534,77,623,860,2215,47,13
229,188,6,606,414,1443,81,393,23,444,560,1501,47,14
449,220,11,630,412,1722,175,394,35,503,583,1690,47,15
699,197,7,522,480,1905,197,430,22,476,676,1801,47,16
1100,228,4,773,557,2662,233,491,33,576,1347,2680,47,17
1317,254,8,735,671,2985,290,619,38,575,1446,2968,47,18
678,259,28,569,496,2030,202,494,88,476,724,1984,47,19
328,257,15,730,574,1904,109,479,94,564,616,1862,47,20
234,151,7,595,435,1422,72,394,16,433,499,1414,47,21
1128,261,4,711,563,2667,252,513,27,595,1307,2694,47,22
1408,283,7,714,698,3110,298,680,27,593,1529,3127,47,23
1438,252,17,785,746,3238,294,653,44,607,1579,3177,47,24
1341,262,40,785,712,3140,310,668,71,569,1405,3023,47,25
1072,386,19,888,960,3325,337,637,87,750,1388,3199,47,26
380,370,24,912,748,2434,140,534,106,715,870,2365,47,27
249,188,6,614,433,1490,85,421,33,450,569,1558,47,28
1204,246,4,702,611,2767,284,537,30,586,1324,2761,47,29
1388,225,8,709,661,2991,311,651,30,618,1527,3137,47,30
1420,255,10,794,702,3181,326,646,40,669,1515,3196,47,31
1357,303,6,770,807,3243,333,658,42,702,1535,3270,47,32
1119,371,19,845,863,3217,296,648,104,733,1325,3106,47,33
366,383,19,894,727,2389,104,535,111,750,851,2351,47,34
255,204,12,667,530,1668,83,433,34,572,627,1749,47,35
1189,262,4,723,653,2831,272,529,21,651,1427,2900,47,36
1435,271,5,747,688,3146,320,679,31,576,1590,3196,47,37
1420,291,9,749,737,3206,328,707,34,613,1505,3187,47,38
1425,332,5,808,756,3326,318,655,40,687,1602,3302,47,39
1137,423,17,894,860,3331,306,641,118,755,1400,3220,47,40
372,371,11,968,820,2542,101,594,118,758,907,2478,47,41
264,241,10,653,555,1723,75,418,32,577,716,1818,47,42
1207,244,8,726,711,2896,292,527,27,627,1466,2939,47,43
1336,329,7,763,728,3163,291,698,26,654,1580,3249,47,44
1469,371,17,880,844,3581,320,684,74,770,1681,3529,47,45
1364,279,12,824,770,3249,340,670,48,663,1586,3307,47,46
1105,382,24,827,834,3172,297,623,104,722,1370,3116,47,47
345,347,12,785,643,2132,110,521,90,656,744,2121,47,48
245,212,9,694,583,1743,78,451,57,549,683,1818,47,49
624,291,15,756,650,2336,197,483,32,675,958,2345,47,50
1401,268,8,789,712,3178,283,627,20,655,1533,3118,47,51
1485,318,10,831,744,3388,328,626,45,664,1667,3330,47,52
1427,330,12,784,779,3332,327,703,52,661,1598,3341,47,53
1140,395,27,856,828,3246,289,644,102,787,1382,3204,47,54
390,344,20,888,742,2384,116,562,108,707,849,2342,47,55
281,219,8,686,573,1767,81,477,36,556,684,1834,47,56
1300,297,4,718,699,3018,337,607,30,586,1477,3037,47,57
1522,259,24,806,700,3311,354,637,45,710,1611,3357,47,58
1463,302,14,778,677,3234,333,624,40,636,1618,3251,47,59
1478,318,4,823,786,3409,330,675,23,698,1569,3295,47,60
1195,399,15,899,898,3406,352,658,97,820,1473,3400,47,61
346,382,17,733,759,2237,109,576,109,650,883,2327,47,62
299,204,7,757,596,1863,92,450,43,686,683,1954,47,63
1325,310,4,800,701,3140,333,605,21,644,1474,3077,47,64
1421,308,8,732,741,3210,313,655,30,601,1647,3246,47,65
1445,307,14,763,720,3249,346,622,59,712,1494,3233,47,66
1390,376,7,848,788,3409,372,686,57,668,1701,3484,47,67
1219,407,19,934,896,3475,349,655,114,788,1504,3410,47,68
388,330,14,824,545,2101,124,516,102,620,742,2104,47,69
291,239,3,637,518,1688,85,497,20,559,672,1833,47,70
1211,319,5,737,638,2910,307,611,32,607,1452,3009,47,71
1472,376,17,806,794,3465,342,808,42,661,1698,3551,47,72
1506,358,13,922,787,3586,329,805,49,816,1669,3668,47,73
1382,438,14,935,879,3648,327,805,46,711,1599,3488,47,74
1145,447,16,917,913,3438,320,688,127,794,1438,3367,47,75
474,483,20,1163,877,3017,150,765,132,828,1090,2965,47,76
336,312,10,778,650,2086,102,624,58,593,744,2121,47,77
1356,317,14,886,750,3323,312,664,32,730,1523,3261,47,78
1552,314,8,872,806,3552,316,768,35,673,1762,3554,47,79
1581,382,6,913,871,3753,346,868,38,726,1767,3745,47,80
1491,311,17,893,795,3507,358,849,60,694,1603,3564,47,81
1309,391,11,926,872,3509,355,782,113,718,1499,3467,47,82
383,390,13,738,685,2209,116,700,104,525,787,2232,47,83
357,247,10,992,623,2229,114,636,36,655,838,2279,47,84
1333,332,5,887,690,3247,307,650,33,649,1621,3260,47,85
1440,370,21,856,735,3422,285,757,43,665,1712,3462,47,86
1438,330,10,756,629,3163,291,698,32,635,1500,3156,47,87
1366,349,11,825,695,3246,305,761,50,654,1535,3305,47,88
1050,499,9,974,862,3394,275,771,117,714,1526,3403,47,89
467,422,20,1243,759,2911,115,744,124,853,1137,2973,47,90
305,200,34,836,556,1931,77,556,67,467,794,1961,47,91
1191,308,19,810,673,3001,254,636,42,614,1425,2971,47,92
1434,274,12,712,614,3046,285,628,37,601,1591,3142,47,93
1468,268,7,722,624,3089,309,723,41,603,1454,3130,47,94
1503,318,9,866,707,3403,333,737,42,677,1642,3431,47,95
1132,364,18,873,839,3226,285,697,115,747,1399,3243,47,96
483,362,16,978,692,2531,113,648,91,700,901,2453,47,97
365,225,3,811,504,1908,96,555,31,611,710,2003,47,98
1293,274,10,767,572,2916,298,556,41,581,1433,2909,47,99
1452,316,7,762,712,3249,305,695,47,634,1722,3403,47,100
1511,272,5,841,731,3360,282,723,39,658,1609,3311,47,101
1427,292,6,840,660,3225,329,637,41,582,1599,3188,47,102
1297,374,15,804,754,3244,308,717,120,640,1349,3134,47,103
465,459,28,945,718,2615,120,699,109,749,927,2604,47,104
329,238,3,806,581,1957,84,570,43,652,730,2079,47,105
1176,284,2,818,633,2913,322,584,38,659,1384,2987,47,106
1306,345,10,785,728,3174,318,712,36,668,1483,3217,47,107
1381,331,8,832,714,3266,301,711,39,680,1439,3170,47,108
1362,345,7,819,765,3298,284,745,41,675,1504,3249,47,109
1147,346,14,809,775,3091,290,648,128,634,1302,3002,47,110
423,424,21,1045,823,2736,114,788,156,642,1030,2730,47,111
328,218,8,659,446,1659,89,489,35,490,642,1745,47,112
1319,273,2,702,618,2914,293,576,23,589,1480,2961,47,113
1483,274,6,748,717,3228,275,741,30,617,1666,3329,47,114
1475,360,13,795,693,3336,278,722,40,625,1642,3307,47,115
1509,291,4,769,710,3283,315,732,43,636,1612,3338,47,116
1230,391,18,854,836,3329,310,726,108,643,1444,3231,47,117
429,326,17,818,562,2152,118,590,110,658,762,2238,47,118
356,212,3,737,548,1856,103,561,48,539,693,1944,47,119
1309,272,13,682,594,2870,299,603,46,538,1488,2974,47,120
1485,284,16,729,697,3211,304,673,58,632,1607,3274,47,121
1575,316,3,901,804,3599,368,756,39,737,1694,3594,47,122
1432,329,4,830,744,3339,321,717,47,622,1670,3377,47,123
1263,409,20,885,782,3359,287,758,102,725,1414,3286,47,124
400,324,13,873,597,2207,102,580,87,692,780,2241,47,125
314,220,2,681,517,1734,78,545,40,512,560,1735,47,126
1378,283,6,712,602,2981,284,569,28,608,1493,2982,47,127
1489,315,6,791,808,3409,325,782,42,591,1667,3407,47,128
1552,346,5,849,755,3507,321,759,46,735,1667,3528,47,129
1471,341,7,902,761,3482,339,740,37,714,1689,3519,47,130
1264,323,17,753,754,3111,286,622,109,707,1428,3152,47,131
491,342,21,946,695,2495,106,524,85,798,933,2446,47,132
323,206,11,703,475,1718,108,489,28,598,621,1844,47,133
1352,294,26,758,646,3076,330,585,52,633,1565,3165,47,134
1514,248,18,815,633,3228,306,660,45,650,1580,3241,47,135
1576,331,15,856,872,3650,430,695,72,692,1702,3591,47,136
1439,361,7,867,792,3466,325,751,55,661,1740,3532,47,137
1271,345,20,896,803,3335,316,669,107,765,1513,3370,47,138
368,312,16,821,555,2072,103,575,109,614,731,2132,47,139
345,239,4,769,528,1885,94,552,32,584,641,1903,47,140
1322,326,8,774,631,3061,306,618,31,582,1479,3016,47,141
1546,307,8,852,768,3481,296,775,37,553,1663,3324,47,142
1609,316,10,782,707,3424,324,742,39,667,1637,3409,47,143
1454,298,11,775,708,3246,311,714,38,597,1616,3276,47,144
1164,480,14,887,836,3381,323,765,120,788,1299,3295,47,145
405,401,8,863,718,2395,116,679,109,700,819,2423,47,146
345,303,4,758,515,1925,96,637,43,544,705,2025,47,147
369,239,4,604,446,1662,109,378,26,567,662,1742,47,148
1492,303,13,853,740,3401,320,685,39,708,1631,3383,47,149
1501,285,8,820,660,3274,355,646,26,680,1653,3360,47,150
1583,358,6,792,751,3490,362,773,38,631,1692,3496,47,151
1326,399,24,900,749,3398,309,678,107,767,1549,3410,47,152
452,422,14,948,709,2545,138,569,138,859,911,2615,47,153
299,224,4,728,527,1782,92,508,35,559,674,1868,47,154
1449,339,10,819,727,3344,324,731,32,675,1632,3394,47,155
1546,310,6,905,829,3596,336,775,25,719,1734,3589,47,156
1690,310,7,772,636,3415,337,767,38,630,1708,3480,47,157
1645,335,10,865,818,3673,334,864,50,695,1745,3688,47,158
1352,463,18,935,872,3640,290,789,142,768,1589,3578,47,159
491,479,27,1195,876,3068,153,980,174,756,1011,3074,47,160
368,279,4,857,564,2072,112,590,36,602,816,2156,47,161
1463,298,8,839,728,3336,362,714,21,699,1637,3433,47,162
1681,368,2,984,727,3762,304,803,30,751,1885,3773,47,163
1665,350,4,888,737,3644,312,841,61,756,1800,3770,47,164
1558,357,1,927,721,3564,326,794,34,753,1685,3592,47,165
1261,387,15,867,810,3340,273,807,97,756,1456,3389,47,166
435,430,10,962,652,2489,129,707,87,734,879,2536,47,167
337,273,7,756,509,1882,90,511,34,553,696,1884,47,168
1324,318,3,741,635,3021,304,647,24,643,1467,3085,47,169
1475,351,12,793,679,3310,277,722,70,731,1552,3352,47,170
784,348,15,893,771,2811,223,728,50,689,1070,2760,47,171
1460,412,3,850,739,3464,315,818,33,707,1582,3455,47,172
1207,423,15,786,661,3092,261,755,111,667,1349,3143,47,173
435,458,17,851,661,2422,141,700,152,706,767,2466,47,174
329,261,4,625,505,1724,90,545,59,526,554,1774,47,175
1363,319,4,757,603,3046,294,624,31,668,1536,3153,47,176
1556,309,7,749,642,3263,282,720,41,661,1699,3403,47,177
1588,292,7,803,669,3359,296,723,36,693,1643,3391,47,178
1467,331,11,839,735,3383,295,799,53,692,1683,3522,47,179
1240,414,12,802,786,3254,266,697,104,701,1413,3181,47,180
460,386,21,891,676,2434,127,625,116,698,889,2455,47,181
304,223,5,634,435,1601,95,489,43,468,631,1726,47,182
1278,307,7,763,653,3008,254,645,30,645,1502,3076,47,183
1411,307,7,800,746,3271,306,728,47,681,1581,3343,47,184
1330,374,10,839,836,3389,313,721,56,819,1484,3393,47,185
396,902,28,795,890,3011,135,1359,77,613,672,2856,47,186
806,349,12,830,635,2632,215,656,108,588,1074,2641,47,187
422,379,20,801,541,2163,127,575,98,575,791,2166,47,188
330,233,2,583,466,1614,93,487,36,495,621,1732,47,189
1248,258,5,747,574,2832,297,585,31,672,1373,2958,47,190
1350,304,6,740,629,3029,299,606,36,620,1461,3022,47,191
1385,259,5,759,664,3072,324,666,30,649,1451,3120,47,192
1332,362,8,804,666,3172,305,757,61,702,1400,3225,47,193
1148,382,12,771,739,3052,290,702,110,669,1280,3051,47,194
433,431,16,801,677,2358,131,710,102,642,792,2377,47,195
312,262,5,612,454,1645,108,464,50,478,655,1755,47,196
1257,308,5,694,569,2833,274,570,27,639,1410,2920,47,197
1472,298,5,716,648,3139,290,645,45,639,1536,3155,47,198
1526,275,16,768,605,3190,307,636,41,673,1562,3219,47,199
1438,349,4,788,741,3320,288,772,41,682,1517,3300,47,200
1070,373,9,703,657,2812,268,683,149,628,1239,2967,47,201
432,344,16,828,637,2257,155,607,98,622,795,2277,47,202
317,235,3,644,504,1703,96,473,26,535,634,1764,47,203
1213,245,7,642,516,2623,261,515,23,516,1282,2597,47,204
1407,333,10,786,660,3196,291,665,38,680,1618,3292,47,205
1416,305,13,786,701,3221,300,741,51,654,1529,3275,47,206
1399,339,4,806,666,3214,310,766,35,629,1569,3309,47,207
1145,383,23,829,766,3146,285,669,119,777,1362,3212,47,208
408,373,14,845,613,2253,127,619,155,659,806,2366,47,209
359,195,35,638,500,1727,146,481,86,462,637,1812,47,210
1256,254,10,753,625,2898,306,553,60,640,1400,2959,47,211
1377,292,34,701,586,2990,285,638,61,588,1525,3097,47,212
1446,283,11,741,595,3076,292,681,32,635,1499,3139,47,213
1349,352,11,764,709,3185,260,692,42,680,1529,3203,47,214
1110,404,16,832,781,3143,287,744,124,708,1294,3157,47,215
411,312,13,885,563,2184,123,524,93,653,908,2301,47,216
328,271,4,663,435,1701,90,501,21,530,693,1835,47,217
1151,306,9,729,628,2823,301,596,25,637,1383,2942,47,218
1366,321,11,778,687,3163,275,746,44,668,1544,3277,47,219
1351,271,17,766,724,3129,282,675,36,650,1521,3164,47,220
1277,306,12,765,577,2937,252,642,38,693,1359,2984,47,221
1004,361,12,609,686,2672,249,593,99,564,1188,2693,47,222
408,380,19,777,628,2212,137,566,86,661,881,2331,47,223
300,249,14,667,540,1770,96,459,26,537,701,1819,47,224
1143,306,5,713,563,2730,270,540,26,591,1352,2779,47,225
1335,296,5,749,666,3051,279,616,42,652,1547,3136,47,226
1327,332,3,774,647,3083,295,649,38,638,1507,3127,47,227
1281,408,10,738,701,3138,281,709,50,719,1490,3249,47,228
1110,467,28,829,789,3223,310,659,128,734,1405,3236,47,229
375,352,16,826,607,2176,118,540,86,681,864,2289,47,230
316,226,3,644,458,1647,81,462,20,585,668,1816,47,231
1224,285,12,774,608,2903,264,539,30,650,1434,2917,47,232
1386,387,0,923,690,3386,295,712,38,775,1651,3471,47,233
1377,303,20,819,703,3222,291,729,45,723,1566,3354,47,234
1346,427,10,849,653,3285,305,762,54,632,1577,3330,47,235
1083,439,20,844,764,3150,289,658,108,749,1352,3156,47,236
428,452,14,1062,802,2758,132,672,119,842,1042,2807,47,237
341,233,7,756,605,1942,69,500,31,708,735,2043,47,238
1344,267,6,742,676,3035,302,578,36,660,1459,3035,47,239
1537,341,6,826,728,3438,342,721,32,695,1733,3523,47,240
1471,305,24,782,634,3216,342,735,48,605,1560,3290,47,241
1473,267,6,773,626,3145,317,633,34,621,1559,3164,47,242
1139,390,28,833,800,3190,285,692,120,729,1340,3166,47,243
387,386,38,928,747,2486,112,604,102,734,982,2534,47,244
328,261,16,795,603,2003,107,537,44,635,760,2083,47,245
347,248,3,742,570,1910,101,445,22,650,770,1988,47,246
1541,286,10,815,643,3295,357,676,25,690,1675,3423,47,247
1588,299,10,862,737,3496,378,706,30,701,1717,3532,47,248
1553,324,7,804,714,3402,352,753,40,684,1720,3549,47,249
1207,413,7,853,798,3278,333,760,80,695,1461,3329,47,250
450,417,7,964,684,2522,132,690,103,737,870,2532,47,251
331,279,5,748,546,1909,105,536,22,578,778,2019,47,252
1394,303,5,763,673,3138,346,650,32,596,1572,3196,47,253
1588,327,5,864,645,3429,375,793,31,668,1654,3521,47,254
1648,310,7,843,702,3510,347,832,33,662,1686,3560,47,255
1583,346,6,847,730,3512,337,819,40,671,1674,3541,47,256
1314,393,10,872,864,3453,328,745,105,698,1583,3459,47,257
457,373,11,1038,865,2744,123,722,120,873,940,2778,47,258
356,246,4,751,514,1871,82,483,44,628,707,1944,47,259
1379,253,4,812,598,3046,306,594,26,647,1522,3095,47,260
1699,254,43,831,660,3487,339,740,55,659,1708,3501,47,261
1546,305,5,806,676,3338,355,799,50,647,1580,3431,47,262
1587,335,7,826,708,3463,350,882,44,686,1624,3586,47,263
1272,479,26,860,853,3490,310,689,182,704,1527,3412,47,264
434,411,20,1127,829,2821,149,867,126,745,978,2865,47,265
333,194,1,744,548,1820,85,536,21,589,702,1933,47,266
1354,225,5,717,580,2881,329,611,38,569,1404,2951,47,267
1640,270,6,812,629,3357,347,773,40,600,1686,3446,47,268
1607,251,6,844,690,3398,368,754,49,695,1642,3508,47,269
1573,331,6,893,814,3617,330,790,54,665,1756,3595,47,270
1288,351,15,818,814,3286,293,741,116,682,1411,3243,47,271
456,470,22,1088,827,2863,142,838,154,746,947,2827,47,272
326,235,9,805,501,1876,89,514,42,599,760,2004,47,273
1332,251,14,818,638,3053,335,642,46,626,1521,3170,47,274
1570,292,12,840,679,3393,367,754,43,689,1644,3497,47,275
1592,320,9,823,693,3437,351,794,45,681,1663,3534,47,276
1483,354,6,812,749,3404,311,766,51,668,1681,3477,47,277
1233,393,20,910,844,3400,308,700,118,726,1539,3391,47,278
420,443,10,1054,834,2761,152,683,118,817,1039,2809,47,279
374,236,3,761,604,1978,110,526,28,637,768,2069,47,280
1370,246,5,821,674,3116,356,683,26,663,1495,3223,47,281
1619,275,5,914,718,3531,402,813,46,668,1732,3661,47,282
1613,336,8,860,760,3577,352,821,51,651,1767,3642,47,283
1459,338,4,853,756,3410,346,750,41,677,1678,3492,47,284
1179,365,9,1020,855,3428,291,682,128,860,1440,3401,47,285
454,375,16,1054,837,2736,140,669,111,847,996,2763,47,286
360,270,2,835,624,2091,98,591,36,631,775,2131,47,287
837,319,5,849,683,2693,298,560,25,788,1098,2769,47,288
1553,286,8,835,716,3398,329,754,44,634,1779,3540,47,289
1592,315,10,848,734,3499,352,823,32,700,1723,3630,47,290
1485,419,5,882,810,3601,364,847,52,756,1693,3712,47,291
1285,439,24,1060,953,3761,309,959,135,760,1629,3792,47,292
464,521,21,1128,939,3073,145,911,170,974,1100,3300,47,293
339,218,23,889,578,2047,113,589,46,649,803,2200,47,294
1355,285,8,878,617,3143,346,606,52,684,1530,3218,47,295
1613,295,8,922,776,3614,411,789,38,702,1730,3670,47,296
1623,316,10,859,771,3579,377,829,53,678,1678,3615,47,297
1630,310,10,972,809,3731,420,832,62,697,1724,3735,47,298
1240,351,19,891,839,3340,331,728,123,729,1583,3494,47,299
485,375,20,1024,833,2737,132,591,137,903,993,2756,47,300
373,232,7,761,582,1955,104,482,35,650,834,2105,47,301
1313,231,7,818,659,3028,313,609,43,680,1535,3180,47,302
1581,315,9,877,853,3635,370,896,46,664,1736,3712,47,303
1675,338,5,870,786,3674,386,797,33,670,1863,3749,47,304
1493,465,14,801,826,3599,341,722,66,649,1708,3486,47,305
1213,458,25,937,817,3450,313,730,131,744,1504,3422,47,306
440,432,18,1021,907,2818,129,651,136,892,1023,2831,47,307
368,226,13,751,609,1967,139,510,33,701,795,2178,47,308
1302,265,9,765,757,3098,348,608,24,742,1450,3172,47,309
1372,307,13,888,772,3352,337,646,122,838,1484,3427,47,310
1465,267,7,813,765,3317,499,641,40,679,1614,3473,47,311
1480,264,20,867,778,3409,379,730,33,653,1628,3423,47,312
1269,344,20,859,894,3386,351,682,118,765,1528,3444,47,313
450,379,27,956,733,2545,143,586,124,771,955,2579,47,314
344,151,11,714,505,1725,107,439,37,566,659,1808,47,315
846,254,2,875,621,2598,302,527,29,773,1124,2755,47,316
1609,280,20,882,710,3501,389,735,51,698,1690,3563,47,317
1723,239,17,882,725,3586,387,679,49,720,1731,3566,47,318
1555,254,11,822,734,3376,339,691,44,659,1695,3428,47,319
1259,342,15,858,827,3301,330,690,107,728,1513,3368,47,320
430,360,12,1032,830,2664,141,536,122,838,1085,2722,47,321
328,189,3,795,492,1807,96,481,35,613,707,1932,47,322
1339,220,11,820,665,3055,354,579,45,673,1469,3120,47,323
1667,221,15,839,687,3429,374,659,53,668,1756,3510,47,324
1660,287,18,878,671,3514,355,702,46,654,1792,3549,47,325
1565,275,19,851,724,3434,380,729,36,692,1635,3472,47,326
1284,297,17,727,693,3018,332,660,88,664,1352,3096,47,327
429,361,16,1002,811,2619,154,580,127,842,923,2626,47,328
289,223,8,759,567,1846,103,471,36,579,743,1932,47,329
1298,244,5,826,737,3110,347,545,42,744,1500,3178,47,330
1306,323,6,898,797,3330,334,685,34,733,1564,3350,47,331
1003,322,8,884,743,2960,289,566,38,912,1149,2954,47,332
194,109,4,341,263,911,91,217,17,306,378,1009,47,333
531,271,10,881,653,2346,201,492,69,815,959,2536,47,334
365,252,13,756,603,1989,112,469,83,658,777,2099,47,335
267,154,6,605,474,1506,80,375,26,601,604,1686,47,336
1256,238,6,778,649,2927,345,579,33,684,1427,3068,47,337
1498,236,6,819,654,3213,353,712,36,630,1669,3400,47,338
1539,234,27,797,709,3306,339,685,53,658,1716,3451,47,339
1439,224,10,787,682,3142,310,697,46,601,1576,3230,47,340
1139,302,12,826,777,3056,301,621,101,669,1449,3141,47,341
422,339,14,906,804,2485,137,672,119,727,948,2603,47,342
315,179,4,764,578,1840,88,531,37,630,666,1952,47,343
1344,237,11,728,643,2963,305,626,45,569,1514,3059,47,344
1585,245,10,883,634,3357,334,707,38,662,1772,3513,47,345
1539,237,8,686,583,3053,312,705,43,552,1583,3195,47,346
1575,291,24,844,770,3504,332,811,65,710,1684,3602,47,347
1250,332,14,873,909,3378,295,730,111,721,1589,3446,47,348
454,350,12,946,861,2623,152,552,118,840,923,2585,47,349
299,185,5,635,553,1677,107,452,27,569,653,1808,47,350
1321,255,4,694,650,2924,289,532,35,636,1465,2957,47,351
1517,358,5,856,830,3566,335,733,37,754,1875,3734,47,352
1516,275,6,864,816,3477,354,718,36,760,1683,3551,47,353
1333,354,14,864,852,3417,303,697,46,764,1640,3450,47,354
1105,332,14,792,849,3092,295,624,91,826,1350,3186,47,355
383,287,21,847,791,2329,127,493,89,837,912,2458,47,356
281,199,2,637,523,1642,93,394,22,616,677,1802,47,357
877,315,5,850,765,2812,246,501,29,805,1362,2943,47,358
598,204,5,759,691,2257,221,308,14,889,855,2287,47,359
128,74,6,240,199,647,58,158,16,179,250,661,47,360
670,295,7,692,744,2408,199,508,27,646,1154,2534,47,361
749,338,5,750,787,2629,212,547,73,728,1248,2808,47,362
338,262,10,646,594,1850,115,472,83,569,649,1888,47,363
259,145,10,604,486,1504,69,369,40,564,626,1668,47,364
882,286,3,809,750,2730,264,493,38,724,1250,2769,47,365
833,365,61,852,723,2834,272,426,183,902,968,2751,47,366
31,22,0,105,81,239,13,95,4,200,116,428,48,1
294,24,0,137,140,595,107,113,1,130,264,615,48,2
318,50,1,161,221,751,123,181,7,131,330,772,48,3
310,46,0,150,205,711,113,134,6,129,313,695,48,4
214,53,0,169,164,600,83,127,14,133,229,586,48,5
44,46,2,142,107,341,26,116,12,77,97,328,48,6
37,30,0,231,106,404,18,163,6,105,131,423,48,7
274,31,0,148,182,635,105,129,5,104,289,632,48,8
333,25,2,128,138,626,111,112,5,129,295,652,48,9
367,27,0,168,227,789,128,167,2,122,381,800,48,10
365,35,2,160,243,805,118,180,9,136,345,788,48,11
225,50,1,142,162,580,81,131,14,108,185,519,48,12
68,58,0,237,110,473,23,158,19,127,146,473,48,13
35,19,0,109,84,247,16,87,4,83,107,297,48,14
61,16,1,98,85,261,37,72,2,81,94,286,48,15
124,21,0,110,90,345,53,97,4,66,134,354,48,16
291,37,0,151,158,637,100,134,8,98,273,613,48,17
347,27,0,121,194,689,110,128,8,116,340,702,48,18
108,39,1,119,124,391,48,114,15,76,116,369,48,19
48,62,0,209,119,438,20,141,23,122,128,434,48,20
48,20,6,123,82,279,16,123,12,104,91,346,48,21
267,40,0,118,187,612,109,133,7,107,270,626,48,22
377,43,2,142,159,723,102,166,9,106,330,713,48,23
393,35,0,152,210,790,116,169,17,111,384,797,48,24
355,36,0,171,189,751,110,145,8,128,350,741,48,25
228,65,1,156,211,661,79,177,36,132,250,674,48,26
72,50,1,288,128,539,23,145,29,149,213,559,48,27
46,24,0,159,84,313,14,115,3,91,105,328,48,28
314,27,0,140,162,643,119,135,12,82,320,668,48,29
409,34,1,159,173,776,139,145,14,107,372,777,48,30
383,37,0,171,208,799,112,209,11,97,347,776,48,31
367,36,0,173,161,737,117,159,5,96,368,745,48,32
240,57,0,165,181,643,85,140,14,111,254,604,48,33
52,42,1,231,114,440,15,140,17,103,159,434,48,34
52,27,0,181,106,366,18,111,5,109,127,370,48,35
304,37,3,156,181,681,115,135,8,106,312,676,48,36
417,34,0,161,211,823,128,150,7,115,388,788,48,37
407,52,0,153,205,817,127,217,7,119,373,843,48,38
407,45,1,165,180,798,132,141,1,118,379,771,48,39
237,66,0,204,193,700,89,159,27,129,273,677,48,40
65,58,0,257,150,530,28,197,22,122,153,522,48,41
39,37,1,150,102,329,16,112,10,85,139,362,48,42
292,38,0,196,148,674,99,141,5,120,272,637,48,43
339,38,0,199,208,784,112,202,7,111,366,798,48,44
402,34,2,154,182,774,110,160,12,109,366,757,48,45
332,38,0,165,195,730,114,178,5,121,309,727,48,46
226,46,1,189,208,670,88,179,32,129,233,661,48,47
50,44,0,187,150,431,31,155,20,128,124,458,48,48
45,26,3,253,105,432,19,141,9,172,141,482,48,49
97,30,3,167,131,428,50,111,6,116,146,429,48,50
389,46,0,191,189,815,118,167,7,140,383,815,48,51
417,28,4,175,209,833,122,170,10,107,400,809,48,52
401,33,1,173,185,793,139,192,10,150,360,851,48,53
271,45,0,179,203,698,94,167,21,157,255,694,48,54
77,37,0,270,127,511,29,160,28,134,163,514,48,55
53,18,0,184,118,373,22,154,6,124,133,439,48,56
313,24,2,172,185,696,109,166,7,114,329,725,48,57
449,34,0,174,157,814,123,188,8,142,446,907,48,58
454,30,0,164,177,825,129,167,10,135,381,822,48,59
386,45,0,194,188,813,117,187,14,122,361,801,48,60
227,74,0,189,252,742,93,223,49,119,268,752,48,61
68,68,2,218,160,516,32,171,33,119,163,518,48,62
68,25,1,228,94,416,25,167,9,125,134,460,48,63
315,35,5,163,161,679,101,163,14,120,316,714,48,64
430,46,0,178,213,867,119,188,10,135,410,862,48,65
433,45,0,191,178,847,139,189,7,145,429,909,48,66
425,37,1,214,225,902,118,206,17,143,398,882,48,67
269,76,0,219,219,783,89,201,32,158,266,746,48,68
78,53,1,253,206,591,23,210,28,201,165,627,48,69
62,31,0,238,126,457,31,151,16,140,180,518,48,70
306,44,0,207,193,750,107,199,11,166,288,771,48,71
425,58,1,241,225,950,140,211,11,147,443,952,48,72
423,55,3,239,240,960,145,229,13,166,446,999,48,73
422,54,0,268,269,1013,147,213,9,173,419,961,48,74
261,53,0,277,283,874,91,224,28,239,265,847,48,75
91,75,0,452,200,818,23,281,42,215,285,846,48,76
74,36,0,323,119,552,29,180,11,187,206,613,48,77
329,46,0,212,219,806,130,181,13,122,387,833,48,78
451,43,0,232,198,924,125,208,9,171,442,955,48,79
499,50,0,247,271,1067,142,256,14,155,480,1047,48,80
424,37,1,208,259,929,128,238,9,200,386,961,48,81
309,50,2,312,254,927,88,248,23,182,349,890,48,82
106,67,5,321,226,725,30,228,24,196,199,677,48,83
102,43,0,540,201,886,11,263,10,210,405,899,48,84
317,36,0,327,264,944,106,248,18,176,418,966,48,85
462,42,0,295,274,1073,134,200,20,211,484,1049,48,86
437,42,0,265,311,1055,135,216,21,244,427,1043,48,87
406,69,0,312,312,1099,115,240,19,287,442,1103,48,88
254,56,1,382,282,975,97,260,37,218,338,950,48,89
130,49,0,659,283,1121,37,386,35,258,458,1174,48,90
73,33,1,348,156,611,32,227,11,177,248,695,48,91
324,38,1,303,240,906,124,229,12,245,371,981,48,92
410,39,1,271,255,976,139,166,9,240,405,959,48,93
438,34,1,254,313,1040,152,221,10,253,408,1044,48,94
464,42,1,311,313,1131,135,226,12,245,455,1073,48,95
319,49,0,314,283,965,85,249,33,207,398,972,48,96
104,57,0,423,225,809,40,259,26,220,273,818,48,97
89,43,1,279,216,628,20,214,15,211,190,650,48,98
304,47,0,209,204,764,122,191,7,170,305,795,48,99
445,45,2,268,230,990,165,215,27,167,416,990,48,100
484,50,0,301,249,1084,129,236,14,173,477,1029,48,101
443,47,0,242,240,972,124,216,12,210,368,930,48,102
306,75,2,271,276,930,104,228,38,189,294,853,48,103
108,61,0,423,185,777,23,273,20,221,242,779,48,104
72,39,0,286,144,541,24,204,7,175,206,616,48,105
336,33,0,233,209,811,112,229,11,147,363,862,48,106
435,43,2,190,239,909,131,221,16,169,413,950,48,107
462,46,4,257,229,998,143,250,20,169,397,979,48,108
432,70,3,321,239,1065,127,225,13,174,420,959,48,109
332,50,2,246,294,924,113,230,30,221,296,890,48,110
84,66,1,503,213,867,24,419,52,138,224,857,48,111
60,48,0,231,160,499,18,145,4,170,169,506,48,112
314,42,2,205,188,751,118,185,9,181,325,818,48,113
469,52,0,225,260,1006,127,242,7,173,446,995,48,114
433,55,1,228,269,986,143,269,11,171,441,1035,48,115
429,52,1,238,240,960,127,227,17,160,383,914,48,116
277,67,9,265,310,928,111,269,42,159,270,851,48,117
79,50,0,319,174,622,30,214,38,176,201,659,48,118
63,41,1,288,158,551,20,175,49,168,177,589,48,119
321,37,1,202,196,757,123,177,9,173,334,816,48,120
450,48,2,192,216,908,142,204,11,157,419,933,48,121
429,44,0,200,213,886,141,215,12,167,384,919,48,122
412,55,2,237,268,974,127,202,23,187,362,901,48,123
266,80,3,276,239,864,106,194,28,210,310,848,48,124
90,57,0,280,187,614,47,197,22,212,217,695,48,125
76,47,0,275,138,536,12,191,10,182,175,570,48,126
319,48,6,214,187,774,116,157,20,173,334,800,48,127
464,35,1,235,278,1013,142,215,18,190,427,992,48,128
474,49,0,194,245,962,148,250,22,189,433,1042,48,129
417,50,1,260,222,950,129,241,12,188,375,945,48,130
274,48,1,242,219,784,108,196,25,161,282,772,48,131
149,70,0,301,121,641,34,165,22,177,261,659,48,132
58,42,0,272,159,531,23,192,5,194,183,597,48,133
319,42,0,195,193,749,112,180,12,117,314,735,48,134
458,37,0,207,230,932,145,171,6,184,442,948,48,135
448,56,1,191,266,962,135,252,10,191,385,973,48,136
483,46,1,267,217,1014,136,240,21,176,412,985,48,137
301,59,0,244,266,870,104,222,26,163,299,814,48,138
105,69,1,278,200,653,30,223,30,216,212,711,48,139
94,44,0,310,143,591,26,176,3,172,191,568,48,140
338,50,4,238,245,875,144,210,25,185,357,921,48,141
486,54,1,271,312,1124,176,265,16,221,449,1127,48,142
495,48,1,219,251,1014,162,235,13,156,446,1012,48,143
415,53,1,262,282,1013,170,245,9,193,371,988,48,144
254,78,2,301,404,1039,133,292,48,181,311,965,48,145
142,57,1,477,313,990,48,377,38,229,279,971,48,146
62,52,0,335,190,639,29,239,9,220,191,688,48,147
91,48,0,272,135,546,35,134,7,179,228,583,48,148
426,64,0,267,322,1079,178,236,40,183,496,1133,48,149
458,50,0,248,249,1005,154,209,12,212,428,1015,48,150
460,53,1,229,267,1010,165,262,15,171,377,990,48,151
302,98,7,253,259,919,120,251,32,166,311,880,48,152
116,66,3,368,224,777,43,248,23,213,236,763,48,153
65,43,3,254,151,516,31,208,9,179,189,616,48,154
348,53,0,198,263,862,165,220,13,192,358,948,48,155
502,54,1,247,277,1081,187,272,16,176,508,1159,48,156
527,59,1,222,328,1137,168,226,8,188,489,1079,48,157
489,63,2,229,312,1095,175,237,24,192,457,1085,48,158
331,72,1,271,382,1057,142,301,58,239,344,1084,48,159
124,68,5,569,289,1055,50,425,61,258,273,1067,48,160
67,46,4,329,205,651,53,231,13,216,194,707,48,161
366,66,2,256,246,936,186,181,9,213,352,941,48,162
522,49,1,235,327,1134,177,242,10,188,473,1090,48,163
526,54,4,294,333,1211,199,244,28,186,486,1143,48,164
507,51,5,269,299,1131,181,251,21,199,448,1100,48,165
298,96,1,272,358,1025,140,236,54,210,296,936,48,166
100,78,6,438,290,912,52,306,26,302,223,909,48,167
61,47,4,295,152,559,24,198,9,182,204,617,48,168
386,52,1,274,278,991,164,221,16,218,407,1026,48,169
504,58,3,263,318,1146,179,260,24,178,489,1130,48,170
190,70,1,286,258,805,127,194,21,222,207,771,48,171
468,66,2,325,319,1180,261,262,35,230,449,1237,48,172
288,85,4,244,308,929,129,372,100,205,294,1100,48,173
103,108,2,348,272,833,41,271,68,252,247,879,48,174
71,50,2,232,170,525,40,198,14,181,160,593,48,175
378,54,1,237,258,928,205,221,10,252,352,1040,48,176
509,48,4,253,288,1102,165,219,17,194,487,1082,48,177
521,41,0,246,290,1098,152,256,12,293,491,1204,48,178
473,56,1,289,287,1106,147,284,17,203,434,1085,48,179
323,95,0,322,305,1045,116,206,30,261,392,1005,48,180
113,81,4,343,233,774,51,265,21,253,186,776,48,181
62,46,3,247,186,544,37,156,4,215,169,581,48,182
338,52,0,225,267,882,154,236,12,163,335,900,48,183
458,57,3,258,325,1101,532,240,15,184,436,1407,48,184
386,59,0,281,349,1075,151,274,49,246,360,1080,48,185
131,334,13,443,601,1522,34,903,143,196,223,1499,48,186
169,83,5,379,294,930,71,315,40,239,278,943,48,187
84,93,4,361,231,773,35,261,31,265,238,830,48,188
65,47,3,252,145,512,38,202,17,206,198,661,48,189
347,48,3,247,264,909,200,268,8,170,330,976,48,190
470,58,1,270,265,1064,205,228,12,169,466,1080,48,191
471,44,0,214,314,1043,197,207,14,185,453,1056,48,192
453,41,1,287,291,1073,151,283,15,168,379,996,48,193
296,68,2,248,264,878,118,232,32,191,316,889,48,194
110,98,10,380,322,920,48,286,85,259,252,930,48,195
55,43,0,251,142,491,31,399,4,143,163,740,48,196
365,70,0,203,240,878,162,226,9,157,335,889,48,197
507,50,2,200,264,1023,163,245,11,141,471,1031,48,198
510,62,0,231,277,1080,161,246,19,181,456,1063,48,199
482,70,2,278,300,1132,169,240,17,197,467,1090,48,200
253,85,3,310,328,979,130,278,68,215,320,1011,48,201
123,95,4,393,263,878,43,319,31,288,249,930,48,202
98,40,2,303,165,608,24,229,16,204,244,717,48,203
398,55,0,253,316,1022,155,233,21,199,365,973,48,204
526,52,1,255,304,1138,192,253,13,148,486,1092,48,205
492,47,8,257,348,1152,168,306,16,217,442,1149,48,206
419,61,4,307,372,1163,180,248,13,204,439,1084,48,207
299,98,3,320,323,1043,144,225,43,221,330,963,48,208
125,100,8,373,327,933,45,288,65,261,257,916,48,209
75,65,3,273,189,605,23,236,20,185,209,673,48,210
359,42,0,241,291,933,168,215,42,167,387,979,48,211
478,58,0,246,263,1045,150,290,9,153,424,1026,48,212
499,66,0,233,280,1078,154,242,13,206,432,1047,48,213
451,81,2,253,320,1107,148,264,13,189,394,1008,48,214
321,89,2,302,366,1080,125,278,75,216,311,1005,48,215
128,66,5,442,201,842,23,290,38,246,236,833,48,216
68,49,4,306,180,607,19,228,8,194,232,681,48,217
350,64,3,229,284,930,173,213,9,169,368,932,48,218
464,57,0,228,282,1031,171,231,8,172,440,1022,48,219
469,79,1,249,285,1083,162,256,14,225,548,1205,48,220
413,67,0,236,292,1008,130,241,14,203,429,1017,48,221
256,87,1,246,276,866,105,228,28,178,275,814,48,222
98,77,8,316,305,804,35,296,37,238,353,959,48,223
90,59,4,257,199,609,22,199,9,161,201,592,48,224
334,53,1,266,258,912,174,249,13,188,342,966,48,225
484,43,1,239,303,1070,170,238,12,222,530,1172,48,226
463,58,0,275,298,1094,162,243,21,183,464,1073,48,227
432,73,0,297,321,1123,172,252,15,204,504,1147,48,228
278,79,2,262,266,887,138,208,35,206,342,929,48,229
92,72,1,267,240,672,44,178,38,225,183,668,48,230
67,31,1,248,158,505,19,146,6,175,175,521,48,231
355,60,0,208,205,828,137,187,9,125,333,791,48,232
470,60,2,249,308,1089,165,234,22,199,430,1050,48,233
462,66,0,236,316,1080,160,274,18,199,479,1130,48,234
441,62,0,227,294,1024,170,392,16,163,607,1348,48,235
288,87,2,296,304,977,135,261,17,253,283,949,48,236
85,90,6,367,246,794,50,395,34,229,463,1171,48,237
67,39,6,307,225,644,27,180,19,379,189,794,48,238
369,47,13,183,238,850,354,222,26,153,381,1136,48,239
483,75,2,245,292,1097,158,275,22,200,440,1095,48,240
492,48,3,215,271,1029,152,265,11,187,426,1041,48,241
402,71,1,259,283,1016,139,230,26,166,387,948,48,242
277,66,0,310,293,946,120,245,47,223,296,931,48,243
98,110,7,343,237,795,43,227,46,239,259,814,48,244
84,51,5,303,179,622,30,209,6,218,209,672,48,245
61,27,0,270,154,512,33,173,15,175,203,599,48,246
451,59,0,255,218,983,159,212,9,189,463,1032,48,247
446,79,2,213,255,995,156,253,12,182,451,1054,48,248
438,87,1,247,265,1038,154,265,5,186,451,1061,48,249
315,69,1,216,248,849,133,182,19,155,316,805,48,250
95,71,2,320,196,684,50,191,45,203,216,705,48,251
60,60,9,218,147,494,34,170,13,173,174,564,48,252
342,59,0,252,214,867,147,199,9,171,390,916,48,253
518,55,3,258,301,1135,168,263,17,194,491,1133,48,254
504,62,2,284,298,1150,177,305,15,152,517,1166,48,255
511,57,1,231,300,1100,154,268,15,190,493,1120,48,256
313,105,3,279,291,991,122,250,51,181,327,931,48,257
104,84,4,417,253,862,58,288,40,225,284,895,48,258
75,40,3,300,146,564,33,200,11,147,214,605,48,259
359,52,3,221,266,901,154,186,13,185,355,893,48,260
538,46,1,240,245,1070,184,232,5,174,492,1087,48,261
499,48,4,273,274,1098,167,251,15,186,498,1117,48,262
469,66,2,283,316,1136,157,277,49,181,409,1073,48,263
290,106,0,307,250,953,122,264,38,174,320,918,48,264
71,62,2,356,209,700,35,237,34,195,235,736,48,265
53,44,0,250,126,473,28,166,8,171,151,524,48,266
363,39,0,210,221,833,137,185,13,171,375,881,48,267
465,50,3,264,273,1055,169,238,17,170,433,1027,48,268
493,51,14,270,303,1131,173,265,30,217,457,1142,48,269
447,57,1,266,291,1062,159,247,14,206,418,1044,48,270
257,102,2,262,271,894,124,242,46,168,307,887,48,271
91,77,4,396,205,773,42,286,33,195,233,789,48,272
71,40,7,301,133,552,32,222,9,158,161,582,48,273
312,62,1,235,205,815,137,192,9,147,338,823,48,274
475,39,0,235,256,1005,171,225,16,181,421,1014,48,275
481,58,0,248,269,1056,177,229,13,201,469,1089,48,276
405,66,0,282,335,1088,144,258,14,213,419,1048,48,277
276,71,4,347,243,941,142,230,25,194,349,940,48,278
121,83,5,366,198,773,39,241,30,254,235,799,48,279
76,40,3,302,137,558,33,181,8,190,208,620,48,280
362,38,1,265,259,925,147,177,8,220,381,933,48,281
508,56,3,222,259,1048,175,260,7,171,476,1089,48,282
523,36,0,221,331,1111,176,233,18,199,465,1091,48,283
460,68,0,294,267,1089,168,254,10,199,427,1058,48,284
281,70,0,318,268,937,131,255,19,193,340,938,48,285
163,109,8,439,313,1032,50,338,41,245,352,1026,48,286
99,66,4,283,190,642,42,203,13,228,178,664,48,287
199,43,2,283,239,766,118,161,7,242,257,785,48,288
518,41,0,208,285,1052,170,246,14,177,481,1088,48,289
503,65,0,261,272,1101,176,249,14,181,476,1096,48,290
441,67,0,293,322,1123,177,280,13,215,443,1128,48,291
288,88,1,277,258,912,130,210,29,182,320,871,48,292
87,91,4,367,231,780,41,212,46,236,231,766,48,293
61,39,0,344,187,631,36,211,6,174,211,638,48,294
380,38,0,249,254,921,155,228,10,171,356,920,48,295
506,60,0,240,241,1047,168,236,8,160,493,1065,48,296
513,59,0,247,259,1078,175,254,12,156,533,1130,48,297
496,71,1,262,297,1127,171,265,11,214,488,1149,48,298
284,82,4,241,250,861,107,233,29,180,319,868,48,299
105,100,3,356,264,828,35,289,35,202,255,816,48,300
125,61,3,321,154,664,42,178,24,217,248,709,48,301
372,53,3,225,247,900,145,195,12,186,366,904,48,302
461,58,0,285,341,1145,170,282,16,210,499,1177,48,303
467,50,2,265,280,1064,172,252,12,175,473,1084,48,304
439,85,3,254,297,1078,185,227,16,229,398,1055,48,305
277,86,1,240,256,860,124,216,31,157,322,850,48,306
74,92,6,317,258,747,29,289,46,199,200,763,48,307
58,41,1,274,138,512,36,170,5,188,185,584,48,308
338,44,0,231,236,849,171,180,14,167,358,890,48,309
377,43,1,226,232,879,144,154,14,214,361,887,48,310
434,48,0,218,253,953,176,222,11,195,381,985,48,311
442,49,0,245,277,1013,149,207,10,199,399,964,48,312
289,63,1,275,246,874,112,224,23,186,274,819,48,313
80,61,0,385,201,727,47,224,6,210,256,743,48,314
65,34,3,294,129,525,20,131,12,198,228,589,48,315
200,53,1,257,219,730,118,186,8,197,276,785,48,316
490,43,0,227,253,1013,179,196,12,181,519,1087,48,317
532,63,1,251,298,1145,204,259,12,193,476,1144,48,318
475,41,0,248,266,1030,159,225,11,216,400,1011,48,319
296,56,4,238,281,875,138,232,34,197,290,891,48,320
68,82,8,302,153,613,26,217,29,172,220,664,48,321
53,47,5,260,152,517,16,143,12,189,224,584,48,322
399,47,0,203,236,885,153,203,14,172,365,907,48,323
506,49,0,215,250,1020,171,220,7,200,491,1089,48,324
500,48,0,226,249,1023,170,213,7,183,477,1050,48,325
439,51,0,239,256,985,156,217,8,161,395,937,48,326
256,80,0,202,211,749,115,183,23,155,299,775,48,327
72,71,7,313,197,660,44,228,30,161,204,667,48,328
58,38,3,279,125,503,28,171,7,161,216,583,48,329
336,48,0,253,195,832,148,201,10,195,368,922,48,330
361,56,0,240,245,902,136,207,7,165,401,916,48,331
241,63,0,327,253,884,99,237,8,231,293,868,48,332
50,31,1,164,92,338,40,85,5,141,140,411,48,333
139,62,0,358,144,703,58,178,15,151,243,645,48,334
81,67,4,250,158,560,29,165,12,179,196,581,48,335
47,44,5,219,130,445,30,186,13,136,177,542,48,336
328,40,1,184,179,732,142,160,7,119,329,757,48,337
467,39,2,223,254,985,174,269,14,139,434,1030,48,338
466,34,2,226,233,961,168,206,14,177,418,983,48,339
407,47,2,237,242,935,132,233,13,179,384,941,48,340
258,66,0,206,236,766,109,192,31,180,278,790,48,341
63,86,2,272,214,637,30,254,52,163,205,704,48,342
46,49,1,273,178,547,33,180,16,162,221,612,48,343
338,56,0,225,201,820,135,211,6,186,306,844,48,344
488,57,3,215,227,990,154,258,16,173,422,1023,48,345
503,54,0,229,244,1030,166,238,6,171,415,996,48,346
456,54,0,261,248,1019,149,230,10,195,444,1028,48,347
271,52,1,286,223,833,117,192,28,188,315,840,48,348
109,69,4,359,238,779,47,280,38,245,234,844,48,349
42,37,4,244,139,466,36,180,14,174,140,544,48,350
315,51,0,192,202,760,121,169,9,158,341,798,48,351
410,48,1,232,269,960,151,216,16,157,427,967,48,352
412,47,0,200,242,901,146,196,10,158,391,901,48,353
395,60,0,246,220,921,128,218,9,153,360,868,48,354
210,76,0,210,218,714,90,212,29,138,216,685,48,355
59,61,2,262,161,545,37,176,23,149,165,550,48,356
43,31,0,229,137,440,24,146,11,125,154,460,48,357
179,45,0,225,155,604,85,144,13,135,219,596,48,358
95,30,0,196,108,429,62,119,10,115,152,458,48,359
21,38,1,94,35,189,24,74,2,56,72,228,48,360
139,39,0,213,151,542,66,133,3,140,163,505,48,361
146,58,0,248,171,623,72,191,14,126,209,612,48,362
47,56,0,203,191,497,40,174,15,192,138,559,48,363
45,39,0,256,158,498,44,128,18,166,173,529,48,364
173,50,0,279,198,700,86,208,10,153,236,693,48,365
150,229,46,259,217,901,86,226,130,161,231,834,48,366
40,70,6,208,191,515,44,71,8,292,141,556,49,1
177,166,16,506,1677,2542,1332,99,16,721,359,2527,49,2
226,292,6,544,1938,3006,1713,163,9,802,387,3074,49,3
265,233,2,686,1947,3133,1676,112,7,957,381,3133,49,4
186,309,17,580,1369,2461,1101,166,9,764,434,2474,49,5
45,172,14,278,214,723,65,118,16,430,188,817,49,6
32,84,9,309,364,798,40,89,12,494,245,880,49,7
254,292,37,677,1867,3127,1665,129,36,799,466,3095,49,8
275,202,34,963,1938,3412,2062,102,24,838,354,3380,49,9
294,355,32,764,2414,3859,2261,197,47,1042,497,4044,49,10
328,471,7,782,2249,3837,2065,186,10,1108,549,3918,49,11
228,223,49,827,1417,2744,1162,157,35,918,414,2686,49,12
66,218,22,428,663,1397,115,187,15,922,447,1686,49,13
44,163,43,476,449,1175,75,113,47,762,326,1323,49,14
69,164,12,398,488,1131,152,132,18,615,239,1156,49,15
178,292,19,423,851,1763,548,156,26,768,383,1881,49,16
288,422,6,779,2348,3843,1907,193,9,1232,561,3902,49,17
326,564,7,801,2657,4355,2364,231,9,1197,738,4539,49,18
193,263,21,530,1057,2064,619,229,23,878,396,2145,49,19
41,284,26,473,452,1276,75,176,21,834,408,1514,49,20
42,145,28,502,508,1225,76,108,43,914,298,1439,49,21
280,408,22,794,2175,3679,1949,169,20,1019,485,3642,49,22
342,507,11,785,2695,4340,2518,205,17,1194,585,4519,49,23
393,473,4,839,2747,4456,2482,175,6,1258,637,4558,49,24
341,495,12,850,2482,4180,2288,221,19,1221,595,4344,49,25
241,306,18,754,1564,2883,1398,224,21,938,498,3079,49,26
73,307,20,485,595,1480,109,179,31,955,477,1751,49,27
48,116,8,404,508,1084,79,106,12,731,284,1212,49,28
276,375,21,874,2242,3788,2030,156,23,1077,458,3744,49,29
343,430,22,796,2835,4426,2559,165,28,1140,613,4505,49,30
319,559,12,858,2734,4482,2550,185,15,1192,638,4580,49,31
361,472,17,788,2588,4226,2302,194,19,1284,569,4368,49,32
245,391,26,799,1554,3015,1353,220,14,1078,566,3231,49,33
66,244,16,450,629,1405,86,204,26,819,402,1537,49,34
40,114,13,340,518,1025,67,101,15,703,266,1152,49,35
284,386,28,772,2125,3595,2008,154,22,952,498,3634,49,36
344,505,8,814,2789,4460,2621,191,12,1205,620,4649,49,37
365,495,23,872,2783,4538,2500,189,25,1278,620,4612,49,38
329,528,27,854,2519,4257,2363,203,21,1204,640,4431,49,39
227,377,16,821,1482,2923,1384,264,21,937,511,3117,49,40
54,233,25,510,614,1436,95,159,27,884,390,1555,49,41
82,199,10,369,554,1214,69,149,16,611,307,1152,49,42
255,418,5,794,2195,3667,2030,151,6,1001,558,3746,49,43
382,528,24,825,2429,4188,2274,195,30,1127,766,4392,49,44
351,460,26,893,2698,4428,2373,224,23,1295,615,4530,49,45
319,496,7,939,2473,4234,2303,230,10,1197,643,4383,49,46
229,310,20,876,1403,2838,1287,203,22,974,490,2976,49,47
68,202,22,536,859,1687,83,173,25,1026,422,1729,49,48
46,162,11,476,608,1303,64,125,12,1021,405,1627,49,49
100,210,15,579,691,1595,217,149,20,949,331,1666,49,50
379,410,18,877,2505,4189,2409,185,24,1144,577,4339,49,51
420,437,25,866,2592,4340,2433,198,27,1177,598,4433,49,52
336,566,15,898,2422,4237,2275,190,21,1201,679,4366,49,53
250,331,16,828,1600,3025,1391,239,22,1022,476,3150,49,54
66,239,24,444,607,1380,101,188,26,814,393,1522,49,55
55,184,4,365,438,1046,83,108,7,584,337,1119,49,56
367,451,6,860,1928,3612,1962,185,12,1016,500,3675,49,57
373,539,15,979,2794,4700,2559,173,12,1334,637,4715,49,58
383,470,6,954,2789,4602,2729,190,9,1211,592,4731,49,59
338,536,7,883,2540,4304,2411,254,11,1176,594,4446,49,60
264,456,22,880,1627,3249,1483,237,20,986,589,3315,49,61
57,251,23,502,551,1384,110,238,28,890,429,1695,49,62
51,146,11,409,569,1186,86,150,15,784,313,1348,49,63
285,420,30,935,2210,3880,2060,134,35,1186,489,3904,49,64
364,562,19,859,2755,4559,2628,211,26,1202,629,4696,49,65
352,540,14,981,2832,4719,2554,252,54,1321,696,4877,49,66
355,644,14,1017,2302,4332,2170,284,10,1268,637,4369,49,67
272,435,20,892,1576,3195,1400,266,23,1103,544,3336,49,68
60,272,27,507,568,1434,106,174,24,896,382,1582,49,69
38,155,4,463,494,1154,75,140,6,753,302,1276,49,70
249,379,21,841,2120,3610,1899,204,18,1192,476,3789,49,71
330,534,12,866,2713,4455,2403,220,15,1295,646,4579,49,72
332,515,11,965,2753,4576,2458,232,9,1418,781,4898,49,73
320,741,8,940,2540,4549,2173,294,20,1338,957,4782,49,74
219,363,52,943,1699,3276,1388,231,19,1287,544,3469,49,75
201,369,26,2360,731,3687,447,266,28,1836,559,3136,49,76
43,268,4,430,531,1276,52,156,6,728,330,1272,49,77
293,390,9,832,2232,3756,1980,220,12,1120,496,3828,49,78
391,538,19,841,2813,4602,2570,228,22,1317,642,4779,49,79
349,667,11,1051,2802,4880,2610,278,12,1492,771,5163,49,80
366,668,14,1007,2538,4593,2361,302,17,1365,793,4838,49,81
262,548,22,931,1801,3564,1429,274,17,1323,707,3750,49,82
74,298,24,506,794,1696,165,249,24,1061,453,1952,49,83
84,252,5,632,860,1833,155,189,10,1046,463,1863,49,84
305,515,13,928,2305,4066,1974,213,15,1474,645,4321,49,85
327,638,19,911,2820,4715,2360,212,21,1476,803,4872,49,86
351,603,11,1000,2702,4667,2340,231,8,1486,650,4715,49,87
343,520,18,1006,2635,4522,2058,232,11,1839,658,4798,49,88
223,464,23,1125,1757,3592,1208,268,30,1563,671,3740,49,89
74,427,17,711,1052,2281,115,218,29,1399,619,2380,49,90
55,273,14,515,537,1394,79,146,12,882,377,1496,49,91
273,432,23,896,2114,3738,1791,231,27,1299,539,3887,49,92
320,574,8,903,2832,4637,2441,205,11,1392,704,4753,49,93
356,718,10,929,2741,4754,2466,260,13,1410,845,4994,49,94
341,637,5,981,2879,4843,2377,294,7,1436,749,4863,49,95
246,775,43,1441,3682,6187,1442,416,40,2099,2388,6385,49,96
144,295,23,2091,1118,3671,358,239,31,2781,709,4118,49,97
85,314,16,484,478,1377,100,161,19,735,356,1371,49,98
298,471,12,882,2242,3905,1896,174,19,1345,551,3985,49,99
351,625,8,891,2808,4683,2578,255,6,1347,697,4883,49,100
334,597,6,980,2734,4651,2460,251,7,1405,743,4866,49,101
346,810,15,901,2703,4775,2433,247,14,1327,988,5009,49,102
243,540,22,832,1755,3392,1449,305,19,1186,679,3638,49,103
80,438,28,1089,1979,3614,295,280,24,3303,658,4560,49,104
45,199,12,961,1167,2384,174,151,18,2201,364,2908,49,105
284,540,15,963,2187,3989,1997,163,21,1250,630,4061,49,106
322,587,10,667,2293,3879,1943,216,12,1210,663,4044,49,107
332,616,7,931,2834,4720,2531,221,10,1462,681,4905,49,108
347,609,8,923,2525,4412,2308,226,11,1394,685,4624,49,109
230,414,14,911,1782,3351,1432,263,19,1291,592,3597,49,110
74,355,20,509,2592,3550,117,235,28,2104,1961,4445,49,111
53,179,12,367,424,1035,75,124,18,619,290,1126,49,112
259,396,19,878,2079,3631,1967,205,21,1116,514,3823,49,113
329,525,26,816,2745,4441,2475,207,25,1327,646,4680,49,114
354,647,12,884,2742,4639,2487,241,17,1390,657,4792,49,115
354,498,25,949,2610,4436,2320,242,40,1414,646,4662,49,116
203,540,24,1059,1722,3548,1457,263,11,1210,644,3585,49,117
58,308,27,453,536,1382,105,181,23,749,430,1488,49,118
38,278,5,427,503,1251,79,181,9,781,351,1401,49,119
231,371,21,802,2059,3484,1872,151,18,1151,489,3681,49,120
354,554,12,907,2668,4495,2532,212,13,1200,646,4603,49,121
360,592,17,866,2662,4497,2493,225,18,1192,686,4614,49,122
345,534,8,1109,2690,4686,2326,226,12,1600,687,4851,49,123
229,368,52,1035,1850,3534,1437,246,40,1445,560,3728,49,124
54,215,21,642,722,1654,148,173,21,1145,384,1871,49,125
38,174,17,441,542,1212,74,115,18,954,300,1461,49,126
270,349,6,807,2133,3565,1976,166,7,1056,443,3648,49,127
342,474,5,867,2794,4482,2540,209,9,1272,563,4593,49,128
326,494,16,889,2526,4251,2456,216,18,1261,567,4518,49,129
317,689,9,845,2493,4353,2230,254,9,1148,792,4433,49,130
258,320,25,811,1573,2987,1345,225,22,1040,573,3205,49,131
93,235,22,618,670,1638,127,247,21,936,515,1846,49,132
46,300,17,463,882,1708,117,245,19,1192,372,1945,49,133
262,628,15,1190,2260,4355,1945,277,17,1453,714,4406,49,134
378,540,6,1134,3178,5236,2632,233,7,1523,808,5203,49,135
345,800,5,1172,2900,5222,2514,379,8,1520,884,5305,49,136
340,606,4,1026,2607,4583,2343,320,11,1334,785,4793,49,137
254,352,29,997,1708,3340,1337,257,26,1220,646,3486,49,138
45,239,14,571,755,1624,137,190,18,1059,426,1830,49,139
41,185,4,369,475,1074,78,132,6,671,289,1176,49,140
273,440,5,891,2137,3746,1920,196,7,1164,478,3765,49,141
348,474,15,1033,2765,4635,2595,250,23,1313,670,4851,49,142
311,573,7,928,2723,4542,2465,276,9,1275,669,4694,49,143
305,556,6,904,2375,4146,2072,244,8,1257,712,4293,49,144
233,303,13,1150,1254,2953,1206,236,26,1126,450,3044,49,145
56,392,15,455,580,1498,107,273,23,804,425,1632,49,146
51,527,5,490,542,1615,84,293,6,839,444,1666,49,147
38,135,4,379,485,1041,110,115,4,711,223,1163,49,148
338,375,11,860,2565,4149,2324,218,13,1154,574,4283,49,149
363,402,16,978,2787,4546,2525,190,24,1247,553,4539,49,150
348,482,6,866,2574,4276,2367,247,13,1247,635,4509,49,151
262,366,20,892,1737,3277,1499,235,17,1097,680,3528,49,152
51,289,16,748,1073,2177,121,171,21,1444,740,2497,49,153
35,161,20,416,428,1060,70,156,19,585,325,1155,49,154
327,364,12,817,2101,3621,1943,178,16,924,517,3578,49,155
389,368,25,908,2802,4492,2536,204,23,1087,616,4466,49,156
372,415,5,893,2774,4459,2488,240,7,1184,623,4542,49,157
362,537,9,910,2459,4277,2253,294,8,1234,617,4406,49,158
255,548,18,863,1768,3452,1423,280,36,1028,714,3481,49,159
71,587,27,554,853,2092,166,384,21,877,662,2110,49,160
57,1285,5,564,1536,3447,124,269,8,1528,1326,3255,49,161
319,353,14,738,2126,3550,1920,174,8,913,524,3539,49,162
362,473,9,859,2729,4432,2471,234,8,1129,644,4486,49,163
357,512,12,930,2703,4514,2474,220,17,1255,567,4533,49,164
337,538,7,874,2625,4381,2255,243,9,1250,677,4434,49,165
271,408,25,813,1619,3136,1444,283,27,1005,541,3300,49,166
56,281,22,505,694,1558,143,249,27,935,459,1813,49,167
44,181,41,400,421,1087,80,169,35,656,266,1206,49,168
314,409,13,793,2198,3727,1914,210,22,926,567,3639,49,169
389,439,12,1113,2474,4427,2255,230,15,1285,553,4338,49,170
145,226,4,420,571,1366,253,160,6,703,429,1551,49,171
372,429,15,864,2342,4022,2108,264,11,1202,625,4210,49,172
255,377,12,807,1586,3037,1325,219,26,949,555,3074,49,173
80,349,24,484,606,1543,117,252,29,1059,569,2026,49,174
37,229,11,457,474,1208,88,161,7,832,333,1421,49,175
288,336,14,761,2152,3551,1988,191,15,916,460,3570,49,176
367,375,20,826,2654,4242,2337,237,22,1234,567,4397,49,177
376,413,13,909,2705,4416,2371,214,13,1268,581,4447,49,178
374,621,20,911,2511,4437,2197,285,19,1204,703,4408,49,179
265,411,22,887,1736,3321,1332,257,25,1072,635,3321,49,180
56,309,19,957,893,2234,233,254,20,1354,513,2374,49,181
67,168,20,439,582,1276,91,135,31,823,245,1325,49,182
309,300,13,823,2113,3558,1841,154,16,1218,598,3827,49,183
351,401,26,757,2525,4060,2118,228,22,1147,593,4108,49,184
278,436,32,1189,1608,3543,1716,266,31,1057,521,3591,49,185
56,2637,9,500,646,3848,121,1718,14,912,867,3632,49,186
146,297,20,785,1121,2369,678,227,25,1148,374,2452,49,187
60,209,30,488,591,1378,91,217,16,895,357,1576,49,188
41,126,7,371,445,990,73,132,4,667,257,1133,49,189
338,322,6,759,1978,3403,1802,186,8,950,475,3421,49,190
417,447,12,952,2640,4468,2424,285,14,1279,619,4621,49,191
402,398,11,872,2535,4218,2261,221,13,1178,641,4314,49,192
413,486,10,999,2454,4362,2203,251,8,1320,702,4484,49,193
252,362,19,842,1599,3074,1417,256,21,1027,452,3173,49,194
67,237,14,557,717,1592,151,225,13,906,454,1749,49,195
55,172,13,463,472,1175,96,174,25,735,269,1299,49,196
357,287,14,811,2086,3555,1901,191,16,955,472,3535,49,197
400,347,9,867,2665,4288,2427,265,12,1118,576,4398,49,198
375,351,4,945,2719,4394,2428,180,6,1185,589,4388,49,199
370,464,14,950,2518,4316,2125,276,13,1384,649,4447,49,200
239,377,24,809,1552,3001,1246,286,62,1069,594,3257,49,201
102,455,28,563,841,1989,127,206,28,1104,753,2218,49,202
61,171,11,552,535,1330,82,137,8,872,384,1483,49,203
287,418,15,777,2217,3714,1924,177,14,1055,529,3699,49,204
360,406,8,900,2874,4548,2415,250,9,1281,662,4617,49,205
375,423,7,1379,3006,5190,1948,205,10,1937,872,4972,49,206
349,504,59,926,2487,4325,2164,256,73,1357,724,4574,49,207
245,414,21,798,1597,3075,1368,252,23,1094,595,3332,49,208
74,371,22,584,807,1858,187,274,29,982,548,2020,49,209
44,158,6,462,525,1195,71,135,11,767,319,1303,49,210
294,334,30,828,2074,3560,1840,204,33,1086,482,3645,49,211
345,306,6,862,2756,4275,2442,191,13,1137,528,4311,49,212
325,367,14,905,2644,4255,2178,229,16,1188,573,4184,49,213
312,408,6,905,2416,4047,2153,224,9,1170,549,4105,49,214
215,436,22,758,1550,2981,1306,241,19,850,530,2946,49,215
60,208,21,488,562,1339,94,151,25,849,319,1438,49,216
53,179,20,418,515,1185,81,124,23,665,308,1201,49,217
241,304,12,768,1956,3281,1765,140,11,979,443,3338,49,218
311,316,7,841,2408,3883,2152,186,12,1087,554,3991,49,219
296,343,5,760,2442,3846,2215,184,18,1024,502,3943,49,220
270,422,11,813,2200,3716,1918,188,17,1113,530,3766,49,221
162,225,19,642,1265,2313,1039,195,20,805,330,2389,49,222
46,219,19,458,612,1354,94,196,18,807,419,1534,49,223
47,171,13,375,418,1024,76,136,8,589,262,1071,49,224
247,286,12,719,1847,3111,1694,183,9,890,414,3190,49,225
295,351,6,771,2367,3790,2143,185,10,1055,511,3904,49,226
308,420,27,881,2326,3962,2107,212,28,1110,472,3929,49,227
253,446,39,848,2053,3639,1835,216,42,1158,556,3807,49,228
200,382,17,779,1394,2772,1114,254,14,965,529,2876,49,229
48,238,26,499,567,1378,100,206,28,809,402,1545,49,230
53,141,18,459,462,1133,70,124,16,739,309,1258,49,231
251,234,12,752,1880,3129,1662,175,16,932,381,3166,49,232
284,419,22,939,2545,4209,2161,201,20,1323,554,4259,49,233
286,366,8,785,2447,3892,2058,247,8,1193,482,3988,49,234
304,536,20,752,2238,3850,1945,319,20,1213,565,4062,49,235
223,457,38,825,1530,3073,1223,249,36,1176,587,3271,49,236
46,327,19,427,568,1387,105,218,15,792,367,1497,49,237
51,255,11,721,914,1952,136,140,17,1566,429,2288,49,238
265,387,20,825,2262,3759,2011,186,27,1110,490,3824,49,239
340,553,27,890,2775,4585,2443,225,24,1317,714,4723,49,240
332,555,15,966,2762,4630,2430,209,13,1349,670,4671,49,241
317,598,28,872,2640,4455,2143,203,33,1372,675,4426,49,242
240,269,28,936,1234,2707,1179,230,30,956,441,2836,49,243
68,249,22,702,930,1971,138,172,22,1307,467,2106,49,244
48,820,7,498,549,1922,82,445,9,840,567,1943,49,245
59,182,7,386,464,1098,101,129,11,689,296,1226,49,246
344,526,18,830,2752,4470,2433,211,22,1235,728,4629,49,247
354,592,9,970,2896,4821,2762,192,8,1500,583,5045,49,248
331,701,26,949,2713,4720,2491,231,33,1352,764,4871,49,249
241,388,26,852,1595,3102,1492,283,46,1037,549,3407,49,250
77,248,21,632,618,1596,171,255,20,902,372,1720,49,251
55,215,10,474,487,1241,96,126,11,786,355,1374,49,252
327,574,32,914,2498,4345,2357,222,36,1304,669,4588,49,253
405,769,8,927,3259,5368,3011,269,30,1452,777,5539,49,254
369,725,8,1099,3135,5336,2893,187,8,1596,797,5481,49,255
404,1079,15,961,2899,5358,2714,307,16,1481,1126,5644,49,256
239,396,23,911,1796,3365,1517,307,29,1132,554,3539,49,257
68,332,29,611,661,1701,173,247,29,934,462,1845,49,258
65,203,5,461,514,1248,105,125,10,814,383,1437,49,259
302,582,33,904,2594,4415,2418,239,36,1317,607,4617,49,260
420,794,48,1091,3432,5785,3018,281,47,1682,811,5839,49,261
400,869,9,1139,3267,5684,2841,328,7,1936,859,5971,49,262
364,982,5,1093,2939,5383,2687,282,8,1660,851,5488,49,263
266,440,32,1051,1790,3579,1546,330,25,1278,564,3743,49,264
69,369,30,638,663,1769,138,241,22,1002,524,1927,49,265
51,181,33,545,489,1299,112,136,32,806,393,1479,49,266
308,485,21,891,2614,4319,2284,169,23,1294,578,4348,49,267
409,728,11,991,3607,5746,2976,183,7,1546,924,5636,49,268
413,716,6,1145,3186,5466,3011,232,6,1711,729,5689,49,269
389,794,8,946,3000,5137,2614,253,9,1661,814,5351,49,270
270,444,35,905,1872,3526,1574,252,23,1273,610,3732,49,271
80,485,46,804,1133,2548,192,318,28,1522,730,2790,49,272
48,214,23,540,730,1555,109,123,26,1110,352,1720,49,273
310,486,4,870,2495,4165,2307,157,6,1313,583,4366,49,274
404,618,14,1020,3155,5211,2905,187,13,1617,736,5458,49,275
384,576,9,1050,3041,5060,2852,219,14,1605,677,5367,49,276
339,585,12,908,2676,4520,2213,246,10,1521,688,4678,49,277
255,440,26,845,1805,3371,1477,253,17,1226,596,3569,49,278
68,331,23,524,697,1643,133,250,16,970,451,1820,49,279
60,171,7,447,475,1160,95,146,15,858,355,1469,49,280
315,662,4,959,2659,4599,2441,297,8,1316,695,4757,49,281
396,657,3,1032,3207,5295,3093,217,6,1608,749,5673,49,282
400,711,2,1019,3196,5328,2973,269,4,1619,782,5647,49,283
357,885,15,935,2790,4982,2471,248,21,1610,1014,5364,49,284
239,387,15,1093,1688,3422,1513,285,15,1314,586,3713,49,285
55,435,17,640,1354,2501,192,230,26,1885,637,2970,49,286
46,297,3,528,588,1462,93,166,8,995,440,1702,49,287
167,273,10,554,858,1862,442,187,12,960,477,2078,49,288
374,715,5,982,3116,5192,2857,228,7,1463,803,5358,49,289
382,606,4,1034,3228,5254,2961,219,4,1646,776,5606,49,290
374,989,4,1006,2877,5250,2546,367,4,1765,896,5578,49,291
280,436,31,968,1951,3666,1638,303,32,1418,616,4007,49,292
75,309,43,931,868,2226,235,296,32,1509,533,2605,49,293
50,183,7,623,921,1784,93,145,10,1317,523,2088,49,294
336,522,16,990,2417,4281,2316,191,16,1444,637,4604,49,295
439,661,11,979,3185,5275,2813,246,11,1631,820,5521,49,296
388,741,7,996,3097,5229,2840,282,11,1549,780,5462,49,297
365,841,13,1107,2865,5191,2553,346,17,1619,906,5441,49,298
253,438,31,1071,1908,3701,1529,325,37,1385,684,3960,49,299
89,356,24,597,832,1898,145,274,10,1095,611,2135,49,300
104,199,13,581,587,1484,197,158,9,1129,407,1900,49,301
313,505,6,1024,2559,4407,2691,206,11,1358,591,4857,49,302
385,886,12,1179,3018,5480,2861,330,10,1623,870,5694,49,303
413,723,12,1108,3084,5340,2901,239,14,1648,725,5527,49,304
342,528,13,1058,2653,4594,2343,250,8,1391,640,4632,49,305
242,385,21,923,1714,3285,1497,217,30,1089,582,3415,49,306
52,343,29,553,676,1653,158,246,23,936,447,1810,49,307
51,147,5,481,555,1239,119,93,8,846,319,1385,49,308
332,474,4,977,2513,4300,2472,186,5,1269,617,4549,49,309
318,435,9,1051,2441,4254,2302,219,16,1282,543,4362,49,310
335,542,5,959,2469,4310,2304,200,5,1276,559,4344,49,311
343,563,4,1011,2704,4625,2363,197,5,1494,639,4698,49,312
249,439,22,1034,1754,3498,1449,222,32,1231,632,3566,49,313
55,337,19,684,740,1835,143,231,18,1133,479,2004,49,314
43,160,2,494,494,1193,85,122,4,805,320,1336,49,315
180,357,5,617,984,2143,589,150,6,978,478,2201,49,316
406,660,10,1051,3129,5256,2947,221,9,1518,805,5500,49,317
382,776,13,1068,3237,5476,3082,264,13,1732,873,5964,49,318
378,872,18,1189,3078,5535,2841,242,19,1795,1086,5983,49,319
231,374,21,1040,1849,3515,1626,256,19,1436,549,3886,49,320
48,161,17,509,585,1320,102,166,23,853,370,1514,49,321
51,137,11,405,414,1018,76,106,14,632,283,1111,49,322
312,497,27,977,2570,4383,2407,197,32,1405,657,4698,49,323
405,571,22,1051,3240,5289,3039,217,23,1677,694,5650,49,324
374,735,24,1190,3103,5426,2997,186,24,1683,848,5738,49,325
368,710,5,1012,2940,5035,2679,265,8,1733,859,5544,49,326
257,328,22,961,1759,3327,1561,266,23,1163,536,3549,49,327
71,286,16,437,514,1324,123,150,28,721,327,1349,49,328
61,163,24,394,437,1079,67,132,31,671,238,1139,49,329
247,363,45,849,2024,3528,1873,170,52,1276,474,3845,49,330
243,420,14,844,2225,3746,1959,156,12,1276,733,4136,49,331
186,223,4,953,916,2282,1060,151,7,1004,322,2544,49,332
43,76,5,234,233,591,52,88,8,282,100,530,49,333
83,130,21,610,952,1796,315,138,15,1332,311,2111,49,334
43,157,14,401,578,1193,86,129,15,888,334,1452,49,335
44,197,2,341,377,961,89,119,4,696,343,1251,49,336
266,320,7,807,2181,3581,1972,212,8,1168,482,3842,49,337
357,575,9,827,3121,4889,2675,229,8,1416,735,5063,49,338
369,610,11,1056,2895,4941,2759,238,13,1579,718,5307,49,339
351,633,14,833,2810,4641,2355,282,17,1445,841,4940,49,340
248,425,21,837,1701,3232,1454,283,22,1290,618,3667,49,341
52,350,55,537,641,1635,147,231,37,943,521,1879,49,342
55,250,12,483,666,1466,137,190,14,1009,494,1844,49,343
297,403,11,953,2332,3996,2100,190,11,1382,643,4326,49,344
385,578,16,938,3230,5147,2768,245,23,1545,802,5383,49,345
368,650,51,964,3044,5077,2687,241,63,1425,814,5230,49,346
335,706,29,1109,2786,4965,2459,320,30,1681,826,5316,49,347
271,477,35,1062,1825,3670,1459,300,27,1373,736,3895,49,348
74,579,50,601,768,2072,91,613,30,1132,588,2454,49,349
51,164,10,468,464,1157,66,118,14,787,325,1310,49,350
297,338,18,773,2060,3486,1826,188,13,1131,525,3683,49,351
350,548,13,881,2671,4463,2472,213,17,1358,747,4807,49,352
306,427,12,958,2451,4154,2263,182,14,1360,623,4442,49,353
293,430,10,918,2251,3902,2018,207,13,1389,655,4282,49,354
178,352,27,696,1364,2617,1073,164,16,974,506,2733,49,355
41,174,9,444,634,1302,78,101,16,899,403,1497,49,356
29,188,7,319,437,980,45,101,7,671,291,1115,49,357
120,179,13,660,1166,2138,790,102,15,1049,382,2338,49,358
101,85,6,407,312,911,258,69,5,474,124,930,49,359
29,38,3,116,111,297,25,55,6,129,58,273,49,360
94,238,16,536,958,1842,497,89,21,986,343,1936,49,361
96,188,10,638,1179,2111,506,128,11,1302,349,2296,49,362
36,175,17,430,634,1292,61,94,17,969,251,1392,49,363
34,121,4,425,610,1194,81,92,7,907,311,1398,49,364
141,253,4,693,1524,2615,937,111,4,1464,436,2952,49,365
121,198,69,806,1015,2209,799,199,69,1066,259,2392,49,366
147,201,13,587,400,1348,111,249,18,486,462,1326,50,1
969,276,18,763,922,2948,589,365,23,746,1261,2984,50,2
1127,324,24,712,1037,3224,650,449,12,751,1470,3332,50,3
1108,331,9,790,969,3207,696,467,11,804,1399,3377,50,4
772,373,25,744,981,2895,485,514,41,779,1221,3040,50,5
188,253,28,642,364,1475,132,341,51,550,508,1582,50,6
184,281,11,818,577,1871,117,336,18,754,650,1875,50,7
1085,323,3,730,933,3074,613,439,13,739,1396,3200,50,8
1268,238,14,713,682,2915,661,341,23,765,1265,3055,50,9
1441,368,16,808,1075,3708,722,522,24,809,1636,3713,50,10
1331,343,26,848,1094,3642,698,625,36,815,1569,3743,50,11
823,307,36,875,942,2983,551,405,47,910,1140,3053,50,12
265,387,29,1210,727,2618,153,472,50,923,1119,2717,50,13
194,241,8,787,589,1819,134,304,21,692,703,1854,50,14
257,287,21,654,467,1686,229,359,35,569,555,1747,50,15
473,219,11,503,513,1719,360,318,29,514,592,1813,50,16
1128,310,7,757,957,3159,618,484,12,810,1504,3428,50,17
1246,370,14,797,1031,3458,709,588,18,859,1550,3724,50,18
589,353,35,739,531,2247,429,392,52,638,857,2368,50,19
234,341,22,780,586,1963,173,350,50,707,677,1957,50,20
195,243,8,669,591,1706,110,311,16,576,530,1543,50,21
995,305,9,802,877,2988,623,382,21,753,1335,3114,50,22
1350,357,16,774,1043,3540,748,505,31,713,1644,3641,50,23
1372,382,12,810,1088,3664,766,512,23,758,1670,3729,50,24
1255,440,9,712,1046,3462,746,580,27,690,1551,3594,50,25
898,617,30,897,1097,3539,585,584,53,1020,1445,3687,50,26
264,499,24,1020,1021,2828,168,461,66,1189,1012,2896,50,27
171,309,7,703,479,1669,119,294,11,692,631,1747,50,28
1053,336,11,727,890,3017,672,424,23,682,1380,3181,50,29
1391,354,17,784,958,3504,751,478,17,746,1645,3637,50,30
1373,343,19,813,1119,3667,785,527,24,806,1574,3716,50,31
1220,404,16,810,1094,3544,760,550,24,810,1582,3726,50,32
861,417,28,895,1033,3234,634,496,59,868,1308,3365,50,33
243,516,27,1063,1022,2871,171,404,44,1236,1053,2908,50,34
154,317,4,776,734,1985,109,309,15,918,644,1995,50,35
1073,314,11,776,938,3112,656,441,26,718,1393,3234,50,36
1409,325,39,796,1094,3663,779,564,33,781,1758,3915,50,37
1357,341,16,835,1109,3658,746,553,24,772,1765,3860,50,38
1315,452,21,928,1111,3827,801,565,28,831,1565,3790,50,39
916,565,23,898,987,3389,569,509,63,896,1463,3500,50,40
234,469,15,1055,871,2644,163,514,57,968,951,2653,50,41
197,262,10,694,487,1650,113,271,23,613,675,1695,50,42
1073,305,6,754,865,3003,645,411,14,744,1264,3078,50,43
1325,375,10,842,1106,3658,683,653,18,778,1548,3680,50,44
1426,378,17,814,1092,3727,722,605,29,878,1765,3999,50,45
1288,412,19,848,1010,3577,753,601,37,841,1633,3865,50,46
829,513,46,893,1008,3289,586,541,70,993,1277,3467,50,47
339,434,23,1086,779,2661,160,482,52,967,1036,2697,50,48
319,395,13,1087,844,2658,123,434,17,1010,1010,2594,50,49
478,354,5,1154,1287,3278,337,366,15,1629,877,3224,50,50
1438,368,17,939,1068,3830,766,595,36,766,1722,3885,50,51
1490,416,8,883,1030,3827,789,521,25,861,1753,3949,50,52
1418,425,17,960,1145,3965,789,618,24,923,1747,4101,50,53
1002,507,31,890,1004,3434,552,560,61,864,1454,3491,50,54
339,467,30,1156,869,2861,194,487,58,1114,1105,2958,50,55
249,350,9,809,692,2109,121,369,17,801,792,2100,50,56
1236,383,29,841,1052,3541,703,586,35,793,1537,3654,50,57
1605,373,17,932,1107,4034,807,587,34,820,1803,4051,50,58
1529,402,6,815,1031,3783,770,575,17,804,1785,3951,50,59
1453,496,12,994,1086,4041,811,658,28,842,1817,4156,50,60
1035,513,21,1099,1232,3900,595,775,54,975,1560,3959,50,61
323,520,30,1122,925,2920,152,540,47,1196,1015,2950,50,62
287,362,10,1108,920,2687,155,382,24,1174,949,2684,50,63
1255,363,21,1001,1024,3664,704,533,32,778,1812,3859,50,64
1544,430,7,987,1177,4145,700,655,23,923,2034,4335,50,65
1583,393,42,1066,1142,4226,821,687,54,884,2025,4471,50,66
1503,480,9,1069,1245,4306,836,708,39,956,2006,4545,50,67
1083,576,28,1159,1204,4050,686,798,62,1077,1641,4264,50,68
391,372,29,1147,722,2661,194,674,60,884,907,2719,50,69
293,368,21,1166,756,2604,132,476,30,902,1038,2578,50,70
1209,405,24,1071,1076,3785,661,596,42,913,1847,4059,50,71
1654,499,29,1315,1394,4891,779,868,34,1066,2287,5034,50,72
1813,639,45,1333,1327,5157,862,848,61,1149,2460,5380,50,73
1666,677,27,1547,1394,5311,803,1058,106,1098,2431,5496,50,74
1186,641,27,1386,1269,4509,642,867,110,1210,1961,4790,50,75
662,907,55,1832,1291,4747,222,1105,76,1614,1845,4862,50,76
328,551,26,1468,998,3371,157,672,53,1231,1271,3384,50,77
1434,441,8,1223,1201,4307,749,702,21,1063,1930,4465,50,78
1756,463,10,1239,1232,4700,858,842,20,958,2216,4894,50,79
1794,481,20,1434,1421,5150,890,984,29,1108,2212,5223,50,80
1648,505,24,1277,1305,4759,858,862,40,1064,2104,4928,50,81
1219,563,25,1589,1344,4740,602,961,71,1226,2089,4949,50,82
379,555,34,1345,882,3195,161,791,65,862,1307,3186,50,83
443,490,21,1861,970,3785,185,717,24,1348,1728,4002,50,84
1363,499,10,1760,1206,4838,678,741,55,1135,2360,4969,50,85
1679,535,7,1745,1348,5314,750,1024,13,1140,2635,5562,50,86
1587,434,8,1429,1122,4580,748,707,21,996,2331,4803,50,87
1507,543,11,1635,1157,4853,745,768,26,1097,2319,4955,50,88
1395,682,44,1801,1473,5395,652,903,66,1495,2305,5421,50,89
550,678,40,2264,1312,4844,204,981,48,1578,1939,4750,50,90
380,457,4,1378,902,3121,163,552,11,1140,1335,3201,50,91
1235,466,9,1644,1096,4450,628,853,16,917,2056,4470,50,92
1744,398,14,1648,1205,5009,776,759,24,1077,2452,5088,50,93
1684,477,7,1419,1182,4769,778,938,15,998,2266,4995,50,94
1792,567,15,1849,1449,5672,845,1107,28,1178,2708,5866,50,95
1293,635,38,1843,1479,5288,624,1049,63,1307,2378,5421,50,96
608,609,24,1771,1038,4050,217,813,58,1380,1567,4035,50,97
480,455,8,1290,981,3214,195,563,17,1420,1155,3350,50,98
1234,462,18,1089,1102,3905,731,566,44,946,1608,3895,50,99
1475,483,11,1110,1236,4315,833,647,40,952,2016,4488,50,100
1525,564,9,1151,1274,4523,804,753,19,1069,2142,4787,50,101
1517,514,12,1111,1156,4310,821,724,22,1003,1871,4441,50,102
1192,614,30,1227,1162,4225,726,748,48,1056,1852,4430,50,103
511,698,28,1632,1255,4124,215,929,70,1449,1544,4207,50,104
353,529,18,1370,986,3256,160,524,15,1372,1193,3264,50,105
1257,406,16,1273,1164,4116,734,725,24,993,1787,4263,50,106
1724,511,12,1204,1246,4697,852,767,27,1088,2268,5002,50,107
1791,506,11,1135,1330,4773,890,822,23,1036,2204,4975,50,108
1679,699,6,1282,1316,4982,794,815,25,1114,2279,5027,50,109
1097,563,36,1299,1269,4264,643,786,43,1119,1740,4331,50,110
384,755,31,1727,1240,4137,234,993,72,1328,1618,4245,50,111
299,353,7,1225,776,2660,155,497,20,998,1035,2705,50,112
1258,444,9,1065,1070,3846,709,582,12,954,1705,3962,50,113
1595,485,25,1091,1329,4525,820,761,27,1032,2096,4736,50,114
1591,579,7,1165,1286,4628,809,851,17,1040,2062,4779,50,115
1617,508,11,1250,1338,4724,775,979,24,1158,2022,4958,50,116
1157,664,28,1242,1327,4418,666,898,52,1163,1912,4691,50,117
430,610,27,1423,1005,3495,205,675,91,1397,1226,3594,50,118
367,500,9,1617,1087,3580,192,595,36,1285,1151,3259,50,119
1215,487,5,1041,965,3713,714,545,9,910,1629,3807,50,120
1621,515,4,975,1135,4250,807,687,15,959,1908,4376,50,121
1693,556,15,1118,1291,4673,893,738,27,1092,2003,4753,50,122
1474,530,7,1143,1228,4382,810,744,18,1048,1965,4585,50,123
1027,715,29,1190,1207,4168,668,767,60,1132,1699,4326,50,124
369,500,35,1166,770,2840,174,601,43,944,1110,2872,50,125
296,460,5,962,716,2439,138,465,22,888,972,2485,50,126
1255,414,14,990,1137,3810,717,559,21,885,1804,3986,50,127
1620,555,37,1132,1408,4752,810,822,43,1052,2090,4817,50,128
1700,541,33,1173,1447,4894,862,906,32,1083,2112,4995,50,129
1483,534,15,1146,1250,4428,776,711,19,1080,1878,4464,50,130
1031,490,17,1162,1104,3804,672,607,50,1047,1569,3945,50,131
384,607,29,1345,1100,3465,221,601,62,1284,1397,3565,50,132
289,471,7,1055,880,2702,174,537,14,1055,1053,2833,50,133
1366,545,11,1097,1339,4358,707,799,25,1143,1884,4558,50,134
1637,406,10,1219,1142,4414,824,723,29,1019,1969,4564,50,135
1661,546,19,1169,1247,4642,840,851,28,974,2011,4704,50,136
1567,668,14,1245,1300,4794,827,868,22,1091,2089,4897,50,137
1173,662,25,1372,1206,4438,638,710,62,1304,1799,4513,50,138
352,497,58,1295,730,2932,175,620,70,983,1200,3048,50,139
502,569,13,1316,1008,3408,243,594,18,1451,1278,3584,50,140
1360,476,18,1268,1194,4316,722,727,28,1043,1846,4366,50,141
1947,555,20,1121,1346,4989,919,908,29,1076,2225,5157,50,142
1758,579,78,1245,1278,4938,915,850,86,993,2200,5044,50,143
1576,518,37,1131,1228,4490,805,763,49,1046,1888,4551,50,144
1020,716,31,1251,1199,4217,637,826,47,1118,1529,4157,50,145
416,784,45,1730,1276,4251,228,969,86,1521,1507,4311,50,146
384,685,11,1707,928,3715,210,704,17,1407,1440,3778,50,147
395,490,9,1283,678,2855,159,437,19,1116,1143,2874,50,148
1570,480,8,1159,1063,4280,784,665,17,1045,1896,4407,50,149
1633,456,14,1107,1092,4302,804,628,31,1015,2000,4478,50,150
1524,564,17,1338,1222,4665,837,798,22,1150,2000,4807,50,151
1143,721,40,1179,1221,4304,672,774,70,1079,1887,4482,50,152
453,737,26,1383,1186,3785,210,749,58,1441,1287,3745,50,153
295,554,8,1154,812,2823,203,537,11,1106,1070,2927,50,154
1339,498,25,1149,1264,4275,795,804,31,986,1756,4372,50,155
1655,576,26,1121,1400,4778,932,929,45,1018,2114,5038,50,156
1732,539,26,1187,1224,4708,966,836,34,1114,2058,5008,50,157
1646,603,20,1261,1422,4952,826,1010,38,1083,2102,5059,50,158
1310,690,38,1372,1469,4879,640,1070,98,1347,1795,4950,50,159
446,938,41,2042,1405,4872,292,1420,111,1438,1676,4937,50,160
288,579,14,1295,856,3032,165,663,28,1074,1250,3180,50,161
1427,502,17,1183,1117,4246,783,676,25,1018,2040,4542,50,162
1830,613,18,1240,1328,5029,899,819,36,1062,2267,5083,50,163
1897,641,87,1259,1474,5358,1003,965,102,1071,2431,5572,50,164
1760,643,24,1296,1298,5021,892,890,37,1103,2243,5165,50,165
1262,693,19,1317,1295,4586,629,937,79,1322,1726,4693,50,166
447,851,31,1477,1175,3981,244,943,42,1316,1447,3992,50,167
309,659,29,1342,773,3112,201,594,29,1142,1287,3253,50,168
1342,496,7,1152,1026,4023,726,672,15,963,1818,4194,50,169
1647,503,6,1285,1399,4840,838,896,31,1048,2039,4852,50,170
817,546,15,1429,1192,3999,472,770,33,1372,1379,4026,50,171
1602,609,11,1374,1095,4691,813,743,33,1021,2330,4940,50,172
1119,841,31,1329,1006,4326,631,742,50,1201,1906,4530,50,173
441,730,31,1378,841,3421,207,751,54,1122,1200,3334,50,174
328,562,25,1143,673,2731,220,581,53,946,1074,2874,50,175
1430,515,8,1134,1090,4177,790,731,26,1038,1923,4508,50,176
1703,605,9,1168,1199,4684,813,885,15,1051,2190,4954,50,177
1701,586,27,1127,1268,4709,848,876,40,1029,2166,4959,50,178
1524,622,23,1315,1195,4679,822,814,35,958,2090,4719,50,179
1165,769,37,1259,1066,4296,622,800,57,1089,1871,4439,50,180
450,646,27,1419,1091,3633,241,706,42,1391,1315,3695,50,181
298,441,4,1117,610,2470,172,400,9,880,1007,2468,50,182
1261,511,17,1165,1099,4053,731,806,27,991,1711,4266,50,183
1530,531,10,1094,1204,4369,845,775,15,961,1978,4574,50,184
1272,641,9,1282,1392,4596,756,936,36,1218,1861,4807,50,185
409,1637,23,1666,1304,5039,187,2081,42,1336,1317,4963,50,186
698,685,36,1383,1012,3814,450,908,62,1172,1422,4014,50,187
352,679,21,1260,911,3223,205,736,41,1146,1149,3277,50,188
307,472,8,1013,710,2510,159,414,30,979,979,2561,50,189
1287,429,14,1016,964,3710,706,659,21,856,1744,3986,50,190
1515,445,15,1035,1148,4158,855,731,25,878,1983,4472,50,191
1596,434,25,1084,1128,4267,895,653,27,931,1902,4408,50,192
1522,527,3,1133,1146,4331,828,816,22,958,1910,4534,50,193
1029,537,25,1171,1067,3829,533,749,67,881,1713,3943,50,194
256,1081,44,1359,1132,3872,184,1073,39,1355,1563,4214,50,195
269,383,19,1065,612,2348,165,476,23,948,880,2492,50,196
1299,371,23,1006,886,3585,715,666,37,788,1497,3703,50,197
1602,473,10,1058,1023,4166,789,680,15,856,1954,4294,50,198
1520,402,5,1039,994,3960,791,560,15,872,1846,4084,50,199
1447,663,11,1220,1211,4552,808,852,23,990,2080,4753,50,200
1121,703,27,1235,1290,4376,599,876,131,1184,1771,4561,50,201
342,673,25,1365,1092,3497,225,821,65,1241,1193,3545,50,202
288,519,7,1140,887,2841,172,504,19,1109,1145,2949,50,203
1302,448,11,1000,902,3663,702,573,20,898,1676,3869,50,204
1570,430,11,1093,1199,4303,825,768,12,940,1926,4471,50,205
1404,483,9,1204,1223,4323,832,873,25,999,1912,4641,50,206
1439,582,4,1291,1044,4360,746,691,15,925,2049,4426,50,207
975,653,22,1270,1020,3940,574,745,79,1069,1691,4158,50,208
340,789,29,1440,1125,3723,199,741,137,1385,1348,3810,50,209
335,537,10,1037,808,2727,174,530,36,1084,1055,2879,50,210
1236,394,10,1026,1053,3719,696,652,83,893,1569,3893,50,211
1493,472,9,970,1143,4087,813,688,17,838,1898,4254,50,212
1490,427,11,952,1041,3921,757,661,15,886,1892,4211,50,213
1392,535,6,1017,1088,4038,754,698,15,958,1843,4268,50,214
1055,575,33,1134,1088,3885,608,826,62,1010,1514,4020,50,215
400,493,34,1427,884,3238,209,639,55,1164,1225,3292,50,216
297,416,6,1145,742,2606,177,437,14,1056,965,2649,50,217
1166,445,7,1015,949,3582,668,568,19,846,1694,3795,50,218
1475,476,10,909,1213,4083,752,726,28,873,1938,4317,50,219
1459,448,12,1077,1118,4114,782,596,37,971,1882,4268,50,220
1311,398,6,905,981,3601,738,556,16,773,1612,3695,50,221
723,467,37,862,828,2917,472,685,82,722,1171,3132,50,222
307,719,29,1322,1094,3471,209,566,59,1440,1171,3445,50,223
249,531,3,1098,799,2680,174,534,10,1178,1073,2969,50,224
1250,394,10,918,1002,3574,721,530,11,905,1593,3760,50,225
1490,488,29,924,1145,4076,864,680,29,867,1867,4307,50,226
1463,501,32,986,1128,4110,839,623,28,923,1873,4286,50,227
1345,510,12,947,1113,3927,792,621,33,914,1726,4086,50,228
944,608,30,1157,1063,3802,610,614,48,1085,1565,3922,50,229
362,610,31,1151,874,3028,196,619,60,1134,1052,3061,50,230
242,401,6,919,729,2297,140,382,22,982,895,2421,50,231
1169,401,2,844,878,3294,696,495,10,890,1442,3533,50,232
1396,503,11,922,1181,4013,780,655,22,975,1804,4236,50,233
1468,482,13,956,1206,4125,845,701,29,865,1896,4336,50,234
1276,583,8,1007,1169,4043,782,593,18,900,1815,4108,50,235
900,699,28,1067,1042,3736,604,661,50,966,1616,3897,50,236
368,697,26,1311,1087,3489,184,738,33,1352,1257,3564,50,237
234,418,5,1072,757,2486,175,441,14,1020,849,2499,50,238
1107,417,7,957,1136,3624,725,691,12,906,1504,3838,50,239
1470,456,10,933,1167,4036,900,712,19,889,1753,4273,50,240
1439,468,19,951,1198,4075,816,680,27,898,1765,4186,50,241
1323,380,10,930,1039,3682,768,512,26,888,1667,3861,50,242
794,559,15,1108,1024,3500,572,796,77,927,1284,3656,50,243
392,608,31,1382,934,3347,178,749,44,1263,1268,3502,50,244
279,563,9,1198,787,2836,165,507,23,1043,1165,2903,50,245
270,502,4,1031,840,2647,189,407,13,1109,927,2645,50,246
1341,452,5,932,1075,3805,849,534,18,883,1692,3976,50,247
1484,453,29,937,1181,4084,905,551,41,964,1834,4295,50,248
1419,484,5,909,1101,3918,817,624,15,890,1898,4244,50,249
972,653,30,961,1073,3689,633,626,55,974,1523,3811,50,250
289,680,21,1263,1124,3377,213,799,109,1266,1087,3474,50,251
255,493,8,1019,786,2561,159,468,16,1138,941,2722,50,252
1283,451,5,885,1102,3726,776,586,17,868,1713,3960,50,253
1605,497,26,955,1256,4339,874,743,41,1019,2001,4678,50,254
1617,520,13,1038,1316,4504,905,868,21,871,1962,4627,50,255
1590,595,21,1160,1322,4688,851,881,31,979,1975,4717,50,256
1028,654,46,1206,1280,4214,691,836,63,1108,1702,4400,50,257
338,756,32,1518,1388,4032,231,777,95,1772,1305,4180,50,258
262,488,8,1200,1011,2969,185,424,22,1469,1162,3262,50,259
1229,427,33,975,1102,3766,868,545,29,907,1633,3982,50,260
1528,528,24,1027,1253,4360,963,679,25,1000,1882,4549,50,261
1579,573,19,999,1285,4455,972,767,34,909,1926,4608,50,262
1592,611,16,1067,1263,4549,849,813,29,1003,1981,4675,50,263
1219,629,23,1096,1241,4208,755,755,89,1088,1690,4377,50,264
372,661,37,1353,993,3416,231,707,55,1407,1219,3619,50,265
278,423,13,1050,772,2536,158,447,25,1032,940,2602,50,266
1305,392,17,977,1022,3713,780,610,32,920,1694,4036,50,267
1683,430,16,1052,1183,4364,876,671,33,996,1914,4490,50,268
1664,470,12,1053,1279,4478,912,807,24,951,2038,4732,50,269
1599,576,19,1181,1243,4618,888,802,32,1078,2021,4821,50,270
1048,545,29,1131,1208,3961,693,765,56,963,1594,4071,50,271
443,827,40,1616,1356,4282,261,1048,71,1661,1469,4510,50,272
315,400,16,1192,691,2614,170,476,14,1022,1006,2688,50,273
1201,347,14,1021,946,3529,736,512,19,872,1552,3691,50,274
1557,447,14,1008,1084,4110,855,637,23,881,1804,4200,50,275
1609,440,9,1000,1229,4287,874,630,15,958,1998,4475,50,276
1453,565,8,1117,1209,4352,727,770,20,988,1910,4415,50,277
1094,598,20,1240,1076,4028,623,713,65,1081,1703,4185,50,278
394,796,34,1494,1064,3782,235,732,74,1403,1500,3944,50,279
366,444,6,1237,860,2913,152,466,33,1238,1269,3158,50,280
1368,459,7,1032,1086,3952,769,605,13,935,1905,4227,50,281
1719,501,11,1224,1271,4726,933,718,17,1022,2228,4918,50,282
1716,526,17,1230,1287,4776,945,712,36,1103,2190,4986,50,283
1550,600,15,1360,1320,4845,806,834,37,1130,2134,4941,50,284
1103,744,41,1417,1303,4608,660,752,51,1320,2028,4811,50,285
626,834,27,1853,1374,4714,267,1008,40,1732,1946,4993,50,286
658,643,9,1513,1224,4047,166,723,30,1912,1513,4344,50,287
946,468,8,1385,1106,3913,488,669,25,1297,1628,4107,50,288
2079,522,15,1350,1245,5211,880,942,20,1130,2482,5454,50,289
2033,541,8,1345,1226,5153,886,676,27,1136,2480,5205,50,290
1743,525,12,1236,1360,4876,851,868,25,1075,2238,5057,50,291
1273,710,31,1384,1267,4665,692,816,56,1244,2007,4815,50,292
416,761,43,1414,1241,3875,169,828,84,1530,1396,4007,50,293
331,485,4,1358,960,3138,178,610,22,1265,1143,3218,50,294
1310,430,10,1114,1142,4006,761,609,15,992,1865,4242,50,295
1723,566,7,1001,1189,4486,868,638,22,1001,2202,4731,50,296
1631,519,10,1096,1382,4638,882,782,19,1042,2187,4912,50,297
1548,575,13,1202,1361,4699,913,793,23,1111,2157,4997,50,298
1105,772,37,1483,1378,4775,740,886,77,1464,2007,5174,50,299
492,791,46,1879,1331,4539,270,833,79,2010,1663,4855,50,300
1611,427,11,1778,1106,4933,254,691,38,2229,1682,4894,50,301
1362,420,16,1339,1230,4367,756,600,21,999,1897,4273,50,302
1676,435,13,1239,1734,5097,915,1078,26,1089,1972,5080,50,303
1628,455,76,1031,1399,4589,916,686,69,1064,2005,4740,50,304
1353,743,19,1015,1213,4343,763,758,32,1010,1966,4529,50,305
1027,680,27,1103,1107,3944,623,629,47,1128,1641,4068,50,306
316,658,27,1507,1201,3709,206,768,45,1446,1397,3862,50,307
288,363,10,1104,815,2580,200,358,15,1155,915,2643,50,308
1259,342,7,982,1056,3646,765,484,21,875,1642,3787,50,309
1298,379,24,935,1063,3699,810,417,51,1003,1584,3865,50,310
1345,407,20,898,1231,3901,867,556,36,919,1650,4028,50,311
1444,509,18,972,1241,4184,807,611,23,995,1888,4324,50,312
1018,560,36,1072,1147,3833,627,664,74,1121,1532,4018,50,313
373,634,55,1426,1199,3687,248,562,71,1575,1309,3765,50,314
299,365,16,1194,773,2647,191,351,24,1076,1069,2711,50,315
631,370,24,1069,979,3073,443,423,34,1193,1148,3241,50,316
1573,406,20,899,1294,4192,893,589,29,990,2015,4516,50,317
1685,400,17,1018,1321,4441,925,684,26,939,1959,4533,50,318
1545,482,21,970,1139,4157,891,651,30,926,1886,4384,50,319
1126,530,39,1145,1164,4004,653,590,48,1103,1673,4067,50,320
340,621,35,1356,1156,3508,255,524,61,1443,1380,3663,50,321
284,373,4,1076,910,2647,180,416,14,1173,897,2680,50,322
1277,377,23,941,1122,3740,755,478,47,913,1666,3859,50,323
1695,409,12,943,1236,4295,944,655,29,992,2047,4667,50,324
1657,390,7,1005,1236,4295,922,572,21,982,2017,4514,50,325
1561,446,12,1067,1301,4387,841,659,32,1010,1840,4382,50,326
1149,454,26,950,987,3566,660,583,43,844,1414,3544,50,327
361,734,26,1206,961,3288,196,608,82,1159,1320,3365,50,328
253,379,7,1065,762,2466,153,378,13,955,991,2490,50,329
1287,354,15,1066,978,3700,737,443,25,957,1653,3815,50,330
1171,406,24,1012,1053,3666,699,533,23,1032,1664,3951,50,331
803,387,11,1228,935,3364,566,467,31,1212,1314,3590,50,332
183,241,7,520,266,1217,99,174,12,490,479,1254,50,333
391,425,12,1320,790,2938,315,413,36,1168,1203,3135,50,334
229,413,25,1045,800,2512,185,384,42,942,976,2529,50,335
198,291,3,818,615,1925,179,400,16,789,720,2104,50,336
1164,309,26,840,964,3303,654,462,34,889,1522,3561,50,337
1623,394,11,857,1181,4066,790,666,24,876,1990,4346,50,338
1561,375,13,882,1133,3964,843,585,26,947,1758,4159,50,339
1571,399,11,882,1156,4019,794,751,23,887,1834,4289,50,340
994,472,27,1056,1098,3647,669,568,50,965,1544,3796,50,341
317,1117,33,1747,1497,4711,274,701,78,2144,1782,4979,50,342
261,395,16,1107,958,2737,208,492,26,1070,959,2755,50,343
1312,409,10,929,1102,3762,724,661,25,909,1728,4047,50,344
1849,425,15,1054,1188,4531,841,729,29,1035,2098,4732,50,345
1787,391,8,973,1086,4245,865,793,14,850,1875,4397,50,346
1755,527,7,1160,1369,4818,795,870,32,1058,2051,4806,50,347
1128,657,23,1299,1171,4278,664,756,61,1158,1824,4463,50,348
684,667,46,1974,1483,4854,223,1032,98,2393,1348,5094,50,349
242,318,5,1009,689,2263,168,350,12,947,772,2249,50,350
1174,374,8,904,946,3406,657,464,18,827,1498,3464,50,351
1483,457,11,976,1174,4101,800,640,22,941,1826,4229,50,352
1438,376,20,944,1035,3813,754,542,22,900,1741,3959,50,353
1287,452,16,896,1140,3791,700,641,24,951,1675,3991,50,354
842,488,24,1019,960,3333,560,639,59,880,1319,3457,50,355
259,383,19,964,884,2509,191,447,34,965,1026,2663,50,356
186,284,7,924,700,2101,130,375,19,761,810,2095,50,357
603,319,20,960,789,2691,452,456,22,854,1039,2823,50,358
343,183,20,710,483,1739,310,190,27,700,621,1848,50,359
93,207,9,369,271,949,81,163,16,363,349,972,50,360
420,368,15,935,702,2440,319,452,19,837,929,2556,50,361
515,405,12,1252,890,3074,387,463,40,1053,1248,3191,50,362
235,477,24,1146,706,2588,132,463,42,943,992,2572,50,363
260,341,23,1218,819,2661,151,419,45,1022,980,2617,50,364
733,400,13,1281,1002,3429,481,540,20,1119,1392,3552,50,365
612,1033,1409,1090,1036,5180,407,1432,510,1183,1895,5427,50,366
218,283,8,941,1390,2840,272,228,12,1545,608,2665,51,1
947,502,42,1615,4374,7480,3377,301,42,2428,1363,7511,51,2
1216,657,78,1634,5077,8662,4197,445,79,2374,1531,8626,51,3
1204,662,69,1646,4631,8212,3743,473,70,2527,1721,8534,51,4
886,829,133,1500,3079,6427,2250,570,115,2126,1573,6634,51,5
228,508,57,1073,1616,3482,350,458,63,1953,710,3534,51,6
223,447,52,1151,1449,3322,336,487,74,1726,817,3440,51,7
1275,569,58,1516,3921,7339,3353,438,43,1925,1436,7195,51,8
1423,530,40,2250,4432,8675,4771,412,46,1982,1344,8555,51,9
1433,683,35,1761,5965,9877,5182,480,39,2321,1822,9844,51,10
1339,850,72,1707,5295,9263,4586,537,72,2246,1876,9317,51,11
856,555,94,2039,2869,6413,2376,486,88,2234,1407,6591,51,12
174,537,62,1308,2338,4419,445,445,52,2753,1350,5045,51,13
148,412,35,1203,1923,3721,299,335,33,2243,937,3847,51,14
264,334,25,1071,1266,2960,435,272,37,1674,626,3044,51,15
472,360,58,836,913,2639,930,286,62,864,565,2707,51,16
1076,703,109,1661,4597,8146,3986,433,80,2233,1482,8214,51,17
1474,750,30,1899,5544,9697,4879,761,26,2491,1684,9841,51,18
824,629,85,1344,1983,4865,1445,543,61,2166,1028,5243,51,19
240,423,52,1499,1773,3987,386,340,49,2322,955,4052,51,20
170,399,55,910,1323,2857,279,330,55,1486,681,2831,51,21
1220,541,30,1491,4171,7453,3697,331,28,1912,1487,7455,51,22
1482,770,58,1873,6345,10528,5878,346,47,2381,1724,10376,51,23
1388,1053,57,1830,6311,10639,5948,590,61,2285,1853,10737,51,24
1380,782,76,1855,5353,9446,4830,510,47,2273,1809,9469,51,25
840,866,105,1953,3195,6959,2678,583,80,2208,1442,6991,51,26
173,689,82,1366,2169,4479,369,469,42,2751,1250,4881,51,27
165,338,35,1017,1218,2773,283,273,42,1579,662,2839,51,28
1212,579,40,1619,4560,8010,3993,331,50,1995,1494,7863,51,29
1446,753,70,1632,6792,10693,6112,387,73,2180,1827,10579,51,30
1440,874,46,1956,6467,10783,6131,450,49,2169,1868,10667,51,31
1353,759,102,1839,5469,9522,5027,452,118,2148,1667,9412,51,32
944,817,130,1798,3134,6823,2781,589,102,2047,1532,7051,51,33
266,621,145,1170,2248,4450,377,503,102,2734,1316,5032,51,34
205,374,42,1006,1384,3011,278,349,46,1695,732,3100,51,35
1217,544,78,1490,4438,7767,3869,361,84,1842,1565,7721,51,36
1538,845,152,1766,6446,10747,5944,518,126,2214,1845,10647,51,37
1561,785,86,2072,6541,11045,6042,482,78,2645,1894,11141,51,38
1382,764,90,1820,5485,9541,5074,482,80,2310,1773,9719,51,39
978,914,112,1853,3282,7139,2748,635,81,2139,1697,7300,51,40
224,2419,135,1351,4208,8337,467,671,68,3509,3731,8446,51,41
168,351,15,1049,1418,3001,232,303,23,1689,777,3024,51,42
1165,530,60,1659,4360,7774,3749,393,58,2006,1493,7699,51,43
1596,793,73,1739,5789,9990,5334,472,63,2136,1700,9705,51,44
1508,785,64,2086,6507,10950,5873,536,77,2692,1934,11112,51,45
1332,772,46,2272,5648,10070,5096,457,48,2447,1846,9894,51,46
820,1396,179,2352,3095,7842,2634,803,132,2648,1843,8060,51,47
310,1130,164,1758,2493,5855,506,997,90,3150,1725,6468,51,48
352,617,96,1709,2247,5021,435,683,93,3027,1348,5586,51,49
590,433,43,1534,1826,4426,713,322,42,2526,938,4541,51,50
1424,776,50,1845,6295,10390,5529,455,49,2551,1786,10370,51,51
1485,914,41,2072,6820,11332,6059,538,42,2820,1909,11368,51,52
1433,882,25,2034,5746,10120,5224,543,30,2487,1947,10231,51,53
967,781,85,2038,3625,7496,2889,516,65,2576,1579,7625,51,54
209,1386,131,1453,2508,5687,421,829,67,2836,1641,5794,51,55
229,434,40,1085,1650,3438,379,353,36,1945,918,3631,51,56
1227,693,40,1760,4698,8418,4107,415,38,2110,1661,8331,51,57
1479,766,40,2118,6694,11097,6164,540,47,2491,1876,11118,51,58
1493,756,103,2138,6590,11080,6140,456,109,2507,2073,11285,51,59
1447,955,81,2143,5577,10203,5041,632,97,2584,1954,10308,51,60
957,1794,177,2143,3466,8537,2863,1101,101,2477,2217,8759,51,61
194,694,70,1366,2208,4532,432,497,50,2663,1274,4916,51,62
208,606,43,1453,2098,4408,359,428,51,2602,1105,4545,51,63
1186,682,43,1741,4682,8334,4022,451,40,2370,1660,8543,51,64
1537,1082,39,2120,6853,11631,6068,526,47,2927,2154,11722,51,65
1483,1016,56,2114,7152,11821,6262,560,26,2848,2023,11719,51,66
1446,935,40,2255,5882,10558,5189,635,52,2874,1972,10722,51,67
1026,875,98,2174,3966,8139,3095,634,78,2708,1798,8313,51,68
278,554,98,1556,2491,4977,489,519,69,3125,1199,5401,51,69
213,483,50,1468,2435,4649,400,431,61,2765,1242,4899,51,70
1310,859,130,2185,5689,10173,4224,520,107,3382,2038,10271,51,71
1665,1704,86,2518,7719,13692,6337,886,100,4113,2743,14179,51,72
1641,2066,101,2620,7822,14250,6450,934,79,4219,2818,14500,51,73
1444,1433,57,2801,6758,12493,5345,694,76,4055,2613,12783,51,74
1004,996,129,2289,4812,9230,2807,710,94,3554,2183,9348,51,75
402,2041,134,3031,5865,11473,960,812,83,7182,3197,12234,51,76
303,902,17,1858,3151,6231,631,512,20,4009,1548,6720,51,77
1226,1006,74,2475,5520,10301,4012,543,72,3621,2251,10499,51,78
1706,1311,91,2744,8039,13891,6309,739,90,4015,2703,13856,51,79
1567,1704,69,3056,8301,14697,6533,735,71,4207,3277,14823,51,80
1574,1874,52,2751,7156,13407,5466,916,43,4186,3063,13674,51,81
1063,2045,170,2898,5376,11552,3226,918,84,4475,3272,11975,51,82
166,1296,113,1732,3525,6832,544,773,65,4180,2245,7807,51,83
277,1662,49,3100,5791,10879,863,577,49,6647,2986,11122,51,84
1276,1477,73,2751,6977,12554,4192,747,84,5254,2715,12992,51,85
1676,1535,53,2969,8948,15181,6256,727,51,5513,3137,15684,51,86
1554,1161,53,3154,8004,13926,5951,673,38,4797,2449,13908,51,87
1395,1316,44,2964,7110,12829,4898,734,46,4751,2621,13050,51,88
946,1939,111,3268,5771,12035,3038,905,50,5466,3022,12481,51,89
292,3442,135,3486,7620,14975,712,1442,49,7399,3599,13201,51,90
300,1043,23,2036,3318,6720,607,562,24,4081,1762,7036,51,91
1213,942,42,2679,5804,10680,3725,669,37,4184,2214,10829,51,92
1610,973,16,2860,8418,13877,6097,587,22,4829,2390,13925,51,93
1616,1093,23,3006,8584,14322,6122,735,32,4705,2355,13949,51,94
1504,1226,47,2918,8093,13788,5343,840,57,4661,2557,13458,51,95
1025,1182,71,2998,5351,10627,3134,892,51,4422,2126,10625,51,96
287,1307,119,2508,3466,7687,686,885,37,4555,1934,8097,51,97
301,909,15,2164,2532,5921,1009,475,21,3438,1494,6437,51,98
1178,1400,52,2154,5615,10399,4105,733,60,3858,2077,10833,51,99
1575,1033,68,2417,7259,12352,5930,574,61,3414,2247,12226,51,100
1598,1248,39,2644,7682,13211,6246,605,40,3830,2279,13000,51,101
1428,1079,33,2354,6496,11390,5422,718,33,3393,2175,11741,51,102
1098,1078,76,2344,4380,8976,3021,708,53,3349,1894,9025,51,103
288,1371,109,2005,3487,7260,791,770,63,4243,2072,7939,51,104
234,959,41,1680,2821,5735,571,579,36,3534,1408,6128,51,105
1142,945,66,2328,5330,9811,3991,545,63,3534,2028,10161,51,106
1476,1478,62,2501,7158,12675,5990,695,49,3762,2548,13044,51,107
1393,1140,56,2721,6184,11494,6322,537,62,3630,3129,13680,51,108
1370,1371,46,2543,6297,11627,5171,685,75,3719,2341,11991,51,109
1078,1044,84,2478,4353,9037,3070,783,38,3246,1911,9048,51,110
259,2760,115,1768,4026,8928,626,1421,82,4010,2799,8938,51,111
187,1034,30,1579,2081,4911,420,617,34,2722,1354,5147,51,112
1263,800,38,2395,5181,9677,4186,505,31,3217,1906,9845,51,113
1622,1032,47,2451,7227,12379,6311,729,52,3254,2241,12587,51,114
1577,1232,53,2655,7320,12837,6451,775,49,3477,2233,12985,51,115
1609,1832,43,2929,6547,12960,5600,977,39,3828,2688,13132,51,116
990,1652,130,2262,4403,9437,3042,930,69,3342,2379,9762,51,117
199,1075,101,1903,2499,5777,551,750,117,3392,1453,6263,51,118
196,861,27,1531,2365,4980,422,569,130,3093,1378,5592,51,119
1226,845,53,2133,4945,9202,4157,523,37,2768,1816,9301,51,120
1529,1341,71,2349,6815,12105,6261,668,69,2949,2373,12320,51,121
1534,1888,28,2626,7037,13113,6458,736,26,3246,2785,13251,51,122
1437,1602,47,2378,5727,11191,5071,791,40,2971,2371,11244,51,123
1026,1086,110,2217,4161,8600,3049,792,66,2962,1840,8709,51,124
258,873,76,1530,2068,4805,517,652,57,2501,1210,4937,51,125
225,1362,25,1330,1804,4746,423,503,29,2369,1549,4873,51,126
1298,905,53,1975,5040,9271,4184,493,54,2732,1845,9308,51,127
1515,1216,40,2361,7142,12274,6312,676,43,3032,2161,12224,51,128
1595,1511,75,2543,7327,13051,6380,968,75,3343,2382,13148,51,129
1452,1130,60,2415,5935,10992,5416,583,64,3102,2138,11303,51,130
970,1570,135,2082,3881,8638,2917,941,94,2836,2169,8957,51,131
280,788,65,1651,2348,5132,504,492,38,3191,1364,5589,51,132
195,679,11,1133,1814,3832,451,406,21,2240,945,4063,51,133
1167,1349,33,1971,5123,9643,4044,655,38,2763,2126,9626,51,134
1600,965,39,2546,7394,12544,6216,589,54,3490,2281,12630,51,135
1583,1347,77,2393,7529,12929,6458,715,71,3312,2256,12812,51,136
1485,1347,39,2338,6431,11640,5377,837,41,3404,2288,11947,51,137
1056,1068,82,2330,4071,8607,2990,769,60,3151,1916,8886,51,138
237,957,110,1591,2489,5384,530,676,61,3095,1239,5601,51,139
258,962,49,1384,2503,5156,511,551,58,3060,1395,5575,51,140
1458,1233,52,2079,5714,10536,4467,732,49,3099,2142,10489,51,141
1629,1355,50,2504,7640,13178,6471,801,59,3357,2377,13065,51,142
1539,1291,64,3009,7308,13211,6429,730,61,3642,2425,13287,51,143
1320,1126,40,2161,6031,10678,5097,636,40,3176,2087,11036,51,144
857,1280,120,2621,3524,8402,2555,917,82,3400,1940,8894,51,145
250,1454,88,1941,3126,6859,669,1028,55,3833,1653,7238,51,146
313,1362,24,2058,3109,6866,537,767,28,3764,1843,6939,51,147
293,669,28,1719,2563,5272,591,445,38,3074,1153,5301,51,148
1441,950,43,2559,6611,11604,5635,654,45,3256,2127,11717,51,149
1567,1036,36,2536,7414,12589,6207,612,41,3589,2131,12580,51,150
1458,1725,60,2510,6301,12054,5191,876,68,3387,2647,12169,51,151
1145,1467,257,2234,4201,9304,2891,859,99,3224,2402,9475,51,152
374,1408,113,1683,2741,6319,618,817,56,3463,1694,6648,51,153
234,800,27,1459,2109,4629,541,446,19,2774,1198,4978,51,154
1276,955,67,2190,5768,10256,4434,647,76,3141,2064,10362,51,155
1646,1242,96,2536,7832,13352,6750,755,97,3470,2283,13355,51,156
1561,1286,30,2709,7865,13451,6672,824,31,3849,2250,13626,51,157
1510,1852,54,2557,6775,12748,5479,1111,54,3524,2655,12823,51,158
1058,1437,170,2706,4819,10190,3125,1118,112,3991,2152,10498,51,159
324,2999,176,2335,4001,9835,753,1924,79,4083,2658,9497,51,160
225,1132,22,1825,3060,6264,464,596,30,3482,1566,6138,51,161
1246,1081,46,2232,6075,10680,4424,690,63,3613,1984,10774,51,162
1654,2787,35,2697,8309,15482,6815,1177,36,4127,3138,15293,51,163
1496,2844,82,2779,8458,15659,6848,1232,77,4172,3227,15556,51,164
1515,1522,76,2670,6917,12700,5551,836,65,3889,2555,12896,51,165
994,2787,136,2671,4664,11252,3023,1541,74,3710,3082,11430,51,166
301,2107,128,1846,3163,7545,626,1127,73,3648,2274,7748,51,167
294,875,47,1584,2238,5038,484,538,42,2741,1401,5206,51,168
1309,991,45,2349,5772,10466,4238,569,45,3419,1975,10246,51,169
1474,1462,40,3347,6831,13154,5818,1088,48,3830,2206,12990,51,170
495,1253,50,2048,3070,6916,873,774,45,3507,1734,6933,51,171
1416,1355,84,2969,6513,12337,5105,747,95,3933,2547,12427,51,172
931,1248,81,2487,4455,9202,2925,980,55,3516,1894,9370,51,173
279,5446,341,2006,2834,10906,700,3461,99,3792,3256,11308,51,174
236,1122,17,1485,2290,5150,551,603,16,2829,1417,5416,51,175
1254,993,90,2181,5750,10268,4234,619,95,3282,2127,10357,51,176
1520,1403,48,2572,7928,13471,6559,773,46,3814,2361,13553,51,177
1506,1442,42,2820,7979,13789,6446,679,48,4083,2492,13748,51,178
1483,1947,67,2728,7177,13402,5458,978,69,4086,2833,13424,51,179
978,1420,114,2727,4672,9911,3077,889,64,4126,2052,10208,51,180
286,1340,117,2150,3484,7377,718,926,48,4172,1718,7582,51,181
268,1578,30,1506,2738,6120,529,667,30,3089,1845,6160,51,182
1183,956,161,2288,6023,10611,4154,735,178,3537,2097,10701,51,183
1448,1946,134,2629,7435,13592,5659,938,123,3892,3072,13684,51,184
1256,1598,34,3816,5518,12222,4439,1218,30,4388,2416,12491,51,185
415,13448,81,2683,4233,20860,740,9861,73,5404,4822,20900,51,186
752,1416,70,2720,4313,9271,1881,1072,38,4324,1997,9312,51,187
332,1323,108,2107,3201,7071,567,899,40,3754,1691,6951,51,188
230,813,57,1509,2274,4883,425,510,65,2772,1218,4990,51,189
1197,912,34,2338,5572,10053,3971,597,35,3061,1797,9461,51,190
1198,1084,57,2576,6565,11480,5046,646,66,3503,1932,11193,51,191
1113,1286,31,2488,6282,11200,4872,586,33,3457,2123,11071,51,192
1069,1357,35,2474,5850,10785,4358,754,44,3678,2135,10969,51,193
813,1121,73,2419,4316,8742,2739,764,39,3413,1888,8843,51,194
264,1483,100,2037,3844,7728,562,1113,55,3952,2122,7804,51,195
236,1058,46,1584,2359,5283,509,495,49,2822,1569,5444,51,196
1267,835,44,2257,5835,10238,4327,557,52,3372,1953,10261,51,197
1564,1141,33,2546,7645,12929,6022,641,30,3663,2208,12564,51,198
1507,1159,29,2469,7658,12822,6112,564,35,3630,2263,12604,51,199
1416,1605,43,2687,6692,12443,5335,769,32,3726,2382,12244,51,200
957,1377,167,2420,4655,9576,2980,977,96,3410,2231,9694,51,201
270,1241,109,1971,3218,6809,636,982,57,3801,1755,7231,51,202
218,979,49,1738,2402,5386,466,534,51,3214,1464,5729,51,203
1206,874,59,2340,5695,10174,4332,566,60,3403,1826,10187,51,204
1467,1249,55,2697,7693,13161,6166,765,62,3900,2490,13383,51,205
1379,2396,63,2912,7202,13952,5207,1368,63,4333,3190,14161,51,206
1389,1321,74,2871,6686,12341,5045,683,83,4090,2586,12487,51,207
952,1369,155,2484,4464,9424,2970,895,130,3796,2211,10002,51,208
309,1535,148,1607,3204,6803,607,901,116,3717,1922,7263,51,209
253,1859,15,1710,2473,6310,479,966,22,3221,1623,6311,51,210
1226,1013,46,2398,5717,10400,4150,843,39,3270,2005,10307,51,211
1452,1388,35,2455,7522,12852,6137,745,29,3609,2411,12931,51,212
1518,1123,61,2569,7379,12650,6027,666,66,3817,2059,12635,51,213
1296,1644,42,2710,6379,12071,4940,811,44,3896,2342,12033,51,214
954,2169,147,2716,4517,10503,2897,1479,77,3658,2501,10612,51,215
359,921,72,2090,2961,6403,556,696,62,3530,1651,6495,51,216
271,791,12,1687,2286,5047,415,553,23,2866,1363,5220,51,217
1224,921,16,2305,5265,9731,3888,675,25,3334,1853,9775,51,218
1499,1128,92,2565,7083,12367,5734,755,107,3545,2249,12390,51,219
1517,1456,55,2523,7177,12728,5747,921,38,3498,2445,12649,51,220
1246,899,63,2465,5978,10651,4528,592,66,3416,1884,10486,51,221
704,1179,100,1918,3474,7375,2254,845,65,2828,1778,7770,51,222
272,2493,126,1625,2686,7202,536,1212,74,3101,2222,7145,51,223
290,807,29,1472,2208,4806,460,556,37,2583,1318,4954,51,224
1135,824,34,1986,4928,8907,3707,541,45,2804,1783,8880,51,225
1419,1711,76,2365,6902,12473,5645,768,83,3238,2496,12230,51,226
1523,1414,97,2361,6792,12187,5626,832,89,3446,2475,12468,51,227
1253,2064,70,2360,5801,11548,4569,1033,60,3329,2780,11771,51,228
978,1582,79,2284,3699,8622,2660,909,60,3238,2056,8923,51,229
258,1369,85,1566,2630,5908,541,700,41,3099,1823,6204,51,230
208,1178,47,1298,1900,4631,371,603,49,2496,1542,5061,51,231
1219,730,54,2062,4780,8845,3729,517,55,2817,1706,8824,51,232
1432,1180,91,2306,6830,11839,5623,896,83,3260,2168,12030,51,233
1408,1163,51,2263,6849,11734,5588,694,52,3249,2169,11752,51,234
1291,1130,27,2420,5601,10469,4464,671,38,3302,2062,10537,51,235
923,1073,241,2048,3617,7902,2587,764,73,2662,1793,7879,51,236
327,1435,125,1479,2624,5990,614,855,78,2774,1789,6110,51,237
216,685,32,1336,1878,4147,425,427,81,2436,1091,4460,51,238
1312,715,23,1824,4780,8654,3891,643,23,2538,1712,8807,51,239
1552,1088,75,2296,6948,11959,6085,753,78,2920,2138,11974,51,240
1428,1051,56,2234,7001,11770,5804,777,53,2931,1952,11517,51,241
1246,691,17,2200,5603,9757,4762,494,27,2676,1776,9735,51,242
879,1186,107,2706,3331,8209,2560,828,63,3085,1854,8390,51,243
251,1444,72,1794,2888,6449,578,804,50,3818,1814,7064,51,244
203,1970,43,1544,2731,6491,423,818,45,3229,1883,6398,51,245
246,659,20,1443,2270,4638,466,477,25,2687,1070,4725,51,246
1419,771,71,1957,6168,10386,5536,498,63,2544,1966,10607,51,247
1505,872,33,2078,6648,11136,6154,495,30,2579,2007,11265,51,248
1404,867,70,2045,5803,10189,5057,517,70,2631,1886,10161,51,249
979,1394,124,2084,3478,8059,2901,918,66,2585,1867,8337,51,250
246,1339,107,1718,2580,5990,510,901,93,2971,1480,5955,51,251
221,964,29,1201,1839,4254,355,413,34,2212,1279,4293,51,252
1254,1811,57,1821,5231,10174,4438,870,51,2577,2824,10760,51,253
1554,1037,79,1968,7338,11976,6453,623,69,2636,1999,11780,51,254
1364,1470,24,2334,7486,12678,6577,902,28,2890,2319,12716,51,255
1395,1415,32,2136,6250,11228,5543,712,38,2777,2321,11391,51,256
993,1983,98,2158,4053,9285,3146,1224,52,2888,2276,9586,51,257
256,1350,690,1788,2665,6749,513,1061,60,3234,2109,6977,51,258
234,774,99,1611,1942,4660,487,584,55,2592,1505,5223,51,259
1216,1120,61,1927,5066,9390,4298,631,71,2402,1967,9369,51,260
1537,1410,38,2072,7825,12882,6644,647,45,2866,2530,12732,51,261
1526,2047,35,2317,7277,13202,6503,925,33,3248,2714,13423,51,262
1403,1186,36,2243,6442,11310,5567,623,39,3091,2286,11606,51,263
979,1905,108,2264,4047,9303,3089,974,65,3097,2338,9563,51,264
269,1139,762,1649,2514,6333,503,1255,66,3251,1722,6797,51,265
237,1159,20,1282,1947,4645,402,573,26,2510,1379,4890,51,266
1324,1486,43,2119,5165,10137,4430,879,43,2785,2137,10274,51,267
1642,1663,47,2205,7882,13439,6607,1046,49,3069,2680,13451,51,268
1668,1574,85,2436,7525,13288,6603,849,72,3181,2486,13191,51,269
1488,1473,95,2346,6248,11650,5336,754,82,3283,2444,11899,51,270
1041,1485,132,2461,4159,9278,3230,954,78,3318,2162,9742,51,271
362,1583,140,1974,3182,7241,693,1054,70,3672,1977,7466,51,272
262,676,34,1648,2232,4852,447,404,40,2849,1209,4949,51,273
1336,1895,34,2074,5156,10495,4423,826,43,2677,2491,10460,51,274
1654,2100,67,2335,7179,13335,6478,876,72,3180,2763,13369,51,275
1618,1791,51,2389,7234,13083,6380,739,58,3334,2737,13248,51,276
1466,1370,45,2194,6246,11321,5064,754,51,3299,2398,11566,51,277
1022,1612,91,2298,4313,9336,3019,1000,53,3299,2206,9577,51,278
312,2295,148,1767,4841,9363,700,981,71,5333,3154,10239,51,279
309,1054,69,1433,2345,5210,485,592,68,2745,1554,5444,51,280
1279,1339,50,2155,5493,10316,4399,594,62,3020,2523,10598,51,281
1680,1404,67,2405,7650,13206,6589,793,66,3467,2506,13421,51,282
1538,1305,41,2708,7587,13179,6676,680,45,3632,2437,13470,51,283
1377,1520,53,2851,6281,12082,5323,612,53,3767,2627,12382,51,284
824,1996,95,2757,4383,10055,2842,1054,50,3907,2573,10426,51,285
322,1774,91,2038,4051,8276,1354,872,45,4885,2293,9449,51,286
707,1065,27,2004,2854,6657,993,575,41,3937,1461,7007,51,287
600,852,62,1796,2952,6262,905,618,56,3279,1513,6371,51,288
1718,888,52,2713,7408,12779,6101,644,47,3711,2324,12827,51,289
1718,1972,31,2744,7554,14019,6488,1054,29,3716,2702,13989,51,290
1525,1484,32,2351,6823,12215,5298,934,26,3529,2513,12300,51,291
1140,1448,172,2593,4635,9988,3095,1029,274,3827,2286,10511,51,292
336,1520,257,1941,3215,7269,619,1249,96,3889,1936,7789,51,293
230,816,11,1569,2476,5102,442,743,14,2880,1329,5408,51,294
1217,2238,48,2003,5579,11085,4471,1021,55,2856,2802,11205,51,295
1646,1056,84,2340,7310,12436,6515,636,69,3037,2145,12402,51,296
1625,1641,39,2668,7265,13238,6397,901,50,3580,2495,13423,51,297
1456,1544,88,2442,6619,12149,5479,1054,85,3340,2414,12372,51,298
1018,1051,135,2743,4142,9089,3170,885,130,3650,2000,9835,51,299
364,1236,158,2001,3305,7064,677,905,124,4247,1825,7778,51,300
979,1453,55,3562,2364,8413,1138,889,64,4200,1980,8271,51,301
1317,1003,87,2161,5411,9979,4166,630,83,3225,2116,10220,51,302
1499,1739,49,2859,6690,12836,6025,900,49,3268,2452,12694,51,303
1517,976,64,2734,7250,12541,6376,678,66,3277,2121,12518,51,304
1362,1158,114,2375,5223,10232,4544,829,99,2806,1945,10223,51,305
967,1454,81,2080,3562,8144,2682,1002,59,2787,2075,8605,51,306
204,1689,124,1689,2915,6621,502,688,81,3238,2460,6969,51,307
306,530,20,1390,1913,4159,471,400,24,2356,951,4202,51,308
1184,633,71,2086,4841,8815,4130,487,67,2419,1597,8700,51,309
1278,695,66,2298,4767,9104,4562,426,104,2459,1531,9082,51,310
1249,1031,90,2141,5394,9905,4970,662,86,2438,1916,10072,51,311
1418,944,68,2141,5857,10428,5264,576,75,2579,2048,10542,51,312
936,1569,125,2568,3490,8688,2979,1030,117,3113,2064,9303,51,313
286,867,83,1791,2867,5894,518,597,54,3937,1637,6743,51,314
232,1090,60,1505,2246,5133,425,558,57,2722,1667,5429,51,315
468,546,35,1421,1988,4458,674,496,42,2244,1039,4495,51,316
1620,1046,113,2199,6852,11830,6426,678,75,2700,2202,12081,51,317
1558,1200,134,2276,7376,12544,6871,722,90,2787,2374,12844,51,318
1451,1024,79,2198,6557,11309,5550,571,74,2795,2078,11068,51,319
1104,1913,144,2198,3775,9134,3065,1018,64,2714,2497,9358,51,320
242,1119,101,1644,2876,5982,528,685,51,3326,1758,6348,51,321
165,1015,42,1183,1904,4309,378,631,36,2318,1214,4577,51,322
1271,1264,43,1799,5193,9570,4569,652,49,2266,2192,9728,51,323
1562,1181,39,2243,7597,12622,6859,684,38,2872,2213,12666,51,324
1519,991,132,2405,7396,12443,6836,556,92,3040,2043,12567,51,325
1532,994,56,2225,6269,11076,5745,620,45,2751,2032,11193,51,326
1084,1002,105,2280,3554,8025,3061,735,81,2562,1668,8107,51,327
297,1442,145,1508,2367,5759,496,1045,88,2773,1673,6075,51,328
230,537,59,1346,1901,4073,433,481,69,2221,1090,4294,51,329
1186,634,67,2178,4971,9036,3906,477,68,2857,1665,8973,51,330
1250,722,52,2417,5666,10107,4497,516,31,3481,1864,10389,51,331
795,674,48,2978,2992,7487,2452,532,60,3208,1252,7504,51,332
207,310,40,888,1088,2533,284,319,36,1392,575,2606,51,333
397,678,49,2081,2812,6017,1013,485,33,3481,1340,6352,51,334
211,530,72,1343,2112,4268,435,476,38,2427,1162,4538,51,335
141,445,56,1070,1507,3219,330,360,62,1733,866,3351,51,336
1197,1070,53,1692,4508,8520,3893,429,51,2142,2109,8624,51,337
1596,736,33,2210,7089,11664,6364,559,37,2852,1948,11760,51,338
1567,1164,123,2340,6963,12157,6486,571,121,2818,2145,12141,51,339
1380,911,150,2207,6567,11215,5521,589,234,2778,2157,11279,51,340
1027,827,110,2299,3582,7845,3052,600,80,2689,1663,8084,51,341
260,4670,136,1486,2328,8880,403,1525,45,2868,4094,8935,51,342
254,1387,37,1369,1870,4917,364,799,43,2258,1667,5131,51,343
1450,760,52,1794,5241,9297,4357,690,56,2280,1822,9205,51,344
1776,1089,65,2432,7894,13256,6889,784,74,3309,2397,13453,51,345
1626,2036,50,2750,8092,14554,6831,1209,57,3569,2612,14278,51,346
1668,1404,53,2971,7100,13196,6156,824,52,3809,2803,13644,51,347
1129,1146,119,2799,4120,9313,3086,840,41,3387,2157,9511,51,348
303,927,125,1815,2545,5715,501,957,75,3255,1536,6324,51,349
221,442,24,1329,1601,3617,348,472,35,2066,1042,3963,51,350
1231,604,35,1889,4988,8747,4298,453,43,2388,1669,8851,51,351
1550,1005,22,2308,7307,12192,6537,539,36,3240,2100,12452,51,352
1475,769,68,2365,6741,11418,6040,482,61,2959,1868,11410,51,353
1342,809,68,2072,5416,9707,4677,544,64,2670,1865,9820,51,354
807,685,92,2081,3116,6781,2627,541,57,2607,1495,7327,51,355
230,851,73,1232,2101,4487,464,630,56,2353,1386,4889,51,356
220,444,34,1207,1734,3639,324,404,36,1967,1099,3830,51,357
666,544,42,1931,3197,6380,2334,412,37,2672,1239,6694,51,358
327,361,24,1258,1342,3312,809,328,31,1777,718,3663,51,359
143,237,28,435,455,1298,161,222,35,639,510,1567,51,360
478,686,338,1583,2965,6050,1489,528,272,3035,1307,6631,51,361
1376,1318,169,3059,5083,11005,2844,1491,184,5643,3103,13265,51,362
538,1099,198,2393,3514,7742,1020,1483,141,4471,2228,9343,51,363
465,876,233,2201,3767,7542,762,1105,151,4613,2630,9261,51,364
810,722,32,2180,4248,7992,2383,519,37,4007,1609,8555,51,365
641,815,887,2605,3045,7993,2173,1301,437,3353,1519,8783,51,366
56,28,3,74,61,222,21,59,9,62,94,245,52,1
483,44,1,177,95,800,83,135,14,135,467,834,52,2
611,54,6,171,112,954,75,177,18,151,574,995,52,3
573,39,2,160,112,886,70,152,9,137,557,925,52,4
459,52,1,141,132,785,62,153,13,121,468,817,52,5
68,33,4,94,47,246,35,77,17,79,80,288,52,6
91,56,9,120,56,332,63,97,14,94,112,380,52,7
559,44,2,197,120,922,98,167,15,136,526,942,52,8
662,35,4,181,72,954,91,142,12,210,532,987,52,9
673,42,5,219,114,1053,95,176,12,145,636,1064,52,10
622,47,4,194,129,996,92,169,17,131,590,999,52,11
457,44,4,189,115,809,80,128,22,142,430,802,52,12
81,38,7,170,58,354,22,101,14,86,152,375,52,13
67,33,5,99,52,256,33,82,11,80,103,309,52,14
135,45,14,132,68,394,55,105,19,101,153,433,52,15
198,40,5,133,94,470,76,102,10,112,181,481,52,16
518,51,7,178,120,874,83,161,27,134,519,924,52,17
610,49,4,174,123,960,79,170,14,136,582,981,52,18
227,51,13,110,84,485,75,105,18,88,210,496,52,19
74,34,3,110,68,289,36,92,15,73,114,330,52,20
47,38,3,112,47,247,21,75,11,85,72,264,52,21
538,50,4,189,112,893,79,153,38,137,537,944,52,22
720,49,2,225,124,1120,86,198,16,152,641,1093,52,23
736,48,15,218,167,1184,100,229,27,175,708,1239,52,24
700,55,20,213,145,1133,116,227,19,184,627,1173,52,25
478,68,6,218,180,950,113,211,22,194,518,1058,52,26
86,44,5,163,102,400,39,125,24,122,165,475,52,27
81,43,3,126,55,308,33,93,11,92,137,366,52,28
593,46,4,172,128,943,94,186,11,140,555,986,52,29
773,58,4,194,153,1182,100,193,15,162,698,1168,52,30
786,70,2,242,140,1240,103,190,15,219,708,1235,52,31
664,72,1,207,133,1077,85,234,16,136,624,1095,52,32
534,93,4,207,145,983,100,220,21,170,489,1000,52,33
99,46,2,174,97,418,48,108,15,100,175,446,52,34
49,54,4,139,87,333,30,109,6,86,152,383,52,35
612,68,4,187,119,990,111,208,13,151,555,1038,52,36
710,62,3,200,127,1102,95,205,12,155,651,1118,52,37
704,52,6,209,143,1114,104,199,18,155,658,1134,52,38
683,52,4,237,142,1118,81,216,15,220,589,1121,52,39
515,54,2,199,119,889,84,146,24,133,488,875,52,40
93,48,4,149,86,380,39,122,23,94,139,417,52,41
55,34,3,127,49,268,33,70,17,77,99,296,52,42
553,48,4,198,114,917,88,185,19,140,539,971,52,43
624,50,18,197,150,1039,102,226,19,128,549,1024,52,44
735,58,4,230,135,1162,139,182,16,178,644,1159,52,45
628,51,1,204,125,1009,87,189,18,113,593,1000,52,46
456,52,16,191,142,857,83,161,28,130,438,840,52,47
84,38,4,131,74,331,39,100,24,81,121,365,52,48
63,40,5,104,76,288,29,94,16,65,103,307,52,49
188,36,2,150,85,461,53,123,8,95,186,465,52,50
676,47,1,199,124,1047,98,199,12,177,643,1129,52,51
741,53,13,217,132,1156,78,195,21,176,679,1149,52,52
657,52,10,190,119,1028,85,226,21,159,557,1048,52,53
535,53,3,169,106,866,98,153,26,152,470,899,52,54
86,40,5,154,81,366,34,95,20,101,150,400,52,55
69,45,1,143,78,336,23,113,15,97,120,368,52,56
588,55,3,201,140,987,86,187,19,153,568,1013,52,57
727,41,3,215,134,1120,106,195,13,159,692,1165,52,58
725,65,8,186,120,1104,92,188,19,154,654,1107,52,59
677,62,5,218,134,1096,90,203,23,168,609,1093,52,60
506,65,8,175,127,881,87,174,17,149,488,915,52,61
75,56,6,145,66,348,27,126,20,107,117,397,52,62
71,71,3,180,76,401,33,139,11,89,152,424,52,63
604,53,5,196,144,1002,109,186,14,142,576,1027,52,64
708,53,3,186,136,1086,93,198,22,143,653,1109,52,65
777,62,1,213,126,1179,103,192,22,166,697,1180,52,66
650,64,0,216,134,1064,104,191,22,178,602,1097,52,67
529,64,4,179,144,920,91,197,35,126,488,937,52,68
94,31,3,137,74,339,28,107,15,89,114,353,52,69
60,60,4,122,56,302,30,113,9,82,102,336,52,70
596,72,5,194,111,978,89,179,26,158,540,992,52,71
743,69,10,221,150,1193,108,216,28,143,709,1204,52,72
774,72,4,213,137,1200,96,262,23,167,690,1238,52,73
689,54,2,250,135,1130,99,216,13,185,619,1132,52,74
552,72,5,193,142,964,80,168,32,144,465,889,52,75
99,54,12,183,107,455,40,124,31,113,191,499,52,76
67,43,2,149,65,326,37,103,10,75,128,353,52,77
602,55,2,226,133,1018,89,166,13,154,595,1017,52,78
731,63,3,252,133,1182,113,231,19,176,671,1210,52,79
740,61,3,228,150,1182,98,266,13,156,670,1203,52,80
688,57,8,245,141,1139,108,241,27,179,624,1179,52,81
545,55,9,226,133,968,105,207,17,142,502,973,52,82
86,37,22,136,95,376,44,116,37,71,140,408,52,83
95,48,7,240,72,462,35,138,16,92,220,501,52,84
599,54,6,267,138,1064,84,216,22,137,603,1062,52,85
708,80,5,271,142,1206,90,246,20,174,722,1252,52,86
714,64,4,229,128,1139,101,212,15,154,639,1121,52,87
651,75,4,221,142,1093,95,215,14,148,614,1086,52,88
499,91,4,216,139,949,99,214,25,146,463,947,52,89
139,57,1,285,98,580,43,177,19,142,214,595,52,90
72,37,5,168,60,342,25,95,14,91,150,375,52,91
550,60,17,218,147,992,85,199,26,106,550,966,52,92
728,65,5,233,137,1168,97,204,17,163,696,1177,52,93
753,69,4,187,138,1151,112,231,22,141,673,1179,52,94
820,74,7,255,139,1295,117,263,16,145,687,1228,52,95
623,76,16,219,156,1090,107,203,27,162,487,986,52,96
144,55,14,185,110,508,59,169,29,89,196,542,52,97
107,50,3,163,57,380,48,147,10,73,149,427,52,98
701,61,7,204,131,1104,93,169,28,142,624,1056,52,99
769,86,2,237,142,1236,114,238,23,168,728,1271,52,100
732,71,10,240,163,1216,109,223,33,152,713,1230,52,101
713,62,2,203,129,1109,101,199,20,143,632,1095,52,102
584,78,3,196,137,998,96,186,28,155,517,982,52,103
106,55,8,188,85,442,37,119,35,101,197,489,52,104
88,46,2,191,90,417,36,134,10,79,137,396,52,105
598,112,5,252,133,1100,101,244,30,161,558,1094,52,106
733,94,3,299,147,1276,111,277,18,188,678,1272,52,107
801,104,14,257,172,1348,118,304,25,187,713,1347,52,108
682,82,15,268,135,1182,119,274,29,203,640,1265,52,109
527,86,11,253,144,1021,124,194,59,151,526,1054,52,110
100,61,5,168,95,429,32,153,29,99,147,460,52,111
76,31,4,114,64,289,40,83,11,66,95,295,52,112
634,56,5,201,116,1012,94,201,12,150,633,1090,52,113
776,88,8,233,152,1257,125,274,21,166,708,1294,52,114
786,68,6,235,136,1231,110,250,21,161,754,1296,52,115
739,57,7,239,142,1184,102,215,23,158,704,1202,52,116
531,86,15,227,150,1009,95,213,31,156,512,1007,52,117
71,40,4,147,80,342,32,82,31,71,93,309,52,118
46,47,5,151,50,299,35,92,20,60,78,285,52,119
601,62,3,204,120,990,106,194,11,145,580,1036,52,120
773,76,4,238,128,1219,98,204,14,156,745,1217,52,121
780,62,2,225,164,1233,112,249,16,162,730,1269,52,122
725,62,3,227,152,1169,104,218,21,165,662,1170,52,123
573,60,6,212,126,977,94,199,30,160,509,992,52,124
108,38,5,181,95,427,50,129,20,79,152,430,52,125
76,47,3,142,54,322,41,129,13,71,135,389,52,126
652,70,3,214,138,1077,114,192,13,136,616,1071,52,127
793,70,6,204,142,1215,117,233,16,191,715,1272,52,128
770,77,11,213,173,1244,110,255,28,173,684,1250,52,129
717,47,2,233,155,1154,114,217,18,166,658,1173,52,130
562,71,6,201,134,974,113,181,30,159,509,992,52,131
110,52,4,182,91,439,53,142,21,121,185,522,52,132
57,41,3,116,62,279,41,110,12,77,103,343,52,133
633,80,6,179,125,1023,88,214,17,143,583,1045,52,134
767,60,1,218,129,1175,100,194,19,183,694,1190,52,135
757,63,3,213,131,1167,110,224,28,162,705,1229,52,136
758,64,4,219,158,1203,108,246,22,163,687,1226,52,137
535,68,8,225,157,993,101,189,26,149,515,980,52,138
108,49,3,173,73,406,35,121,24,96,154,430,52,139
92,56,3,174,84,409,39,148,17,87,147,438,52,140
644,75,4,168,140,1031,89,201,17,142,598,1047,52,141
769,78,1,219,134,1201,113,235,16,166,713,1243,52,142
774,73,2,236,144,1229,98,239,16,189,711,1253,52,143
704,78,15,216,138,1151,101,219,20,174,654,1168,52,144
499,86,8,212,149,954,92,214,31,190,441,968,52,145
87,81,5,182,122,477,46,192,22,95,202,557,52,146
77,72,2,165,75,391,35,154,16,144,165,514,52,147
113,47,1,140,84,385,37,125,8,89,147,406,52,148
737,73,3,213,137,1163,105,203,17,216,695,1236,52,149
745,69,3,248,118,1183,107,210,19,185,678,1199,52,150
738,82,4,205,148,1177,119,235,18,141,697,1210,52,151
594,74,5,177,152,1002,107,196,28,151,520,1002,52,152
121,70,9,186,103,489,48,145,23,129,189,534,52,153
75,50,4,159,65,353,49,129,14,68,143,403,52,154
662,71,3,213,119,1068,96,191,13,141,590,1031,52,155
779,75,2,270,164,1290,115,236,28,188,760,1327,52,156
800,63,5,236,135,1239,115,240,13,173,741,1282,52,157
744,77,2,209,154,1186,110,242,18,161,658,1189,52,158
598,82,10,211,153,1054,109,234,34,162,559,1098,52,159
118,90,3,237,180,628,49,243,42,119,229,682,52,160
76,52,18,178,97,421,45,160,26,91,140,462,52,161
647,57,5,242,148,1099,80,197,18,152,631,1078,52,162
802,73,3,216,134,1228,99,229,22,186,755,1291,52,163
819,87,2,234,155,1297,92,243,40,180,748,1303,52,164
756,58,4,245,141,1204,126,222,24,177,665,1214,52,165
579,87,10,231,152,1059,144,241,26,150,535,1096,52,166
97,88,8,197,98,488,36,154,26,111,186,513,52,167
85,71,5,163,64,388,41,137,13,93,134,418,52,168
659,66,9,194,121,1049,109,197,25,130,620,1081,52,169
768,66,21,220,130,1205,123,235,51,181,653,1243,52,170
244,64,4,186,124,622,86,195,20,107,271,679,52,171
657,74,6,230,150,1117,96,247,29,152,583,1107,52,172
518,73,4,214,132,941,86,218,32,166,462,964,52,173
106,47,7,188,99,447,45,145,33,110,149,482,52,174
83,43,8,131,78,343,49,116,22,75,105,367,52,175
640,65,6,211,123,1045,92,193,20,163,577,1045,52,176
761,56,4,245,146,1212,103,236,21,170,690,1220,52,177
751,59,7,254,111,1182,87,228,22,167,704,1208,52,178
731,83,10,248,132,1204,104,239,27,180,699,1249,52,179
561,62,9,238,128,998,101,204,32,165,515,1017,52,180
107,49,2,180,105,443,43,141,26,99,150,459,52,181
62,41,2,115,66,286,34,124,12,67,113,350,52,182
640,87,11,247,174,1159,98,220,23,161,628,1130,52,183
749,81,6,277,175,1288,106,254,33,202,699,1294,52,184
654,82,7,222,170,1135,91,244,19,208,624,1186,52,185
131,208,8,191,255,793,53,428,27,99,226,833,52,186
363,75,6,264,131,839,103,200,29,137,399,868,52,187
110,79,7,200,118,514,50,164,25,108,187,534,52,188
81,54,0,131,67,333,45,128,8,79,141,401,52,189
593,76,9,226,134,1038,94,223,19,177,562,1075,52,190
703,57,3,239,133,1135,112,218,16,193,676,1215,52,191
716,64,4,269,170,1223,114,231,19,182,693,1239,52,192
687,76,11,252,159,1185,105,240,29,152,672,1198,52,193
523,86,7,237,124,977,102,227,29,180,517,1055,52,194
94,72,3,177,81,427,55,166,26,136,200,583,52,195
85,42,2,112,57,298,40,139,12,108,114,413,52,196
594,84,1,207,105,991,167,181,18,139,581,1086,52,197
732,68,5,210,117,1132,96,222,12,163,643,1136,52,198
761,67,1,208,139,1176,100,178,9,164,694,1145,52,199
684,67,3,185,120,1059,89,196,17,155,610,1067,52,200
525,76,10,184,141,936,110,183,34,154,474,955,52,201
115,49,7,164,115,450,53,152,29,100,175,509,52,202
73,38,3,139,63,316,38,126,13,67,133,377,52,203
600,68,4,186,130,988,87,198,20,141,561,1007,52,204
739,78,12,230,138,1197,91,247,19,168,685,1210,52,205
728,82,34,235,167,1246,92,209,45,173,680,1199,52,206
689,91,31,231,142,1184,97,249,37,172,613,1168,52,207
511,81,11,221,118,942,86,214,28,158,532,1018,52,208
132,61,11,160,82,446,31,169,26,96,193,515,52,209
106,40,1,124,60,331,39,122,24,63,109,357,52,210
624,43,7,165,128,967,90,211,17,111,573,1002,52,211
734,40,6,231,101,1112,94,205,15,152,645,1111,52,212
719,66,7,220,107,1119,92,182,16,155,666,1111,52,213
646,58,1,209,102,1016,84,168,13,165,614,1044,52,214
531,55,5,188,101,880,90,184,22,153,481,930,52,215
106,31,23,140,71,371,40,108,19,108,126,401,52,216
68,29,3,106,39,245,44,86,8,49,90,277,52,217
557,45,4,169,104,879,78,163,9,133,519,902,52,218
684,52,0,196,122,1054,94,182,9,168,636,1089,52,219
669,59,1,221,117,1067,90,196,4,150,610,1050,52,220
581,38,1,194,109,923,81,187,14,123,555,960,52,221
462,53,4,174,104,797,74,171,20,138,417,820,52,222
111,38,3,117,45,314,39,109,16,96,122,382,52,223
78,30,13,113,67,301,27,129,19,54,115,344,52,224
545,57,2,191,103,898,80,172,8,131,509,900,52,225
670,40,0,226,112,1048,116,167,5,162,600,1050,52,226
701,55,15,206,115,1092,105,190,14,144,653,1106,52,227
652,52,4,202,107,1017,98,222,12,149,517,998,52,228
513,75,6,208,122,924,105,207,21,140,436,909,52,229
106,49,1,144,69,369,37,147,16,82,126,408,52,230
83,26,0,100,36,245,29,97,5,61,94,286,52,231
552,43,1,195,111,902,82,162,7,138,520,909,52,232
676,62,0,198,121,1057,110,213,12,124,623,1082,52,233
685,65,3,228,126,1107,101,217,17,146,624,1105,52,234
672,62,19,215,130,1098,108,207,31,147,551,1044,52,235
547,59,3,203,143,955,124,190,31,156,461,962,52,236
103,47,6,153,84,393,47,102,23,88,151,411,52,237
65,56,36,127,59,343,33,109,48,65,116,371,52,238
544,43,10,181,113,891,127,181,14,137,542,1001,52,239
800,55,8,211,109,1183,121,187,15,135,671,1129,52,240
708,48,3,208,122,1089,104,204,10,154,656,1128,52,241
709,50,6,182,137,1084,90,207,20,131,647,1095,52,242
470,63,4,165,120,822,97,155,31,187,427,897,52,243
118,40,5,134,91,388,45,111,26,87,155,424,52,244
72,44,0,129,67,312,43,117,6,66,130,362,52,245
94,43,0,125,76,338,69,86,7,68,127,357,52,246
747,54,6,179,147,1133,179,171,14,151,661,1176,52,247
817,56,6,197,114,1190,123,188,17,156,699,1183,52,248
728,61,2,225,122,1138,116,207,10,167,645,1145,52,249
566,53,2,204,144,969,113,176,18,190,475,972,52,250
115,45,3,131,70,364,40,96,22,77,148,383,52,251
79,41,1,135,70,326,36,100,7,72,115,330,52,252
646,55,3,195,103,1002,92,166,16,141,624,1039,52,253
824,53,1,208,135,1221,115,238,10,161,672,1196,52,254
885,63,1,211,133,1293,102,233,15,173,702,1225,52,255
820,61,21,191,128,1221,113,208,25,147,690,1183,52,256
594,57,5,221,138,1015,93,188,28,176,558,1043,52,257
123,46,2,152,91,414,56,143,17,80,148,444,52,258
73,37,1,141,78,330,39,98,7,92,135,371,52,259
656,41,10,171,124,1002,104,189,16,140,570,1019,52,260
819,44,1,227,145,1236,132,217,13,183,748,1293,52,261
783,58,2,233,139,1215,104,230,23,162,672,1191,52,262
806,49,8,222,138,1223,108,242,19,172,693,1234,52,263
606,80,5,219,110,1020,110,201,24,174,550,1059,52,264
11,2,1,9,6,29,16,1,0,8,4,29,52,265
53,18,0,86,41,198,28,53,3,42,75,201,52,266
657,61,2,192,126,1038,100,178,19,154,572,1023,52,267
831,51,16,250,126,1274,124,183,25,146,761,1239,52,268
812,46,4,239,135,1236,104,217,19,164,756,1260,52,269
787,55,4,225,137,1208,116,228,26,138,716,1224,52,270
570,75,3,219,126,993,97,189,34,168,477,965,52,271
92,61,2,199,94,448,36,153,22,90,190,491,52,272
71,35,1,137,63,307,34,120,8,84,111,357,52,273
651,49,10,181,118,1009,105,207,22,132,561,1027,52,274
798,53,1,242,108,1202,114,178,14,171,697,1174,52,275
812,51,8,225,151,1247,111,217,16,169,729,1242,52,276
745,59,2,212,132,1150,104,211,14,150,662,1141,52,277
576,65,5,187,165,998,108,190,41,185,506,1030,52,278
115,53,2,148,99,417,46,127,17,116,146,452,52,279
57,34,0,120,71,282,39,89,6,104,119,357,52,280
648,44,3,216,136,1047,107,173,12,158,624,1074,52,281
794,48,2,241,138,1223,108,180,17,159,761,1225,52,282
825,48,3,257,126,1259,109,208,16,197,757,1287,52,283
748,60,6,232,123,1169,108,227,16,160,657,1168,52,284
534,72,5,210,159,980,101,189,29,174,451,944,52,285
107,58,1,170,89,425,50,127,20,96,190,483,52,286
72,38,3,101,64,278,40,123,16,72,118,369,52,287
277,42,1,167,95,582,64,141,11,106,283,605,52,288
781,57,2,207,129,1176,101,217,20,134,735,1207,52,289
806,50,9,239,123,1227,111,202,20,172,751,1256,52,290
754,76,4,234,140,1208,102,233,17,145,684,1181,52,291
574,75,6,223,146,1024,86,217,28,138,523,992,52,292
121,61,3,170,86,441,57,141,37,105,164,504,52,293
60,47,1,129,71,308,30,108,11,83,159,391,52,294
656,52,2,204,137,1051,97,190,19,127,639,1072,52,295
817,53,5,228,131,1234,107,239,14,156,736,1252,52,296
827,68,2,259,124,1280,109,242,25,172,759,1307,52,297
768,50,4,232,142,1196,111,228,19,143,710,1211,52,298
576,55,4,199,111,945,90,208,32,133,517,980,52,299
105,45,3,167,115,435,45,146,26,87,183,487,52,300
100,45,9,128,76,358,43,101,14,118,140,416,52,301
651,47,3,176,136,1013,91,204,17,123,627,1062,52,302
787,48,3,225,175,1238,107,291,18,186,695,1297,52,303
847,61,4,232,131,1275,105,239,16,166,756,1282,52,304
727,66,3,194,153,1143,103,205,16,179,667,1170,52,305
575,70,11,204,124,984,87,186,37,168,536,1014,52,306
38,15,3,15,12,83,17,9,4,14,13,57,52,307
13,10,3,10,21,57,4,6,2,13,19,44,52,308
682,49,2,184,127,1044,88,179,7,125,584,983,52,309
699,55,3,202,91,1050,97,169,17,186,598,1067,52,310
770,55,6,217,116,1164,110,181,18,199,684,1192,52,311
766,60,3,199,121,1149,88,193,13,151,719,1164,52,312
581,62,5,173,148,969,108,208,27,144,531,1018,52,313
93,33,1,210,80,417,39,97,21,124,194,475,52,314
72,24,1,117,70,284,32,82,7,92,120,333,52,315
281,43,3,161,86,574,65,144,9,121,273,612,52,316
805,44,1,241,128,1219,104,189,17,150,756,1216,52,317
839,46,2,238,165,1290,110,229,11,167,797,1314,52,318
762,45,2,203,120,1132,84,224,13,127,706,1154,52,319
604,53,3,194,141,995,80,182,25,173,576,1036,52,320
117,40,3,152,73,385,42,101,18,117,182,460,52,321
82,37,5,123,59,306,32,96,11,73,128,340,52,322
693,42,4,215,132,1086,92,180,14,166,638,1090,52,323
880,44,5,245,119,1293,99,216,20,194,796,1325,52,324
869,47,10,220,151,1297,108,245,18,172,811,1354,52,325
778,54,5,228,128,1193,100,191,18,144,753,1206,52,326
610,57,9,188,115,979,102,179,31,172,531,1015,52,327
119,41,15,133,78,386,58,123,32,99,152,464,52,328
65,34,7,123,76,305,44,101,10,78,110,343,52,329
618,44,1,203,128,994,87,155,13,179,607,1041,52,330
693,56,10,238,152,1149,91,190,17,183,668,1149,52,331
544,46,0,198,102,890,107,160,14,237,438,956,52,332
70,46,2,58,38,214,34,37,5,74,95,245,52,333
243,47,2,167,86,545,55,111,22,107,252,547,52,334
93,37,4,114,70,318,37,99,12,77,153,378,52,335
63,27,1,93,60,244,32,71,2,93,101,299,52,336
712,41,8,188,117,1066,90,159,15,161,651,1076,52,337
785,44,6,222,117,1174,90,202,16,163,755,1226,52,338
809,43,0,258,119,1229,99,223,9,176,735,1242,52,339
750,47,10,228,130,1165,95,216,15,179,680,1185,52,340
590,42,6,197,136,971,94,188,19,148,549,998,52,341
72,32,1,105,54,264,43,58,20,56,75,252,52,342
47,23,0,71,35,176,22,65,5,33,55,180,52,343
690,48,3,176,127,1044,103,176,17,138,625,1059,52,344
840,65,0,217,123,1245,109,203,12,164,799,1287,52,345
801,41,0,188,104,1134,102,192,8,113,754,1169,52,346
742,45,3,231,122,1143,137,225,17,152,638,1169,52,347
574,60,13,215,120,982,99,187,36,154,515,991,52,348
92,54,0,132,79,357,41,88,21,141,154,445,52,349
58,31,0,94,54,237,34,98,5,53,103,293,52,350
638,42,1,161,120,962,107,183,7,119,603,1019,52,351
829,41,1,224,152,1247,96,210,13,163,754,1236,52,352
802,48,1,212,129,1192,123,201,13,157,751,1245,52,353
722,51,4,199,129,1105,91,208,12,143,682,1136,52,354
406,63,4,177,126,776,99,169,13,136,382,799,52,355
89,45,1,134,51,320,50,88,13,93,119,363,52,356
51,31,1,101,75,259,29,91,11,63,88,282,52,357
342,33,3,172,93,643,67,128,8,112,333,648,52,358
225,28,4,134,47,438,76,73,10,121,164,444,52,359
30,19,0,50,25,124,22,28,5,52,47,154,52,360
266,37,5,169,97,574,57,138,10,120,263,588,52,361
269,30,11,179,84,573,57,113,19,99,257,545,52,362
51,26,0,114,54,245,39,87,9,63,91,289,52,363
55,31,0,75,49,210,27,66,9,48,84,234,52,364
310,29,1,206,94,640,74,130,10,129,365,708,52,365
389,77,5,171,103,745,98,115,20,193,329,755,52,366
6,16,3,39,20,84,1,32,3,23,42,101,53,1
118,19,0,56,36,229,29,32,4,42,122,229,53,2
149,10,0,63,62,284,25,55,3,46,161,290,53,3
124,10,0,41,61,236,19,46,1,54,124,244,53,4
89,12,0,50,56,207,25,58,5,43,86,217,53,5
14,18,0,34,26,92,1,23,7,19,32,82,53,6
13,14,2,45,20,94,3,31,2,12,23,71,53,7
110,13,0,54,54,231,23,46,3,39,115,226,53,8
158,11,0,49,36,254,27,48,6,50,136,267,53,9
183,8,0,57,73,321,34,48,5,39,179,305,53,10
161,18,0,48,67,294,36,73,4,47,155,315,53,11
81,15,1,35,61,193,31,48,7,37,72,195,53,12
17,8,1,85,26,137,3,49,4,20,60,136,53,13
10,14,1,34,20,79,1,20,4,22,26,73,53,14
17,21,2,25,35,100,15,24,5,21,34,99,53,15
40,11,0,28,37,116,17,31,2,36,36,122,53,16
139,11,0,54,55,259,27,39,2,52,143,263,53,17
166,13,0,42,63,284,31,66,2,42,144,285,53,18
47,13,0,28,35,123,22,26,4,30,61,143,53,19
20,16,1,34,31,102,5,32,16,25,32,110,53,20
14,11,0,43,22,90,2,32,4,21,31,90,53,21
121,13,2,42,58,236,26,33,3,39,127,228,53,22
187,9,0,47,54,297,36,44,1,47,173,301,53,23
191,15,0,31,55,292,36,53,3,37,163,292,53,24
166,14,1,40,69,290,32,70,1,41,161,305,53,25
125,12,0,50,47,234,25,41,8,68,92,234,53,26
31,7,1,84,39,162,6,32,13,42,74,167,53,27
13,14,2,35,27,91,2,24,2,26,34,88,53,28
137,7,2,42,62,250,23,50,7,36,127,243,53,29
188,9,0,56,61,314,31,47,4,51,182,315,53,30
200,12,0,44,50,306,28,50,3,59,161,301,53,31
166,10,0,40,52,268,33,62,3,61,124,283,53,32
100,17,1,35,69,222,29,56,4,46,101,236,53,33
11,7,0,53,36,107,6,25,7,23,53,114,53,34
14,8,2,40,24,88,6,24,4,22,29,85,53,35
133,22,1,43,51,250,32,44,3,44,111,234,53,36
198,10,0,49,65,322,32,54,1,47,175,309,53,37
190,7,7,30,63,297,29,57,8,45,160,299,53,38
153,12,0,58,58,281,34,60,0,45,148,287,53,39
85,20,0,54,64,223,29,55,11,48,96,239,53,40
12,13,1,44,35,105,4,41,3,23,41,112,53,41
5,11,1,49,23,89,1,11,5,21,48,86,53,42
130,11,1,45,51,238,24,34,4,44,127,233,53,43
147,7,1,36,69,260,26,60,2,38,137,263,53,44
189,6,0,31,53,279,31,44,5,41,158,279,53,45
149,11,0,52,53,265,34,58,2,43,149,286,53,46
83,20,3,46,56,208,33,46,9,45,91,224,53,47
16,6,0,38,26,86,2,27,7,38,35,109,53,48
10,8,1,52,24,95,0,32,4,17,40,93,53,49
35,13,2,40,40,130,25,29,4,25,47,130,53,50
181,13,2,55,59,310,35,55,3,53,164,310,53,51
180,8,0,54,54,296,35,52,6,45,159,297,53,52
158,17,0,45,60,280,36,59,2,55,136,288,53,53
100,13,0,38,74,225,41,36,5,60,103,245,53,54
30,9,0,48,24,111,5,39,4,26,67,141,53,55
10,9,0,48,14,81,0,31,5,20,48,104,53,56
148,13,1,39,59,260,46,52,1,45,117,261,53,57
196,17,0,58,64,335,48,49,5,46,193,341,53,58
195,11,0,41,50,297,43,50,5,47,168,313,53,59
159,13,0,51,54,277,45,48,6,57,155,311,53,60
99,11,1,50,77,238,44,46,7,65,90,252,53,61
22,13,0,50,23,108,4,25,7,48,49,133,53,62
11,12,1,50,34,108,8,24,2,31,57,122,53,63
169,13,1,48,50,281,34,60,0,45,138,277,53,64
183,27,2,61,69,342,41,67,1,45,182,336,53,65
205,9,5,49,63,331,29,59,9,50,180,327,53,66
156,19,0,72,61,308,45,62,10,69,150,336,53,67
94,9,2,60,66,231,39,47,13,53,108,260,53,68
26,12,0,51,64,153,8,74,4,38,52,176,53,69
14,4,0,32,25,75,3,24,5,22,34,88,53,70
148,15,1,45,49,258,38,35,3,38,126,240,53,71
188,13,0,59,66,326,54,52,5,34,194,339,53,72
182,10,1,58,65,316,35,54,8,53,185,335,53,73
153,18,1,45,71,288,48,52,7,49,161,317,53,74
71,10,0,44,70,195,33,47,6,41,102,229,53,75
31,15,1,85,54,186,11,56,17,45,77,206,53,76
16,13,1,81,52,163,0,58,10,37,69,174,53,77
141,15,0,53,65,274,45,31,3,39,144,262,53,78
203,21,4,53,58,339,51,64,7,49,184,355,53,79
213,13,4,84,79,393,47,91,7,56,196,397,53,80
159,13,0,60,65,297,31,48,7,64,163,313,53,81
96,9,0,83,80,268,34,69,14,56,103,276,53,82
30,14,0,74,31,149,4,41,9,49,57,160,53,83
28,10,0,139,28,205,1,58,5,33,103,200,53,84
142,15,0,141,76,374,36,84,7,39,192,358,53,85
184,9,0,108,73,374,46,75,8,66,186,381,53,86
151,7,3,62,68,291,36,49,10,46,160,301,53,87
147,12,0,100,68,327,42,67,11,58,181,359,53,88
89,15,0,122,43,269,35,64,10,58,167,334,53,89
21,16,0,224,60,321,7,141,4,55,129,336,53,90
18,13,0,87,39,157,3,48,4,32,71,158,53,91
117,8,0,72,69,266,43,50,3,45,138,279,53,92
200,15,0,68,68,351,56,65,2,57,175,355,53,93
226,12,0,57,64,359,35,73,4,51,199,362,53,94
170,20,0,70,81,341,33,85,12,54,181,365,53,95
94,16,0,96,66,272,37,57,10,49,108,261,53,96
20,15,5,85,22,147,8,31,12,51,65,167,53,97
30,7,0,79,25,141,3,55,3,46,59,166,53,98
142,11,0,65,50,268,50,34,5,49,114,252,53,99
182,8,1,51,68,310,50,48,4,55,179,336,53,100
192,11,0,69,50,322,32,74,5,57,183,351,53,101
186,11,1,60,67,325,41,60,9,57,173,340,53,102
104,10,0,68,66,248,35,54,11,57,96,253,53,103
27,18,1,98,46,190,4,56,4,46,59,169,53,104
17,19,0,75,29,140,6,36,3,45,50,140,53,105
155,15,0,60,65,295,43,65,7,46,169,330,53,106
215,18,0,59,82,374,57,76,4,58,177,372,53,107
217,13,0,66,72,368,38,63,6,65,207,379,53,108
184,9,2,53,65,313,42,72,6,60,160,340,53,109
98,22,3,41,61,225,35,54,13,57,105,264,53,110
25,31,8,121,52,237,7,94,10,43,75,229,53,111
9,9,0,45,17,80,2,15,3,33,35,88,53,112
143,5,0,68,63,279,48,52,3,61,129,293,53,113
203,19,1,67,88,378,52,57,5,50,209,373,53,114
212,14,0,54,79,359,49,84,6,48,164,351,53,115
185,20,0,89,58,352,46,100,2,76,164,388,53,116
110,32,1,43,75,261,44,51,12,46,113,266,53,117
39,15,2,73,59,188,2,45,29,47,57,180,53,118
8,20,0,59,38,125,1,29,12,35,45,122,53,119
145,14,0,54,63,276,42,43,2,59,131,277,53,120
179,15,0,55,61,310,46,43,4,49,162,304,53,121
194,25,0,45,75,339,35,53,1,56,190,335,53,122
178,16,0,54,90,338,42,52,5,52,162,313,53,123
97,18,0,59,71,245,42,46,8,63,93,252,53,124
28,19,0,80,36,163,13,41,8,25,62,149,53,125
6,10,0,40,32,88,2,36,6,21,35,100,53,126
156,12,1,46,64,279,52,23,1,58,133,267,53,127
202,17,0,72,98,389,59,53,6,60,213,391,53,128
193,18,0,71,90,372,48,59,9,62,192,370,53,129
170,15,0,71,72,328,42,63,5,57,168,335,53,130
96,19,1,60,69,245,38,40,10,48,90,226,53,131
35,12,0,120,32,199,19,45,4,47,98,213,53,132
25,17,1,58,30,131,11,36,5,34,38,124,53,133
150,17,3,66,59,295,40,58,7,53,119,277,53,134
187,21,1,64,79,352,47,56,3,66,211,383,53,135
197,16,0,67,83,363,40,59,4,68,205,376,53,136
161,20,0,76,62,319,45,86,4,55,161,351,53,137
126,22,0,51,73,272,44,50,8,60,114,276,53,138
16,15,0,54,40,125,3,33,8,22,55,121,53,139
23,18,0,76,38,155,5,36,6,50,60,157,53,140
152,13,1,73,78,317,54,43,5,67,157,326,53,141
193,13,0,76,94,376,54,80,14,45,194,387,53,142
231,12,2,65,63,373,52,68,7,52,200,379,53,143
179,8,0,67,64,318,44,58,4,73,176,355,53,144
85,16,1,67,70,239,45,74,3,67,93,282,53,145
18,18,1,103,44,184,4,83,12,37,49,185,53,146
4,19,1,107,42,173,2,76,14,37,80,209,53,147
21,13,1,92,38,165,7,41,1,41,73,163,53,148
193,21,0,73,118,405,50,59,30,59,204,402,53,149
223,15,1,66,55,360,48,64,5,66,207,390,53,150
190,22,0,59,57,328,40,73,5,47,197,362,53,151
103,22,1,69,73,268,46,54,13,43,111,267,53,152
30,21,3,101,67,222,5,88,21,35,80,229,53,153
16,8,2,78,37,141,6,33,2,39,49,129,53,154
174,15,3,46,81,319,42,58,6,41,159,306,53,155
240,17,0,54,81,392,62,82,4,63,214,425,53,156
242,10,0,67,82,401,47,76,3,54,207,387,53,157
192,12,3,68,99,374,45,63,18,55,170,351,53,158
103,14,0,53,114,284,37,58,14,43,122,274,53,159
30,19,0,150,70,269,6,126,19,29,73,253,53,160
12,19,1,63,32,127,4,35,9,37,64,149,53,161
176,19,1,69,73,338,62,38,5,62,169,336,53,162
238,16,0,65,92,411,62,80,3,44,228,417,53,163
217,21,5,79,116,438,59,73,23,63,231,449,53,164
207,22,0,79,78,386,51,75,11,53,198,388,53,165
118,29,5,45,117,314,55,73,34,50,110,322,53,166
28,13,6,84,44,175,11,63,27,38,48,187,53,167
10,26,1,50,42,129,7,41,5,27,56,136,53,168
157,19,1,94,74,345,50,54,9,52,177,342,53,169
216,28,2,81,97,424,61,99,8,59,202,429,53,170
75,25,1,94,66,261,42,72,5,31,96,246,53,171
208,16,0,92,83,399,57,72,1,51,205,386,53,172
117,19,1,63,92,292,57,68,7,65,118,315,53,173
32,22,3,66,47,170,8,52,19,35,58,172,53,174
21,18,1,41,38,119,4,28,4,22,57,115,53,175
163,24,8,68,61,324,46,41,10,47,160,304,53,176
234,13,6,75,83,411,67,82,13,47,200,409,53,177
268,28,6,79,103,484,61,99,12,59,257,488,53,178
213,29,4,80,73,399,49,87,13,46,201,396,53,179
129,21,1,78,90,319,40,63,12,69,133,317,53,180
18,17,0,60,34,129,7,44,14,35,42,142,53,181
25,12,0,41,27,105,8,39,7,36,46,136,53,182
150,21,0,56,90,317,46,93,4,58,138,339,53,183
212,31,6,54,97,400,55,102,13,52,201,423,53,184
154,27,0,94,94,369,64,76,15,82,156,393,53,185
53,107,19,109,167,455,11,106,29,42,68,256,53,186
55,30,1,55,64,205,34,55,6,42,73,210,53,187
21,21,3,58,50,153,8,58,18,48,55,187,53,188
21,16,1,66,50,154,4,38,6,41,42,131,53,189
162,15,0,74,67,318,45,50,7,44,149,295,53,190
218,9,3,62,74,366,56,61,6,45,181,349,53,191
187,12,0,68,78,345,64,64,6,52,182,368,53,192
202,33,1,64,77,377,61,87,8,55,179,390,53,193
106,15,1,55,66,243,37,31,12,36,105,221,53,194
25,26,4,128,60,243,13,99,18,65,66,261,53,195
28,23,1,48,32,132,9,49,10,43,56,167,53,196
174,16,0,60,80,330,51,51,9,79,147,337,53,197
214,16,1,92,74,397,52,71,3,55,222,403,53,198
218,22,0,65,74,379,56,68,7,64,208,403,53,199
193,18,4,101,92,408,65,73,9,64,200,411,53,200
101,22,1,48,106,278,32,64,22,57,100,275,53,201
26,16,0,96,71,209,8,97,22,52,57,236,53,202
20,14,0,80,49,163,12,57,2,28,76,175,53,203
134,17,3,48,87,289,38,53,27,34,142,294,53,204
198,22,0,74,104,398,60,107,1,44,214,426,53,205
205,29,11,66,96,407,56,86,23,69,200,434,53,206
183,22,2,88,87,382,47,71,7,56,244,425,53,207
133,22,0,61,75,291,44,52,8,58,142,304,53,208
23,26,0,88,55,192,3,64,27,37,46,177,53,209
22,20,1,80,45,168,8,42,3,67,60,180,53,210
152,19,0,49,74,294,56,51,11,57,139,314,53,211
239,13,1,73,89,415,61,66,6,56,219,408,53,212
190,35,5,70,78,378,45,89,4,54,186,378,53,213
192,21,2,79,72,366,66,71,10,57,165,369,53,214
132,25,2,91,99,349,69,97,25,52,127,370,53,215
24,23,0,90,40,177,3,59,27,30,76,195,53,216
18,14,0,86,42,160,9,41,7,51,86,194,53,217
147,26,0,63,74,310,45,60,4,35,163,307,53,218
202,15,0,90,97,404,71,86,8,57,179,401,53,219
242,10,0,85,105,442,57,90,6,79,235,467,53,220
172,32,2,95,64,365,64,75,4,63,171,377,53,221
92,18,1,57,74,242,53,42,17,60,113,285,53,222
18,20,0,77,52,167,5,58,20,39,54,176,53,223
24,16,2,93,36,171,6,69,9,54,70,208,53,224
168,14,0,64,58,304,49,51,5,46,125,276,53,225
193,14,1,58,100,366,56,70,12,46,178,362,53,226
194,25,3,79,82,383,60,70,11,66,180,387,53,227
191,20,0,88,71,370,64,62,7,59,181,373,53,228
118,24,1,48,61,252,70,54,5,48,115,292,53,229
19,24,0,74,51,168,6,55,14,40,66,181,53,230
28,18,1,41,37,125,8,51,8,35,35,137,53,231
135,17,5,61,65,283,38,47,10,55,124,274,53,232
177,20,0,66,71,334,64,49,9,52,183,357,53,233
194,20,1,53,88,356,53,57,7,60,177,354,53,234
175,21,0,81,62,339,52,72,7,45,161,337,53,235
101,11,1,58,71,242,42,50,13,42,101,248,53,236
27,23,4,95,45,194,7,57,18,55,74,211,53,237
26,16,3,47,23,115,8,35,6,46,58,153,53,238
157,12,1,57,88,315,51,78,5,48,120,302,53,239
219,29,0,75,79,402,63,96,3,65,174,401,53,240
220,31,0,65,70,386,67,82,9,79,175,412,53,241
168,17,0,55,64,304,49,55,26,55,139,324,53,242
85,23,1,107,78,294,42,82,10,64,94,292,53,243
21,19,0,86,56,182,6,63,9,49,66,193,53,244
28,18,2,77,53,178,2,46,8,51,63,170,53,245
17,21,0,69,39,146,10,52,5,44,31,142,53,246
202,30,1,64,63,360,52,67,6,55,184,364,53,247
226,16,0,70,82,394,57,69,9,67,202,404,53,248
194,25,0,60,69,348,46,83,6,65,175,375,53,249
111,16,0,44,79,250,54,51,2,54,109,270,53,250
33,28,1,49,33,144,3,44,3,53,50,153,53,251
29,40,2,64,51,186,11,72,4,51,72,210,53,252
157,36,1,46,75,315,44,74,10,54,133,315,53,253
223,17,0,65,74,379,49,71,9,53,230,412,53,254
231,25,4,41,79,380,64,91,4,55,176,390,53,255
210,19,2,63,87,381,56,67,5,59,190,377,53,256
110,19,0,66,69,264,46,67,3,71,106,293,53,257
35,26,2,68,48,179,8,61,26,43,60,198,53,258
35,15,0,61,34,145,6,17,17,59,58,157,53,259
143,9,2,52,55,261,39,43,4,54,133,273,53,260
214,21,2,57,73,367,51,71,13,56,188,379,53,261
261,33,3,71,82,450,74,107,50,76,199,506,53,262
191,21,0,91,81,384,57,120,3,53,170,403,53,263
119,16,2,59,95,291,47,41,13,71,121,293,53,264
35,16,0,99,53,203,13,60,11,53,68,205,53,265
29,25,0,49,35,138,4,45,2,47,62,160,53,266
155,16,0,86,62,319,36,56,5,81,139,317,53,267
212,19,3,64,79,377,48,73,16,55,203,395,53,268
237,23,2,48,105,415,54,98,3,59,195,409,53,269
195,24,4,81,86,390,42,86,8,52,192,380,53,270
104,17,1,47,95,264,39,60,22,46,127,294,53,271
28,17,0,104,44,193,10,92,13,47,48,210,53,272
23,19,0,77,30,149,3,46,8,33,49,139,53,273
176,21,0,130,52,379,75,57,3,93,141,369,53,274
247,5,0,101,71,424,76,79,4,86,192,437,53,275
250,19,5,76,101,451,73,78,13,76,205,445,53,276
203,19,0,85,74,381,73,77,3,61,175,389,53,277
111,15,3,68,73,270,47,53,14,50,125,289,53,278
36,12,0,88,46,182,2,67,8,67,54,198,53,279
28,15,2,86,58,189,4,62,9,33,62,170,53,280
159,16,0,59,71,305,48,62,6,52,144,312,53,281
249,14,0,80,74,417,65,88,3,61,237,454,53,282
246,19,0,76,85,426,56,64,8,64,206,398,53,283
200,27,2,81,77,387,79,87,8,64,181,419,53,284
106,31,1,89,95,322,66,58,8,65,131,328,53,285
35,23,0,76,42,176,9,60,14,47,43,173,53,286
34,13,1,70,50,168,6,61,12,37,56,172,53,287
80,19,3,95,64,261,33,50,6,57,116,262,53,288
232,15,1,89,95,432,48,94,6,65,199,412,53,289
239,18,0,67,89,413,56,93,6,54,228,437,53,290
206,25,0,79,85,395,52,73,13,62,192,392,53,291
118,23,0,91,75,307,51,52,12,65,118,298,53,292
26,16,1,107,69,219,2,68,15,61,80,226,53,293
30,25,2,62,48,167,2,52,5,49,52,160,53,294
153,16,0,57,74,300,51,49,5,51,145,301,53,295
232,22,2,63,73,392,51,83,10,53,205,402,53,296
230,13,1,73,86,403,57,88,5,77,198,425,53,297
205,29,4,76,74,388,57,86,11,75,201,430,53,298
109,33,0,52,69,263,48,57,8,50,135,298,53,299
21,29,1,84,49,184,2,48,20,57,67,194,53,300
27,15,3,71,63,179,6,48,15,33,71,173,53,301
162,15,0,52,68,297,36,54,6,43,148,287,53,302
198,19,1,77,114,409,58,112,12,46,192,420,53,303
208,11,0,55,101,375,51,84,8,52,189,384,53,304
150,24,4,50,77,305,42,73,13,47,150,325,53,305
95,38,2,76,76,287,37,69,13,60,119,298,53,306
30,20,3,74,80,207,7,82,10,53,87,239,53,307
19,12,0,71,45,147,2,58,6,32,58,156,53,308
143,16,0,69,74,302,50,62,3,55,131,301,53,309
164,18,0,59,68,309,46,42,4,65,163,320,53,310
198,10,15,53,89,365,71,66,15,53,164,369,53,311
182,10,4,57,63,316,53,62,4,36,168,323,53,312
116,23,2,63,78,282,37,71,9,60,112,289,53,313
23,16,0,76,38,153,8,42,4,51,71,176,53,314
29,20,1,63,29,142,13,32,9,37,49,140,53,315
88,17,1,47,54,207,36,57,2,37,71,203,53,316
220,20,5,67,69,381,57,62,9,60,200,388,53,317
230,15,1,61,87,394,42,74,9,61,206,392,53,318
229,27,2,68,60,386,57,78,10,76,176,397,53,319
147,13,1,61,83,305,53,62,6,50,132,303,53,320
29,30,0,72,41,172,7,47,10,46,90,200,53,321
24,16,1,45,33,119,4,40,4,36,45,129,53,322
151,17,3,56,79,306,51,54,8,44,143,300,53,323
231,15,0,61,67,374,60,78,3,67,186,394,53,324
247,17,1,58,75,398,50,68,9,61,234,422,53,325
197,11,4,44,69,325,39,74,8,62,169,352,53,326
112,24,1,44,76,257,55,70,9,67,99,300,53,327
23,21,0,40,51,135,6,35,7,47,57,152,53,328
18,19,1,88,25,151,9,41,6,51,71,178,53,329
133,13,1,53,76,276,44,43,9,51,164,311,53,330
163,19,1,61,73,317,48,72,5,47,168,340,53,331
91,34,0,83,79,287,29,75,5,83,141,333,53,332
22,12,0,34,15,83,9,14,2,27,53,105,53,333
51,20,0,84,39,194,17,28,2,36,94,177,53,334
19,10,1,62,44,136,4,33,7,21,66,131,53,335
30,15,2,57,38,142,5,34,6,28,47,120,53,336
145,6,0,64,73,288,42,47,6,42,154,291,53,337
236,25,1,61,88,411,50,90,6,48,208,402,53,338
231,24,0,69,69,393,53,71,8,57,206,395,53,339
202,21,0,57,70,350,31,73,8,47,199,358,53,340
109,16,0,56,68,249,37,58,7,42,146,290,53,341
19,21,4,39,49,132,4,56,10,31,56,157,53,342
25,17,2,60,45,149,8,43,12,31,50,144,53,343
171,13,2,51,58,295,44,59,14,38,163,318,53,344
237,9,1,65,71,383,39,86,7,49,206,387,53,345
220,15,3,69,70,377,49,83,4,54,202,392,53,346
195,19,3,76,76,369,39,88,10,43,179,359,53,347
120,23,1,55,55,254,36,41,13,61,122,273,53,348
37,22,3,86,69,217,11,91,10,59,60,231,53,349
9,18,5,59,34,125,5,35,12,34,54,140,53,350
145,18,1,37,72,273,36,50,4,43,127,260,53,351
213,29,0,71,90,403,44,112,13,49,195,413,53,352
205,15,0,71,69,360,53,69,7,52,196,377,53,353
163,13,4,70,64,314,35,70,11,41,176,333,53,354
85,14,0,52,55,206,32,47,5,50,98,232,53,355
22,19,1,59,34,135,6,58,3,31,53,151,53,356
24,15,4,61,36,140,12,84,7,26,51,180,53,357
76,18,2,80,67,243,28,91,7,48,98,272,53,358
43,11,2,61,28,145,22,20,5,57,61,165,53,359
11,23,3,14,37,88,6,42,1,17,22,88,53,360
71,7,0,71,43,192,33,55,10,35,81,214,53,361
52,29,6,102,57,246,25,54,13,43,93,228,53,362
12,16,0,67,33,128,9,45,7,36,49,146,53,363
19,20,0,90,42,171,1,45,17,35,61,159,53,364
75,41,5,98,71,290,48,82,14,48,112,304,53,365
60,56,19,74,63,272,30,62,38,45,74,249,53,366
33,67,6,108,62,276,33,75,4,139,110,361,54,1
274,100,0,239,615,1228,595,219,2,240,356,1412,54,2
321,98,8,239,893,1559,768,151,14,246,417,1596,54,3
314,120,2,255,874,1565,758,142,8,281,402,1591,54,4
186,94,11,211,383,885,286,148,11,170,301,916,54,5
47,77,6,160,117,407,56,110,19,122,109,416,54,6
31,115,2,202,98,448,36,98,5,155,192,486,54,7
280,89,4,171,449,993,380,129,10,161,334,1014,54,8
353,120,2,236,896,1607,993,90,8,293,356,1740,54,9
352,160,1,297,1259,2069,1092,154,5,390,457,2098,54,10
379,227,7,271,1170,2054,1027,235,12,329,451,2054,54,11
214,96,8,219,328,865,275,110,11,162,220,778,54,12
53,79,4,206,143,485,45,146,14,115,157,477,54,13
49,40,1,127,82,299,43,62,0,88,109,302,54,14
62,44,8,102,119,335,66,82,5,87,86,326,54,15
133,70,1,130,300,634,258,88,5,155,151,657,54,16
301,139,0,272,1107,1819,1010,149,4,354,343,1860,54,17
356,130,3,267,1195,1951,974,173,5,401,417,1970,54,18
151,84,6,227,225,693,200,164,12,181,187,744,54,19
51,168,10,182,180,591,65,155,19,152,202,593,54,20
33,47,2,150,119,351,33,81,2,132,121,369,54,21
287,86,2,168,435,978,406,124,5,201,345,1081,54,22
466,166,5,267,1445,2349,1321,186,5,367,456,2335,54,23
399,208,1,277,1346,2231,1226,209,8,381,468,2292,54,24
402,157,1,336,1176,2072,1005,183,6,603,401,2198,54,25
249,183,16,343,433,1224,364,179,20,294,358,1215,54,26
72,118,14,316,194,714,70,120,20,210,241,661,54,27
41,76,4,164,131,416,43,101,3,163,150,460,54,28
326,104,2,218,801,1451,488,148,6,702,330,1674,54,29
425,153,1,337,1435,2351,1306,157,6,407,448,2324,54,30
403,175,3,283,1387,2251,1212,186,5,449,407,2259,54,31
383,191,5,358,1283,2220,1200,194,6,449,445,2294,54,32
237,119,9,244,446,1055,313,166,15,247,295,1036,54,33
66,129,10,257,190,652,70,127,22,194,251,664,54,34
42,98,2,178,134,454,35,89,2,152,209,487,54,35
281,84,6,194,488,1053,393,137,6,205,364,1105,54,36
405,154,2,315,1529,2405,1337,186,4,415,467,2409,54,37
399,187,1,333,1449,2369,1285,201,6,423,452,2367,54,38
419,146,3,348,1285,2201,1132,194,5,441,449,2221,54,39
225,182,14,259,405,1085,322,150,20,216,392,1100,54,40
79,146,4,256,207,692,73,184,21,175,257,710,54,41
28,96,4,175,119,422,33,95,9,136,216,489,54,42
287,82,14,180,470,1033,393,118,16,169,347,1043,54,43
332,172,1,250,1384,2139,1203,184,8,439,367,2201,54,44
397,146,6,296,1368,2213,994,174,12,476,508,2164,54,45
379,168,1,320,1280,2148,1063,155,3,465,440,2126,54,46
212,174,15,289,430,1120,339,185,37,239,334,1134,54,47
61,108,7,185,201,562,61,142,18,193,179,593,54,48
42,116,3,204,162,527,33,128,6,175,202,544,54,49
92,56,2,191,282,623,148,125,2,182,252,709,54,50
398,157,2,262,1410,2229,1337,166,4,323,459,2289,54,51
416,168,0,326,1519,2429,1325,189,6,419,470,2409,54,52
389,170,3,342,1289,2193,1173,223,2,387,476,2261,54,53
245,129,11,249,429,1063,334,138,15,204,303,994,54,54
62,117,8,254,196,637,62,122,14,213,265,676,54,55
41,87,1,187,148,464,38,123,1,126,201,489,54,56
332,104,5,193,501,1135,400,136,6,198,410,1150,54,57
460,192,3,295,1549,2499,1436,193,6,396,489,2520,54,58
409,168,0,320,1363,2260,1342,169,5,382,427,2325,54,59
422,180,4,336,1321,2263,1131,179,6,512,448,2276,54,60
240,154,10,268,441,1113,315,174,16,230,349,1084,54,61
54,144,13,210,181,602,59,133,16,152,243,603,54,62
60,93,12,249,162,576,49,97,11,186,235,578,54,63
302,95,3,195,486,1081,414,149,3,191,341,1098,54,64
372,144,1,303,1472,2292,996,157,3,702,487,2345,54,65
402,151,1,313,1425,2292,1273,193,4,378,463,2311,54,66
389,214,7,367,1415,2392,1175,209,11,456,521,2372,54,67
244,176,8,276,478,1182,351,207,22,243,386,1209,54,68
69,113,6,193,168,549,67,146,12,161,191,577,54,69
40,89,3,187,158,477,38,90,8,161,198,495,54,70
314,94,5,191,466,1070,407,140,13,200,366,1126,54,71
416,215,5,353,1544,2533,1383,248,7,488,537,2663,54,72
401,217,1,375,1452,2446,1230,232,13,488,526,2489,54,73
381,278,1,455,1335,2450,1112,263,23,512,581,2491,54,74
246,145,19,307,468,1185,347,203,35,245,356,1186,54,75
72,224,10,397,273,976,60,293,41,248,404,1046,54,76
61,92,5,297,193,648,42,151,4,233,271,701,54,77
307,92,3,212,596,1210,439,167,6,216,370,1198,54,78
440,204,0,314,1579,2537,1441,219,2,408,464,2534,54,79
427,213,0,399,1533,2572,1285,281,9,478,509,2562,54,80
400,170,0,394,1390,2354,1132,229,9,468,472,2310,54,81
248,168,18,351,485,1270,339,283,20,246,378,1266,54,82
61,182,8,240,202,693,47,224,15,124,255,665,54,83
92,87,4,408,193,784,35,186,6,257,312,796,54,84
317,105,5,294,559,1280,419,186,20,238,411,1274,54,85
466,142,0,388,1597,2593,1342,243,4,485,541,2615,54,86
359,178,11,363,1295,2206,1198,175,17,366,469,2225,54,87
350,183,1,395,1228,2157,1010,190,14,432,461,2107,54,88
239,179,6,384,415,1223,319,255,18,258,405,1255,54,89
74,154,4,449,241,922,54,285,22,226,413,1000,54,90
63,88,2,246,166,565,50,130,3,203,265,651,54,91
280,102,3,325,456,1166,352,194,9,244,379,1178,54,92
422,173,1,348,1534,2478,1413,226,5,405,468,2517,54,93
391,173,3,318,1262,2147,1176,260,10,346,405,2197,54,94
418,203,9,432,1391,2453,1154,328,8,455,508,2453,54,95
307,141,11,431,508,1398,349,253,27,280,424,1333,54,96
106,154,10,390,288,948,68,229,17,319,300,933,54,97
74,130,2,219,219,644,37,150,7,249,249,692,54,98
340,117,5,211,460,1133,390,192,10,226,379,1197,54,99
465,202,1,363,1481,2512,1337,201,7,442,589,2576,54,100
405,247,13,361,1404,2430,1194,236,22,521,512,2485,54,101
417,165,19,354,1273,2228,1086,241,20,467,521,2335,54,102
260,199,14,358,451,1282,382,214,33,289,388,1306,54,103
97,134,23,331,275,860,83,224,40,221,300,868,54,104
55,120,3,266,200,644,40,168,3,217,270,698,54,105
378,116,3,330,562,1389,445,208,4,259,388,1304,54,106
466,231,10,371,1552,2630,1465,226,15,440,535,2681,54,107
449,220,1,383,1412,2465,1361,209,7,410,538,2525,54,108
454,196,6,353,1361,2370,1130,238,6,486,517,2377,54,109
276,162,11,316,531,1296,370,187,30,281,399,1267,54,110
61,237,13,444,269,1024,55,274,43,234,450,1056,54,111
42,103,6,249,156,556,41,116,10,171,182,520,54,112
330,111,3,232,480,1156,420,148,6,223,387,1184,54,113
438,207,2,352,1513,2512,1379,232,14,456,521,2602,54,114
436,252,3,371,1490,2552,1213,297,4,483,591,2588,54,115
429,285,2,424,1401,2541,1109,337,7,503,578,2534,54,116
271,209,7,356,512,1355,330,252,21,255,422,1280,54,117
88,105,6,304,249,752,70,176,56,220,235,757,54,118
67,138,7,237,247,696,47,178,43,193,267,728,54,119
325,133,5,227,507,1197,430,179,12,216,402,1239,54,120
443,217,4,387,1570,2621,1435,219,6,481,522,2663,54,121
433,301,7,374,1503,2618,1391,291,10,500,526,2718,54,122
428,230,1,385,1382,2426,1227,204,12,479,505,2427,54,123
295,255,19,303,521,1393,358,279,40,277,449,1403,54,124
84,124,6,260,223,697,73,170,19,229,245,736,54,125
57,126,9,170,126,488,51,160,14,145,171,541,54,126
329,127,12,220,534,1222,431,175,16,202,421,1245,54,127
465,226,14,413,1636,2754,1455,254,19,513,504,2745,54,128
447,238,14,419,1465,2583,1283,274,28,471,505,2561,54,129
375,189,5,431,1352,2352,1175,198,8,483,512,2376,54,130
280,189,16,279,427,1191,360,195,34,245,364,1198,54,131
86,210,6,363,212,877,89,245,16,250,361,961,54,132
37,136,7,203,148,531,42,124,8,189,251,614,54,133
324,128,1,230,537,1220,432,157,6,209,444,1248,54,134
454,238,2,350,1482,2526,1419,182,4,437,551,2593,54,135
459,287,3,382,1411,2542,1277,244,5,500,507,2533,54,136
440,264,7,443,1451,2605,1239,238,11,510,565,2563,54,137
291,238,10,383,512,1434,385,236,40,303,458,1422,54,138
101,197,8,276,242,824,69,231,34,218,250,802,54,139
67,154,5,253,203,682,50,187,6,238,248,729,54,140
348,114,10,274,587,1333,472,201,8,214,411,1306,54,141
489,158,13,376,776,1812,685,226,14,308,562,1795,54,142
484,200,2,339,832,1857,671,248,5,310,550,1784,54,143
425,187,8,312,793,1725,595,214,7,366,509,1691,54,144
252,250,9,382,446,1339,373,278,28,281,407,1367,54,145
94,176,19,325,251,865,64,248,41,224,308,885,54,146
69,131,5,276,204,685,54,190,7,196,277,724,54,147
61,100,13,238,144,556,55,130,12,179,219,595,54,148
460,202,4,418,1358,2442,1258,205,35,420,529,2447,54,149
472,209,2,428,1417,2528,1352,202,4,492,482,2532,54,150
448,269,3,420,1508,2648,1325,244,3,500,581,2653,54,151
318,254,16,317,532,1437,400,269,25,306,393,1393,54,152
98,226,11,344,322,1001,82,295,18,271,324,990,54,153
60,129,6,273,235,703,54,163,7,388,257,869,54,154
408,137,5,242,662,1454,523,200,5,271,414,1413,54,155
522,318,8,442,1787,3077,1721,234,8,554,610,3127,54,156
504,297,1,536,1672,3010,1510,297,7,571,626,3011,54,157
486,333,2,501,1676,2998,1507,314,10,580,614,3025,54,158
319,231,17,459,699,1725,399,322,37,302,455,1515,54,159
79,295,12,554,361,1301,84,444,51,290,411,1280,54,160
50,217,5,288,198,758,58,205,9,223,285,780,54,161
366,135,4,255,665,1425,554,150,7,240,463,1414,54,162
513,316,2,421,2104,3356,1979,266,2,476,597,3320,54,163
512,339,21,490,2016,3378,1840,282,21,562,637,3342,54,164
497,312,6,476,1833,3124,1606,252,6,542,595,3001,54,165
279,222,21,343,603,1468,435,281,40,315,430,1501,54,166
87,273,13,324,272,969,88,289,30,207,365,979,54,167
52,205,5,235,189,686,56,175,6,231,320,788,54,168
374,138,16,260,642,1430,537,199,14,240,437,1427,54,169
448,281,3,648,1788,3168,1794,366,13,455,595,3223,54,170
165,254,2,327,470,1218,395,222,4,271,363,1255,54,171
419,346,3,476,1708,2952,1571,266,10,513,577,2937,54,172
351,213,4,299,501,1368,425,204,26,272,419,1346,54,173
79,359,17,243,231,929,68,272,41,233,355,969,54,174
56,367,6,185,158,772,56,143,16,186,376,777,54,175
389,140,6,271,627,1433,547,183,6,287,423,1446,54,176
506,405,3,426,1901,3241,1913,301,2,524,609,3349,54,177
485,315,4,414,1888,3106,1714,217,9,513,594,3047,54,178
472,276,5,432,1780,2965,1628,231,12,533,573,2977,54,179
278,277,17,306,554,1432,415,238,37,241,470,1401,54,180
91,326,23,271,293,1004,91,278,29,229,377,1004,54,181
62,112,2,212,156,544,52,131,6,179,219,587,54,182
382,134,2,258,665,1441,576,196,5,245,439,1461,54,183
450,229,0,404,1194,2277,1067,214,5,373,748,2407,54,184
363,191,2,476,631,1663,640,258,29,302,415,1644,54,185
104,500,4,385,478,1471,72,910,30,278,268,1558,54,186
171,208,9,307,345,1040,236,257,17,255,325,1090,54,187
59,187,11,286,169,712,68,193,25,192,253,731,54,188
66,101,2,193,156,518,53,138,6,179,217,593,54,189
361,157,3,296,613,1430,528,223,6,287,457,1501,54,190
462,244,8,406,1938,3058,1851,209,12,480,550,3102,54,191
427,268,8,405,1797,2905,1615,244,25,506,642,3032,54,192
420,516,4,424,1461,2825,1428,255,25,626,517,2851,54,193
276,259,14,329,582,1460,396,281,30,261,409,1377,54,194
91,377,17,362,278,1125,65,353,25,251,441,1135,54,195
52,127,20,207,180,586,65,152,14,197,272,700,54,196
357,119,5,230,620,1331,551,154,8,224,409,1346,54,197
462,218,5,380,1853,2918,1804,190,11,493,517,3015,54,198
409,231,1,416,1746,2803,1623,192,4,565,542,2926,54,199
433,298,1,528,1767,3027,1624,238,10,533,591,2996,54,200
267,319,15,299,603,1503,410,270,45,265,456,1446,54,201
56,188,5,293,296,838,78,286,27,222,260,873,54,202
71,192,2,229,182,676,56,199,4,173,259,691,54,203
362,134,8,266,693,1463,532,259,9,258,408,1466,54,204
434,224,2,402,1982,3044,1753,267,4,592,531,3147,54,205
420,339,7,428,1786,2980,1663,284,16,537,583,3083,54,206
447,303,4,550,1594,2898,1447,210,13,528,675,2873,54,207
256,276,21,330,523,1406,419,215,62,244,459,1399,54,208
57,351,23,322,271,1024,63,323,59,247,378,1070,54,209
42,177,4,217,165,605,61,175,7,184,246,673,54,210
332,111,8,277,596,1324,506,181,23,239,414,1363,54,211
431,248,5,427,1802,2913,1782,197,9,534,499,3021,54,212
417,277,3,434,1692,2823,1585,207,14,522,468,2796,54,213
421,350,1,453,1730,2955,1498,257,10,561,589,2915,54,214
282,292,10,322,599,1505,412,294,41,296,424,1467,54,215
93,178,8,354,160,793,64,269,22,232,255,842,54,216
40,188,8,213,173,622,58,146,12,183,302,701,54,217
322,145,3,262,617,1349,545,178,4,248,410,1385,54,218
404,223,0,489,1831,2947,1769,230,4,564,468,3035,54,219
389,249,0,427,1629,2694,1505,184,5,594,505,2793,54,220
374,186,0,489,1308,2357,1235,158,17,582,461,2453,54,221
222,214,7,239,465,1147,325,205,27,216,313,1086,54,222
62,153,5,245,284,749,70,187,23,226,274,780,54,223
52,126,3,236,185,602,52,170,7,190,221,640,54,224
303,126,3,239,554,1225,473,159,6,215,359,1212,54,225
406,196,0,397,1706,2705,1607,179,3,459,507,2755,54,226
397,208,2,417,1561,2585,1398,213,8,435,503,2557,54,227
389,317,1,476,1513,2696,1382,243,5,460,544,2634,54,228
237,220,4,369,463,1293,382,206,20,254,457,1319,54,229
77,190,5,244,241,757,66,151,21,229,284,751,54,230
56,128,2,213,149,548,49,116,9,160,241,575,54,231
304,156,3,249,599,1311,530,175,4,246,394,1349,54,232
408,250,1,345,1796,2800,1681,222,8,440,529,2880,54,233
415,284,7,403,1759,2868,1551,292,16,580,587,3026,54,234
374,223,2,518,1559,2676,1381,215,7,570,520,2693,54,235
256,247,23,377,477,1380,440,244,31,251,424,1390,54,236
84,293,14,300,273,964,73,269,36,267,342,987,54,237
47,161,2,200,202,612,52,186,15,195,325,773,54,238
359,180,5,280,621,1445,578,216,9,245,417,1465,54,239
462,299,0,390,1811,2962,1674,278,7,543,511,3013,54,240
420,228,6,395,1839,2888,1568,325,17,429,536,2875,54,241
426,243,0,611,1364,2644,1276,201,5,526,508,2516,54,242
248,199,10,322,437,1216,319,214,37,248,396,1214,54,243
82,189,5,312,200,788,58,202,23,247,262,792,54,244
41,146,2,260,152,601,49,149,14,179,252,643,54,245
58,101,23,193,170,545,71,131,24,191,189,606,54,246
422,210,0,401,1518,2551,1432,224,3,480,516,2655,54,247
424,224,0,393,1681,2722,1558,202,2,488,475,2725,54,248
436,307,0,421,1640,2804,1455,233,3,501,559,2751,54,249
279,446,11,276,455,1467,395,258,20,250,572,1495,54,250
84,206,18,298,231,837,86,219,43,223,258,829,54,251
64,113,2,227,141,547,60,156,5,174,235,630,54,252
365,147,3,257,691,1463,604,195,8,245,436,1488,54,253
481,254,5,472,1896,3108,1794,259,5,510,581,3149,54,254
434,298,1,500,1741,2974,1583,325,6,511,617,3042,54,255
478,332,1,509,1603,2923,1408,294,2,538,663,2905,54,256
314,275,11,358,511,1469,406,241,29,315,495,1486,54,257
89,280,23,332,324,1048,78,264,21,230,405,998,54,258
68,189,2,262,196,717,58,173,4,216,272,723,54,259
357,245,5,294,627,1528,524,194,6,233,572,1529,54,260
489,355,4,472,1744,3064,1748,218,7,514,729,3216,54,261
453,253,2,407,1580,2695,1510,260,9,495,575,2849,54,262
471,232,4,470,1537,2714,1437,264,7,488,529,2725,54,263
286,285,8,326,541,1446,438,245,22,293,468,1466,54,264
75,227,14,331,323,970,65,239,36,337,338,1015,54,265
59,121,3,155,167,505,51,158,3,178,197,587,54,266
390,117,19,272,594,1392,556,185,21,258,437,1457,54,267
457,231,2,422,1878,2990,1660,240,12,596,544,3052,54,268
459,205,3,410,1721,2798,1598,210,9,527,525,2869,54,269
476,237,3,471,1457,2644,1405,253,8,534,573,2773,54,270
260,231,7,283,545,1326,397,249,30,216,436,1328,54,271
101,248,13,373,263,998,51,287,20,239,439,1036,54,272
62,132,3,252,134,583,51,151,7,169,256,634,54,273
318,140,5,267,600,1330,490,182,10,231,403,1316,54,274
488,212,3,386,1723,2812,1795,222,5,440,513,2975,54,275
470,221,1,482,1677,2851,1488,207,4,573,611,2883,54,276
440,247,0,503,1499,2689,1360,226,3,504,599,2692,54,277
262,232,10,304,461,1269,372,213,25,256,435,1301,54,278
90,227,17,308,237,879,62,239,39,239,375,954,54,279
46,99,4,252,174,575,49,148,3,199,242,641,54,280
364,154,2,262,669,1451,535,231,7,262,432,1467,54,281
545,256,4,468,1851,3124,1916,245,8,526,572,3267,54,282
495,293,2,464,1736,2990,1721,235,8,583,611,3158,54,283
487,263,0,495,1552,2797,1455,254,5,582,561,2857,54,284
286,211,4,346,477,1324,379,222,28,287,439,1355,54,285
128,176,20,358,278,960,58,302,35,237,319,951,54,286
102,172,4,275,192,745,55,160,16,244,298,773,54,287
182,128,5,284,382,981,249,150,5,251,349,1004,54,288
487,239,1,464,1668,2859,1612,248,14,549,584,3007,54,289
505,235,0,443,1763,2946,1534,242,6,637,564,2983,54,290
445,320,0,501,1621,2887,1431,256,4,558,611,2860,54,291
285,313,8,336,529,1471,398,311,17,261,515,1502,54,292
78,232,11,290,371,982,64,220,22,336,386,1028,54,293
70,178,2,282,230,762,56,195,7,292,295,845,54,294
365,161,11,303,681,1521,541,209,14,290,448,1502,54,295
493,255,1,490,1925,3164,1870,223,4,570,609,3276,54,296
476,278,1,476,1820,3051,1757,260,3,577,586,3183,54,297
487,228,3,510,1706,2934,1542,264,6,511,586,2909,54,298
315,258,9,323,553,1458,398,282,25,268,433,1406,54,299
75,290,18,306,267,956,74,249,33,272,393,1021,54,300
158,131,4,289,206,788,57,165,3,299,301,825,54,301
404,146,22,255,655,1482,519,202,16,324,484,1545,54,302
497,223,7,439,1949,3115,1751,334,9,536,555,3185,54,303
493,239,7,422,1862,3023,1594,256,9,540,596,2995,54,304
421,172,5,488,1470,2556,1299,196,9,482,527,2513,54,305
216,193,6,321,517,1253,357,222,25,272,357,1233,54,306
81,186,17,290,255,829,59,237,30,223,312,861,54,307
48,106,9,223,161,547,52,114,8,203,244,621,54,308
383,133,3,333,650,1502,572,201,5,275,454,1507,54,309
412,151,1,491,1517,2572,1523,165,10,554,441,2693,54,310
419,219,1,421,1583,2643,1505,238,5,533,513,2794,54,311
467,219,2,528,1515,2731,1580,196,3,542,560,2881,54,312
245,194,18,312,572,1341,402,235,29,235,566,1467,54,313
93,157,19,327,232,828,70,187,31,218,326,832,54,314
47,99,1,295,202,644,55,111,5,266,268,705,54,315
201,281,5,307,349,1143,255,243,6,277,470,1251,54,316
512,353,1,469,1787,3122,1875,270,4,527,676,3352,54,317
530,242,3,442,1862,3079,1843,257,10,534,615,3259,54,318
479,214,3,475,1489,2660,1470,235,8,498,535,2746,54,319
277,369,18,310,551,1525,425,318,29,252,491,1515,54,320
83,149,30,340,269,871,81,197,26,224,316,844,54,321
52,99,2,198,188,539,58,98,3,182,227,568,54,322
333,128,3,241,702,1407,601,160,3,243,424,1431,54,323
475,237,2,450,1947,3111,1799,212,6,565,587,3169,54,324
459,188,1,434,1774,2856,1603,172,7,528,541,2851,54,325
466,198,1,484,1487,2636,1358,207,7,508,539,2619,54,326
241,188,16,293,487,1225,407,163,23,260,383,1236,54,327
68,123,12,336,265,804,78,194,20,232,299,823,54,328
57,77,3,232,155,524,64,97,6,171,211,549,54,329
325,119,4,251,546,1245,434,156,4,242,408,1244,54,330
366,146,10,318,715,1555,551,180,9,330,502,1572,54,331
222,142,3,401,323,1091,300,140,6,313,330,1089,54,332
44,61,1,95,59,260,34,39,3,134,100,310,54,333
113,120,6,371,268,878,127,174,14,220,381,916,54,334
42,107,11,256,177,593,54,149,15,196,209,623,54,335
40,89,5,204,153,491,41,90,7,193,231,562,54,336
329,126,5,238,532,1230,462,140,2,260,409,1273,54,337
457,219,3,358,1622,2659,1613,202,7,511,589,2922,54,338
473,215,1,380,1713,2782,1694,216,4,538,517,2969,54,339
425,231,1,467,1596,2720,1437,216,6,528,479,2666,54,340
235,174,13,232,434,1088,376,175,8,207,350,1116,54,341
38,193,12,257,246,746,49,188,21,211,284,753,54,342
47,148,1,226,173,595,53,148,3,177,274,655,54,343
315,190,2,227,614,1348,535,188,6,255,434,1418,54,344
484,309,4,408,1847,3052,1798,227,4,590,518,3137,54,345
453,278,1,421,1542,2695,1640,204,6,597,500,2947,54,346
457,282,1,480,1601,2821,1262,210,5,754,545,2776,54,347
257,212,15,282,492,1258,362,187,41,255,415,1260,54,348
91,166,20,313,263,853,49,235,25,240,267,816,54,349
44,82,4,189,136,455,35,113,7,175,165,495,54,350
314,143,3,234,592,1286,475,152,5,266,371,1269,54,351
476,216,3,490,1615,2800,1416,212,26,538,586,2778,54,352
417,196,1,442,1249,2305,1155,165,8,477,525,2330,54,353
366,221,2,485,1023,2097,863,210,3,455,504,2035,54,354
200,156,7,232,406,1001,282,161,25,209,290,967,54,355
44,108,8,204,167,531,45,106,15,166,190,522,54,356
37,59,10,153,166,425,32,104,12,103,133,384,54,357
156,84,6,246,281,773,217,105,5,155,267,749,54,358
83,47,2,190,123,445,129,44,4,145,132,454,54,359
18,23,3,64,53,161,13,49,3,47,59,171,54,360
99,95,2,194,253,643,165,107,8,173,206,659,54,361
117,122,8,194,253,694,162,123,22,158,237,702,54,362
58,104,6,150,134,452,42,113,13,100,191,459,54,363
40,52,0,156,125,373,36,94,4,134,121,389,54,364
164,98,2,257,323,844,259,110,4,228,284,885,54,365
125,175,58,309,281,948,244,122,133,209,300,1008,54,366
174,220,10,727,563,1694,130,251,14,595,544,1534,55,1
831,525,29,1027,3246,5658,2804,358,31,1363,1174,5730,55,2
1038,695,16,1226,3910,6885,3382,362,18,1794,1391,6947,55,3
962,739,10,1273,3637,6621,3188,409,10,1659,1450,6716,55,4
639,725,72,1024,2261,4721,1702,562,44,1275,1351,4934,55,5
190,424,61,821,593,2089,188,405,45,800,762,2200,55,6
193,377,18,824,757,2169,201,388,22,958,751,2320,55,7
837,677,10,994,3198,5716,2939,386,17,1330,1140,5812,55,8
1121,608,24,1591,3814,7158,3781,339,27,1521,1157,6825,55,9
1205,911,21,1446,4527,8110,4009,523,19,1881,1609,8041,55,10
1188,981,19,1450,4208,7846,3640,533,23,1897,1582,7675,55,11
611,528,46,1134,1661,3980,1405,355,39,1076,951,3826,55,12
186,583,61,868,3079,4777,202,318,32,1002,968,2522,55,13
114,248,8,700,528,1598,139,191,7,575,507,1419,55,14
200,303,7,650,508,1668,283,177,17,554,426,1457,55,15
418,461,6,653,1254,2792,961,326,9,894,687,2877,55,16
1081,939,24,1314,3934,7292,3174,577,30,1975,1596,7352,55,17
1180,982,22,1313,4295,7792,3759,677,21,1853,1604,7914,55,18
462,856,75,871,1407,3671,980,542,39,1072,1248,3881,55,19
191,588,132,928,851,2690,239,555,63,1050,805,2712,55,20
168,370,21,847,747,2153,175,253,22,872,569,1891,55,21
888,717,36,1037,3314,5992,2905,464,25,1459,1176,6029,55,22
1330,966,31,1220,4608,8155,4360,532,35,1806,1675,8408,55,23
1258,1015,21,1393,4459,8146,4105,513,22,1880,1711,8231,55,24
1196,996,17,1235,4221,7665,3728,560,15,1767,1636,7706,55,25
718,1042,132,1332,2392,5616,2004,723,47,1420,1422,5616,55,26
236,692,111,1066,1048,3153,293,539,68,1377,1019,3296,55,27
170,312,19,883,671,2055,179,288,22,888,577,1954,55,28
889,770,23,1152,3204,6038,2873,450,25,1481,1374,6203,55,29
1365,945,40,1205,4611,8166,4255,496,37,1802,1678,8268,55,30
1321,1039,43,1293,4687,8383,4231,541,35,1830,1701,8338,55,31
1292,1126,27,1279,4368,8092,3872,591,25,1854,1715,8057,55,32
767,915,101,1174,2389,5346,2064,705,39,1331,1379,5518,55,33
201,773,117,1127,1080,3298,242,647,50,1241,1074,3254,55,34
177,381,21,937,851,2367,181,321,16,1071,712,2301,55,35
899,760,21,1078,3258,6016,3049,406,22,1390,1279,6146,55,36
1369,953,34,1215,4730,8301,4271,512,32,1917,1752,8484,55,37
1407,1068,43,1277,4616,8411,4116,558,40,2020,1721,8455,55,38
1259,976,25,1311,4368,7939,3875,569,28,1869,1753,8094,55,39
793,903,112,1297,2419,5524,2021,766,43,1368,1368,5566,55,40
225,756,126,994,981,3082,241,728,79,1122,997,3167,55,41
152,388,36,901,842,2319,179,361,54,830,655,2079,55,42
886,876,43,1008,3387,6200,2912,499,45,1475,1345,6276,55,43
1232,1004,46,1200,4197,7679,3831,526,50,1822,1720,7949,55,44
1305,1007,54,1477,4754,8597,4144,660,39,2529,1790,9162,55,45
1259,1089,22,1344,4128,7842,3661,553,29,1783,1714,7740,55,46
739,950,102,1364,2235,5390,1873,731,54,1453,1407,5518,55,47
212,669,91,1017,956,2945,237,572,45,1245,963,3062,55,48
207,431,29,964,931,2562,227,357,29,1063,773,2449,55,49
376,531,16,1042,1112,3077,551,366,18,1178,967,3080,55,50
1289,903,19,1338,4583,8132,4210,519,22,1897,1666,8314,55,51
1293,1051,31,1478,4539,8392,4218,622,30,2003,1804,8677,55,52
1288,1072,45,1441,4222,8068,3848,622,35,1988,1756,8249,55,53
789,928,136,1320,2362,5535,2059,696,70,1419,1516,5760,55,54
216,758,130,1141,1311,3556,252,677,73,1341,1111,3454,55,55
201,409,54,967,897,2528,231,385,45,1042,708,2411,55,56
1027,809,48,1227,3284,6395,3088,494,59,1424,1349,6414,55,57
1352,981,47,1427,4700,8507,4370,555,37,1985,1682,8629,55,58
1309,1053,40,1565,4680,8647,4158,531,47,1894,1726,8356,55,59
1219,1112,23,1541,4304,8199,3970,637,40,1970,1751,8368,55,60
801,990,103,1393,2485,5772,2017,666,78,1544,1439,5744,55,61
217,723,145,1087,983,3155,232,639,73,1185,1127,3256,55,62
323,459,66,1011,966,2825,247,331,73,1183,875,2709,55,63
977,891,18,1317,3472,6675,3161,479,23,1503,1513,6679,55,64
1462,1026,39,1482,4639,8648,4286,585,49,1909,1829,8658,55,65
1414,1059,33,1427,4751,8684,4185,601,26,2037,1964,8813,55,66
1252,1443,38,1653,4302,8688,3878,747,35,1992,2196,8848,55,67
958,1134,105,1440,2659,6296,2040,779,42,1712,1709,6282,55,68
260,672,88,1168,938,3126,320,556,55,1228,1129,3288,55,69
198,512,19,1168,1084,2981,278,407,32,1221,983,2921,55,70
1012,877,51,1298,3510,6748,2930,632,56,1791,1499,6908,55,71
1445,1244,61,1621,4957,9328,4288,684,54,2251,2133,9410,55,72
1408,1357,27,1974,4966,9732,4335,788,26,2300,2212,9661,55,73
1193,1321,32,1769,4511,8826,3924,740,23,2296,2058,9041,55,74
794,1008,113,1625,2659,6199,2178,771,69,1847,1700,6565,55,75
312,1156,133,1658,1492,4751,358,757,67,2096,1485,4763,55,76
248,621,19,1195,1158,3241,261,530,18,1328,987,3124,55,77
1005,885,16,1389,3571,6866,3026,536,14,1813,1714,7103,55,78
1404,1261,37,1720,5019,9441,4525,712,34,2265,2007,9543,55,79
1442,1284,22,1550,4999,9297,4490,770,17,2128,2142,9547,55,80
1433,1403,38,1738,4822,9434,4005,912,55,2362,2257,9591,55,81
1009,1213,95,1850,2808,6975,2156,979,46,1943,1881,7005,55,82
245,897,118,1435,1309,4004,265,868,48,1451,1526,4158,55,83
299,692,19,1808,1812,4630,346,655,13,1794,1485,4293,55,84
1105,1189,13,1898,3801,8006,2909,783,17,2191,1946,7846,55,85
1487,1216,16,2031,4953,9703,4070,722,18,2571,2451,9832,55,86
1435,1082,21,2133,4673,9344,3940,758,32,2297,2321,9348,55,87
1216,1205,16,2178,4343,8958,3406,790,20,2412,2319,8947,55,88
846,1242,124,2186,2684,7082,1694,1044,47,2283,2148,7216,55,89
380,1076,125,2225,1918,5724,407,809,55,2114,1753,5138,55,90
314,634,13,1696,1246,3903,278,546,12,1568,1185,3589,55,91
936,1004,33,1932,3677,7582,2853,669,40,2001,1700,7263,55,92
1451,1015,37,2036,4944,9483,4267,682,35,2496,2187,9667,55,93
1305,1239,33,2076,4932,9585,4219,751,28,2441,2173,9612,55,94
1424,1355,61,2261,4881,9982,4087,953,60,2695,2343,10138,55,95
936,1230,112,2151,2959,7388,2134,972,39,2213,1974,7332,55,96
347,1114,114,2131,1667,5373,418,899,47,1981,1512,4857,55,97
408,744,15,1684,1302,4153,327,456,18,1712,1304,3817,55,98
1049,821,15,1459,3201,6545,2967,575,53,1579,1454,6628,55,99
1376,1114,11,1486,4806,8793,4288,671,15,2011,1877,8862,55,100
1383,1348,42,1604,4759,9136,4173,672,42,2177,2039,9103,55,101
1315,1116,25,1655,4499,8610,3958,754,28,2071,2023,8834,55,102
969,1121,112,1574,2524,6300,2019,786,35,1691,1735,6266,55,103
376,955,142,1657,1439,4569,315,879,48,1889,1514,4645,55,104
340,631,12,1422,1363,3768,297,567,17,1409,1126,3416,55,105
1071,964,18,1469,3550,7072,2910,594,20,1746,1516,6786,55,106
1483,1157,29,1854,4699,9222,4361,659,27,2191,1945,9183,55,107
1400,1136,32,1829,4739,9136,4340,652,41,2327,2027,9387,55,108
1327,1318,11,1760,4404,8820,4086,787,20,2179,1968,9040,55,109
852,1128,113,1765,2858,6716,2157,958,37,1761,1806,6719,55,110
320,1026,156,1389,1333,4224,302,989,71,1582,1485,4429,55,111
373,432,14,1255,881,2955,202,396,15,1121,1015,2749,55,112
1092,783,10,1290,3299,6474,2871,479,14,1632,1631,6627,55,113
1374,1058,33,1481,4833,8779,4206,726,23,2215,1876,9046,55,114
1384,1212,21,1631,4841,9089,4196,752,23,2262,1948,9181,55,115
1253,1284,24,1663,4481,8705,3966,824,35,2034,2029,8888,55,116
836,1094,114,1547,2567,6158,2068,800,38,1746,1734,6386,55,117
297,832,125,1381,1120,3755,356,917,125,1315,1222,3935,55,118
257,632,15,1203,1151,3258,229,633,58,1310,981,3211,55,119
1040,804,9,1363,3334,6550,2914,545,10,1639,1504,6612,55,120
1485,1146,39,1662,4718,9050,4456,708,31,2047,1903,9145,55,121
1452,1222,64,1507,4831,9076,4266,780,68,2080,2090,9284,55,122
1399,1244,16,1623,4272,8554,3814,737,10,2046,1953,8560,55,123
890,1039,109,1725,2478,6241,2130,757,52,1676,1627,6242,55,124
263,663,102,1345,1089,3462,300,696,46,1424,1104,3570,55,125
193,491,17,1107,853,2661,231,411,22,1004,885,2553,55,126
980,811,11,1305,3392,6499,2969,500,11,1580,1409,6469,55,127
1349,1051,53,1661,4972,9086,4516,660,54,2244,1835,9309,55,128
1302,1169,38,1604,4812,8925,4292,703,39,2119,1872,9025,55,129
1314,1217,31,1626,4344,8532,3870,677,34,2104,2005,8690,55,130
928,988,92,1591,2540,6139,1926,764,48,1531,1594,5863,55,131
308,818,109,1357,1436,4028,328,560,41,1697,1371,3997,55,132
216,505,14,1276,1031,3042,290,477,15,1274,931,2987,55,133
981,938,53,1615,3431,7018,3021,707,62,1810,1633,7233,55,134
1383,1047,12,1788,4892,9122,4346,596,15,2186,1971,9114,55,135
1498,1281,63,1800,4704,9346,4413,731,70,2283,2119,9616,55,136
1394,1339,13,1910,4530,9186,4009,835,16,2431,1965,9256,55,137
898,966,89,1706,2652,6311,2114,856,33,1761,1658,6422,55,138
265,809,121,1382,1107,3684,300,720,45,1906,1158,4129,55,139
177,741,19,1229,1067,3233,254,449,20,1362,1077,3162,55,140
1052,973,33,1528,3645,7231,3002,670,43,2010,1564,7289,55,141
1292,1253,57,1677,4883,9162,4438,733,50,2217,1863,9301,55,142
1354,1178,53,1733,4796,9114,4241,666,54,2264,1902,9127,55,143
1164,1186,21,1580,4283,8234,3842,722,25,1928,1697,8214,55,144
748,969,128,1710,2312,5867,1748,923,71,1785,1608,6135,55,145
323,912,94,1510,1360,4199,370,923,57,1683,1491,4524,55,146
288,744,19,1755,1225,4031,242,667,20,1542,1350,3821,55,147
318,452,9,1285,970,3034,229,435,8,1178,1006,2856,55,148
1218,1036,13,1529,4513,8309,4021,635,15,1944,1938,8553,55,149
1313,1077,14,1789,4735,8928,4333,723,13,2296,1843,9208,55,150
1359,1249,41,1836,4533,9018,4042,775,27,2396,2016,9256,55,151
810,1047,108,1767,2640,6372,2163,840,41,1889,1557,6490,55,152
322,951,106,1531,1215,4125,460,889,50,1512,1241,4152,55,153
213,477,30,1229,996,2945,229,539,35,1215,981,2999,55,154
1099,907,28,1390,3762,7186,3309,611,28,1697,1605,7250,55,155
1592,1192,34,1746,5293,9857,4667,835,33,2269,2072,9876,55,156
1482,1153,13,1825,5090,9563,4588,718,17,2410,2171,9904,55,157
1329,1424,16,1804,4732,9305,4226,947,17,2256,2053,9499,55,158
913,1190,135,1797,3187,7222,2204,1127,74,1955,2050,7410,55,159
318,3744,207,2136,8308,14713,467,1542,47,6564,7768,16388,55,160
290,724,24,1626,1164,3828,272,715,26,1478,1348,3839,55,161
1058,985,34,1499,3852,7428,3208,629,34,1850,1770,7491,55,162
1574,1323,84,1679,5153,9813,4711,874,82,2309,2167,10143,55,163
1463,1323,40,1920,5196,9942,4549,820,65,2440,2191,10065,55,164
1388,1398,38,1846,4542,9212,4121,796,46,2405,2115,9483,55,165
949,987,95,1714,2709,6454,2192,937,59,1651,1698,6537,55,166
295,886,131,1558,1194,4064,330,930,60,1554,1376,4250,55,167
233,517,14,1276,972,3012,254,541,21,1218,1053,3087,55,168
1001,906,12,1410,3462,6791,3078,556,19,1825,1607,7085,55,169
1318,1214,12,1795,4786,9125,4252,909,17,2119,1961,9258,55,170
598,850,5,1462,1562,4477,833,754,12,1461,1397,4457,55,171
1249,1309,57,1881,4340,8836,3835,781,57,2236,2174,9083,55,172
941,1076,120,1660,2501,6298,2267,904,52,1767,1731,6721,55,173
379,938,171,1613,1159,4260,375,1102,110,1427,1270,4284,55,174
258,517,22,1172,911,2880,222,547,26,1238,981,3014,55,175
1011,911,11,1429,3497,6859,2978,618,14,2220,1769,7599,55,176
1413,1152,16,1764,5040,9385,4576,711,29,2314,1966,9596,55,177
1433,1362,10,1784,4865,9454,4202,701,11,2612,2071,9597,55,178
1316,1332,7,1881,4623,9159,3992,852,15,2339,2052,9250,55,179
877,1013,116,1698,2658,6362,2094,829,66,1834,1637,6460,55,180
317,867,107,1399,1253,3943,332,839,49,1511,1417,4148,55,181
245,553,10,1213,958,2979,265,496,9,1198,1096,3064,55,182
906,834,18,1422,3496,6676,2924,645,19,1629,1474,6691,55,183
1137,1027,22,1705,4497,8388,3843,770,37,2165,1756,8571,55,184
1036,1084,18,2285,3432,7855,3079,954,25,2155,1872,8085,55,185
381,3663,67,1709,1841,7661,294,2417,42,1968,2419,7140,55,186
596,924,83,2091,2060,5754,1136,994,62,1992,1635,5819,55,187
296,930,85,1690,1269,4270,290,829,52,1462,1403,4036,55,188
263,577,19,1209,910,2978,230,477,24,1165,851,2747,55,189
926,936,7,1557,3415,6841,3122,633,6,1781,1512,7054,55,190
1544,1186,16,2013,5060,9819,4473,766,28,2519,2212,9998,55,191
1497,1303,5,1989,4915,9709,4430,760,15,2287,2256,9748,55,192
1429,1424,23,2066,4568,9510,3931,945,22,2383,2221,9502,55,193
808,1024,138,1953,2455,6378,2149,857,55,1775,1599,6435,55,194
286,1012,116,1461,1329,4204,284,1016,39,1628,1510,4477,55,195
251,476,15,1354,1074,3170,257,414,17,1303,1047,3038,55,196
828,867,26,1394,3488,6603,2439,562,24,1660,1434,6119,55,197
1422,1107,17,1817,4652,9015,4292,720,21,2080,1914,9027,55,198
1407,1152,15,1850,4959,9383,4335,608,15,2328,2065,9351,55,199
1283,1346,20,1787,4348,8784,3720,796,21,2436,1987,8960,55,200
835,1094,118,1739,2653,6439,1880,1014,101,1691,1511,6197,55,201
297,894,132,1524,1464,4311,310,994,88,1572,1488,4452,55,202
246,559,16,1347,1105,3273,224,545,13,1265,1150,3197,55,203
1007,792,14,1539,3407,6759,2945,573,18,1767,1580,6883,55,204
1512,1092,9,1808,4639,9060,4216,936,14,2481,2001,9648,55,205
1283,1296,21,2026,5120,9746,3570,893,35,2630,2186,9314,55,206
1360,1307,20,2013,4398,9098,3618,917,20,2454,2290,9299,55,207
758,1070,136,1865,2565,6394,2011,1029,123,1798,1677,6638,55,208
306,996,178,1650,1716,4846,326,1111,117,1823,1504,4881,55,209
212,621,21,1396,1253,3503,207,633,26,1423,1184,3473,55,210
966,874,16,1529,3467,6852,3021,676,34,1701,1563,6995,55,211
1439,1106,43,1654,4909,9151,4218,663,50,2214,2027,9172,55,212
1331,1113,7,1855,4862,9168,4110,687,11,2362,1941,9111,55,213
1325,1173,7,1893,4262,8660,3558,858,16,2340,1967,8739,55,214
775,1056,98,1794,2448,6171,1948,960,46,1774,1647,6375,55,215
245,712,119,1471,1274,3821,240,584,49,1563,1313,3749,55,216
225,600,40,1273,1083,3221,244,555,57,1272,1028,3156,55,217
890,765,20,1595,3251,6521,2678,668,19,1745,1447,6557,55,218
1426,944,68,1594,4484,8516,3951,761,56,2115,1738,8621,55,219
1402,1117,42,1762,4415,8738,3719,736,40,2302,1954,8751,55,220
1135,878,59,1893,3746,7711,3234,596,51,2116,1764,7761,55,221
580,927,107,1451,2008,5073,1428,847,58,1296,1451,5080,55,222
296,803,135,1372,1177,3783,290,853,57,1317,1259,3776,55,223
218,525,26,1201,997,2967,219,521,33,1177,1091,3041,55,224
953,776,16,1287,3023,6055,2684,543,21,1558,1399,6205,55,225
1346,910,35,1476,4178,7945,3576,664,34,2071,1873,8218,55,226
1385,1089,35,1543,4158,8210,3710,666,36,2040,1898,8350,55,227
1299,1093,44,1617,3748,7801,3288,755,29,1860,1966,7898,55,228
714,997,113,1575,2286,5685,1646,786,39,1607,1574,5652,55,229
322,831,93,1330,1104,3680,258,811,33,1372,1347,3821,55,230
213,437,27,1161,952,2790,205,396,35,1103,930,2669,55,231
885,722,16,1251,2910,5784,2497,564,18,1473,1361,5913,55,232
1280,942,37,1379,4168,7806,3665,734,39,1858,1783,8079,55,233
1324,1066,34,1471,4188,8083,3574,748,42,1890,1747,8001,55,234
1180,1048,78,1529,3602,7437,3035,708,85,1797,1984,7609,55,235
676,941,123,1458,2088,5286,1617,946,46,1432,1471,5512,55,236
244,908,152,1179,1260,3743,288,870,34,1506,1312,4010,55,237
232,457,29,1122,941,2781,224,489,49,1072,967,2801,55,238
1014,745,17,1398,3063,6237,2729,635,22,1499,1494,6379,55,239
1416,868,22,1509,4605,8420,3850,737,34,1977,1835,8433,55,240
1362,992,18,1578,4494,8444,3708,749,15,1999,1943,8414,55,241
1259,909,21,1606,3523,7318,3286,505,35,1874,1536,7236,55,242
724,964,192,1692,1997,5569,1620,1028,67,1632,1361,5708,55,243
254,807,116,1337,1291,3805,276,756,38,1620,1463,4153,55,244
246,628,15,1184,1085,3158,230,633,21,1287,1137,3308,55,245
248,419,21,1116,809,2613,213,409,26,965,791,2404,55,246
1262,834,27,1454,4290,7867,4005,601,32,1897,1631,8166,55,247
1351,1030,6,1502,4597,8486,4277,577,11,1913,1770,8548,55,248
1327,1148,21,1462,4371,8329,3983,705,34,1902,1819,8443,55,249
769,1049,114,1455,2378,5765,1991,909,64,1451,1568,5983,55,250
244,727,167,1716,1475,4329,310,951,62,2095,1299,4717,55,251
269,454,8,1162,833,2726,246,433,14,1018,877,2588,55,252
1032,833,26,1270,3445,6606,3175,548,33,1626,1505,6887,55,253
1423,1170,35,1598,5169,9395,4525,789,44,2077,1901,9336,55,254
1458,1189,33,1617,4861,9158,4398,768,38,2232,1954,9390,55,255
1323,1511,22,1614,4526,8996,3928,801,26,2222,2133,9110,55,256
760,1129,124,1435,2611,6059,2049,847,47,1515,1722,6180,55,257
307,867,165,1279,1207,3825,356,944,67,1427,1332,4126,55,258
261,512,8,1313,1091,3185,279,499,17,1232,1090,3117,55,259
984,864,16,1344,3479,6687,3058,603,15,1547,1525,6748,55,260
1524,1088,19,1662,5199,9492,4435,686,24,2317,1969,9431,55,261
1519,1232,8,1444,4901,9104,4407,685,9,2143,1949,9193,55,262
1340,1363,30,1786,4423,8942,3866,852,28,2231,2095,9072,55,263
853,1020,161,1560,2546,6140,2016,930,64,1725,1652,6387,55,264
268,797,151,1265,1202,3683,325,909,42,1337,1279,3892,55,265
223,435,15,1037,887,2597,205,417,18,1027,778,2445,55,266
1025,859,13,1287,3479,6663,3056,615,17,1535,1525,6748,55,267
1448,1093,80,1510,5255,9386,4391,734,76,1987,1952,9140,55,268
1483,1144,33,1602,4822,9084,4301,781,46,2083,1913,9124,55,269
1340,1255,57,1594,4364,8610,3883,781,62,2121,1929,8776,55,270
773,1078,86,1395,2563,5895,1982,741,59,1550,1621,5953,55,271
219,998,186,1406,1207,4016,339,960,95,1477,1303,4174,55,272
199,454,12,1102,911,2678,227,356,18,947,886,2434,55,273
931,809,38,1370,3343,6491,3010,487,42,1701,1274,6514,55,274
1363,944,27,1628,4872,8834,4427,649,25,2078,1675,8854,55,275
1338,1181,27,1639,4673,8858,4300,697,42,2079,1949,9067,55,276
1261,1167,22,1585,4194,8229,3731,773,34,2039,1883,8460,55,277
823,1023,112,1667,2505,6130,1981,1005,43,1750,1770,6549,55,278
371,1221,133,1456,1291,4472,335,800,45,1573,1694,4447,55,279
286,491,37,1442,1009,3265,266,470,40,1328,1187,3291,55,280
1029,862,8,1366,3496,6761,3100,600,11,1655,1495,6861,55,281
1319,1103,18,1677,5081,9198,4552,640,23,2351,2008,9574,55,282
1434,1216,17,1644,4909,9220,4461,682,24,2181,2023,9371,55,283
1235,1236,11,1704,4533,8719,4082,718,18,2179,2060,9057,55,284
781,1095,80,1641,2519,6116,1938,964,31,1835,1866,6634,55,285
399,972,110,1644,1529,4654,380,917,33,1906,1571,4807,55,286
431,611,15,1531,1407,3995,304,642,19,1784,1268,4017,55,287
654,749,19,1406,2071,4899,1523,492,28,1502,1299,4844,55,288
1409,1258,66,1529,5032,9294,4478,591,69,2184,1925,9247,55,289
1410,1232,6,1769,5219,9636,4576,671,8,2416,2060,9731,55,290
1397,1283,22,1686,4543,8931,4018,769,22,2333,2130,9272,55,291
764,1232,159,1697,2782,6634,2115,1016,70,1849,1758,6808,55,292
303,947,146,1717,1328,4441,324,965,56,1564,1397,4306,55,293
224,549,16,1410,1048,3247,238,633,27,1232,1079,3209,55,294
1042,906,9,1602,3642,7201,3104,590,13,1678,1570,6955,55,295
1412,1158,32,1586,5305,9493,4745,620,20,2261,1896,9542,55,296
1430,1305,22,1643,4987,9387,4473,716,18,2181,2128,9516,55,297
1340,1287,20,1723,4638,9008,4146,782,22,2283,2031,9264,55,298
768,1199,112,1663,2700,6442,2065,823,50,1806,1755,6499,55,299
287,913,154,1576,1310,4240,348,824,62,1520,1571,4325,55,300
759,494,16,1543,1056,3868,303,643,26,1787,1204,3963,55,301
1047,861,22,1423,3600,6953,3184,588,33,1574,1534,6913,55,302
1459,2173,31,2013,4567,10243,4401,776,28,2294,2667,10166,55,303
1420,1294,32,1759,5034,9539,4601,701,35,2261,2201,9799,55,304
1288,983,33,1679,4220,8203,3684,810,44,1910,1764,8212,55,305
722,1033,118,1468,2429,5770,1953,836,52,1657,1600,6098,55,306
307,873,140,1363,1274,3957,310,818,79,1359,1216,3782,55,307
290,366,9,1152,949,2766,237,362,20,1063,879,2561,55,308
968,729,6,1285,3640,6628,3216,450,10,1493,1471,6640,55,309
1138,1009,17,1545,3302,7011,3010,577,33,1721,1790,7131,55,310
1158,858,9,1389,3532,6946,3139,490,11,1641,1539,6820,55,311
1326,1066,6,1488,4163,8049,3748,668,10,1862,1895,8183,55,312
743,988,149,1481,2562,5923,1863,830,54,1870,1569,6186,55,313
315,855,124,1405,1189,3888,277,757,63,1459,1377,3933,55,314
276,428,9,1346,974,3033,253,425,14,1122,1177,2991,55,315
670,593,13,1222,1925,4423,1334,465,17,1401,1128,4345,55,316
1464,1044,32,1530,5254,9324,4714,547,45,2093,1854,9253,55,317
1475,1197,9,1568,5167,9416,4759,634,16,2102,2096,9607,55,318
1386,1218,21,1627,4815,9067,4192,617,20,2123,2020,8972,55,319
803,1002,90,1460,2719,6074,2150,724,46,1563,1632,6115,55,320
237,795,132,1160,1265,3589,272,766,51,1364,1180,3633,55,321
162,401,8,1002,879,2452,235,332,18,1041,828,2454,55,322
976,810,8,1205,3694,6693,3330,494,14,1589,1454,6881,55,323
1492,1175,5,1642,5376,9690,4925,617,8,2213,2019,9782,55,324
1487,1247,9,1702,5098,9543,4656,650,12,2259,2127,9704,55,325
1396,1145,6,1543,4747,8837,4147,629,12,2094,1910,8792,55,326
813,931,85,1592,2469,5890,2080,616,53,1499,1597,5845,55,327
262,594,86,1230,1142,3314,273,654,32,1181,1121,3261,55,328
225,416,28,1273,804,2746,211,360,33,1084,842,2530,55,329
801,622,22,1378,3219,6042,2681,370,26,1474,1264,5815,55,330
847,786,7,1491,3440,6571,2865,467,7,1549,1281,6169,55,331
603,593,7,1508,1819,4530,1666,417,13,1328,929,4353,55,332
161,230,4,573,459,1427,116,252,9,570,508,1455,55,333
294,444,33,1013,1011,2795,492,447,26,1200,991,3156,55,334
168,457,39,942,794,2400,199,432,29,1004,884,2548,55,335
145,303,19,804,634,1905,190,368,36,810,762,2166,55,336
905,682,9,1214,3292,6102,2885,473,19,1656,1381,6414,55,337
1345,1069,4,1448,4973,8839,4573,551,9,2159,1948,9240,55,338
1447,1295,5,1667,4908,9322,4532,634,12,2189,2037,9404,55,339
1400,1347,17,1734,4619,9117,3953,779,14,2127,2332,9205,55,340
911,970,98,1601,2527,6107,2511,729,33,1601,1782,6656,55,341
283,1012,112,1305,1150,3862,223,1005,43,1265,1375,3911,55,342
284,521,10,1044,1093,2952,228,485,23,1247,1372,3355,55,343
912,1008,4,1255,3548,6727,3313,549,8,1752,1505,7127,55,344
1426,1443,13,1543,5560,9985,5029,645,14,2489,2104,10281,55,345
1424,1428,13,1627,5118,9610,4590,615,18,2392,1998,9613,55,346
1381,1603,14,1631,4472,9101,3922,712,13,2643,2184,9474,55,347
800,1213,152,1449,2807,6421,2245,917,71,1750,1814,6797,55,348
489,970,130,1932,1421,4942,291,1294,54,1685,1456,4780,55,349
179,476,14,1314,931,2914,199,332,17,971,894,2413,55,350
994,780,11,1502,3328,6615,2847,482,15,1664,1469,6477,55,351
1345,1103,19,1469,4657,8593,4108,623,23,2060,1916,8730,55,352
1272,1332,12,1640,4192,8448,3827,576,18,2165,1850,8436,55,353
1071,1119,61,1533,3717,7501,3302,623,54,1903,1786,7668,55,354
27,16,15,16,3,77,19,15,19,24,12,89,55,355
12,8,3,16,8,47,3,10,4,22,8,47,55,356
10,7,6,16,5,44,6,8,3,21,5,43,55,357
13,5,14,5,3,40,10,5,20,8,3,46,55,358
55,7,1,33,1,97,51,6,1,38,2,98,55,359
5,1,0,3,4,13,5,0,0,2,1,8,55,360
1,11,6,4,9,31,1,9,4,8,6,28,55,361
8,5,5,5,5,28,6,4,5,8,9,32,55,362
3,1,2,3,2,11,3,0,5,4,3,15,55,363
4,6,9,18,6,43,3,5,9,16,7,40,55,364
311,439,24,672,1232,2678,808,273,29,863,690,2663,55,365
455,623,483,1295,1228,4084,1017,697,243,1181,907,4045,55,366
22,48,7,133,79,289,33,58,8,128,101,328,56,1
313,163,7,443,1312,2238,1216,109,12,521,344,2202,56,2
358,209,11,486,1626,2690,1476,145,12,595,409,2637,56,3
351,217,3,512,1731,2814,1566,107,6,670,418,2767,56,4
238,218,9,498,1456,2419,1392,106,18,556,285,2357,56,5
40,88,4,154,146,432,52,71,9,142,77,351,56,6
36,83,4,162,122,407,35,75,7,171,148,436,56,7
364,203,6,453,1874,2900,1685,110,9,617,410,2831,56,8
417,208,5,684,1531,2845,1680,68,4,685,336,2773,56,9
457,257,3,589,1934,3240,1739,133,4,765,470,3111,56,10
458,268,6,537,1959,3228,1737,168,7,770,447,3129,56,11
279,203,14,641,1419,2556,1488,108,24,630,264,2514,56,12
79,105,5,279,179,647,70,92,24,206,210,602,56,13
81,91,6,195,132,505,52,89,11,182,148,482,56,14
72,99,11,219,202,603,128,80,7,202,165,582,56,15
165,127,7,354,633,1286,575,92,10,446,164,1287,56,16
332,235,6,514,1741,2828,1587,119,8,705,341,2760,56,17
429,227,14,532,1954,3156,1762,166,12,712,422,3074,56,18
146,151,9,688,928,1922,829,122,9,656,295,1911,56,19
39,104,5,192,172,512,49,105,13,169,142,478,56,20
39,72,9,177,167,464,39,65,3,178,136,421,56,21
361,251,15,461,1926,3014,1711,122,6,712,372,2923,56,22
510,263,20,510,2022,3325,1879,151,24,721,510,3285,56,23
507,243,13,584,2059,3406,1856,164,10,822,425,3277,56,24
462,256,13,550,1981,3262,1792,153,8,744,445,3142,56,25
301,217,12,563,1651,2744,1533,147,24,671,336,2711,56,26
57,115,6,309,190,677,72,130,27,234,227,690,56,27
38,77,8,199,143,465,45,96,10,192,146,489,56,28
444,224,8,553,1826,3055,1744,137,11,679,446,3017,56,29
544,267,17,589,1947,3364,1858,137,18,782,550,3345,56,30
513,257,7,543,2021,3341,1811,168,9,818,468,3274,56,31
493,271,8,513,1946,3231,1661,163,9,882,428,3143,56,32
296,227,10,609,1657,2799,1517,149,23,701,320,2710,56,33
30,92,9,243,148,522,53,64,17,164,144,442,56,34
35,75,11,153,155,429,47,68,11,164,155,445,56,35
446,248,13,487,1926,3120,1801,114,13,707,426,3061,56,36
505,281,4,533,2056,3379,1967,174,3,714,460,3318,56,37
557,273,3,551,2086,3470,1913,153,7,827,494,3394,56,38
497,271,5,549,1925,3247,1882,148,10,706,434,3180,56,39
300,269,5,624,1589,2787,1560,119,31,647,342,2699,56,40
73,124,6,276,234,713,70,121,26,242,201,660,56,41
51,92,3,187,185,518,45,95,11,161,223,535,56,42
390,231,8,480,1848,2957,1712,120,6,722,388,2948,56,43
425,265,10,516,1893,3109,1730,191,10,747,412,3090,56,44
469,263,7,545,2017,3301,1876,143,4,757,427,3207,56,45
475,249,4,574,1971,3273,1809,160,6,791,477,3243,56,46
287,239,11,661,1477,2675,1455,148,21,662,272,2558,56,47
50,102,6,220,190,568,60,98,17,177,168,520,56,48
46,79,7,195,148,475,44,90,4,173,158,469,56,49
101,105,5,280,283,774,160,110,6,264,218,758,56,50
488,283,3,506,1920,3200,1823,177,3,685,499,3187,56,51
488,262,10,507,2054,3321,1867,193,9,736,451,3256,56,52
498,257,17,530,1952,3254,1923,160,8,719,429,3239,56,53
297,236,11,573,1580,2697,1541,153,16,633,305,2648,56,54
203,1166,179,825,1453,3826,599,456,20,2089,1130,4294,56,55
122,858,39,698,1074,2791,380,233,6,1404,812,2835,56,56
417,270,5,490,1935,3117,1839,155,6,683,428,3111,56,57
509,278,31,539,2032,3389,1947,168,17,723,488,3343,56,58
479,237,7,608,1932,3263,1858,141,5,748,414,3166,56,59
520,265,7,576,2065,3433,2016,179,5,733,438,3371,56,60
309,246,4,596,1555,2710,1527,133,19,675,348,2702,56,61
49,110,8,213,226,606,66,111,21,213,160,571,56,62
52,82,2,203,162,501,61,91,6,176,170,504,56,63
428,252,7,494,1969,3150,1828,148,7,684,433,3100,56,64
504,280,7,567,1986,3344,1917,153,8,738,523,3339,56,65
523,273,17,559,1957,3329,1847,162,13,766,453,3241,56,66
475,286,7,562,2004,3334,1904,145,12,750,466,3277,56,67
328,270,48,592,1614,2852,1529,151,45,625,382,2732,56,68
28,12,13,17,22,92,24,6,10,17,22,79,56,69
35,7,10,18,11,81,33,6,4,16,8,67,56,70
404,255,6,470,1811,2946,1689,145,12,713,398,2957,56,71
534,288,21,568,1973,3384,1795,193,7,778,529,3302,56,72
494,310,15,584,2025,3428,1856,208,15,806,518,3403,56,73
525,287,20,613,1925,3370,1831,188,22,783,485,3309,56,74
327,248,39,632,1651,2897,1565,158,43,695,374,2835,56,75
24,27,10,8,17,86,21,18,9,11,8,67,56,76
17,20,4,20,15,76,12,12,4,23,11,62,56,77
395,260,2,512,1873,3042,1768,154,3,734,404,3063,56,78
508,294,11,613,2009,3435,1909,197,5,754,513,3378,56,79
522,269,4,585,2026,3406,1873,243,6,741,528,3391,56,80
466,283,5,603,2012,3369,1830,247,9,763,485,3334,56,81
295,272,10,706,1606,2889,1548,198,17,715,457,2935,56,82
43,111,15,174,194,537,55,136,29,163,145,528,56,83
75,69,1,292,196,633,63,139,8,215,227,652,56,84
366,256,3,528,1787,2940,1593,169,1,710,407,2880,56,85
451,286,1,586,1899,3223,1749,193,2,752,501,3197,56,86
436,267,8,549,1757,3017,1708,146,10,710,438,3012,56,87
350,259,2,556,1751,2918,1643,155,0,717,413,2928,56,88
230,246,4,706,1353,2539,1338,144,27,687,328,2524,56,89
65,141,5,346,224,781,57,196,23,253,229,758,56,90
42,87,9,254,177,569,47,131,9,190,178,555,56,91
353,224,6,528,1697,2808,1560,159,3,736,364,2822,56,92
501,291,10,524,1959,3285,1789,199,9,769,488,3254,56,93
515,249,7,532,1885,3188,1755,190,7,685,451,3088,56,94
492,265,4,602,1997,3360,1853,203,4,755,465,3280,56,95
319,253,6,634,1689,2901,1531,183,22,676,396,2808,56,96
90,90,4,265,205,654,66,136,16,277,186,681,56,97
63,96,3,224,154,540,51,125,3,206,199,584,56,98
388,244,11,541,1752,2936,1677,144,14,710,393,2938,56,99
546,303,2,581,1931,3363,1806,214,3,733,515,3271,56,100
513,287,5,563,1916,3284,1762,233,9,740,511,3255,56,101
523,257,2,625,1883,3290,1756,200,3,744,454,3157,56,102
341,266,12,647,1582,2848,1570,204,22,643,383,2822,56,103
67,132,6,329,236,770,78,173,16,255,196,718,56,104
55,89,8,256,193,601,55,136,6,221,208,626,56,105
412,242,13,555,1917,3139,1775,198,13,713,433,3132,56,106
532,246,16,607,2058,3459,1884,220,7,758,528,3397,56,107
515,282,6,655,1990,3448,1879,225,14,812,493,3423,56,108
529,269,3,679,1866,3346,1788,224,11,735,517,3275,56,109
319,275,2,625,1598,2819,1532,197,30,679,355,2793,56,110
70,137,5,335,211,758,61,186,38,222,217,724,56,111
50,86,10,197,146,489,51,92,15,199,156,513,56,112
373,247,5,516,1822,2963,1681,151,3,695,440,2970,56,113
503,270,3,628,2017,3421,1861,209,1,805,526,3402,56,114
503,259,1,612,2094,3469,1853,231,2,849,507,3442,56,115
532,265,5,794,2001,3597,1989,191,13,904,498,3595,56,116
336,250,13,649,1648,2896,1529,204,24,711,345,2813,56,117
49,117,6,263,213,648,68,123,17,202,187,597,56,118
46,98,6,270,167,587,55,130,15,178,174,552,56,119
412,243,2,546,1844,3047,1771,177,3,717,413,3081,56,120
521,277,4,546,2037,3385,1884,204,6,754,541,3389,56,121
519,293,4,630,1996,3442,1915,188,9,796,516,3424,56,122
505,301,6,635,1993,3440,1890,187,17,872,472,3438,56,123
316,251,9,656,1540,2772,1513,184,23,650,343,2713,56,124
63,115,2,292,176,648,65,135,25,183,208,616,56,125
46,98,4,177,163,488,46,93,13,159,171,482,56,126
426,246,2,498,1888,3060,1730,139,5,710,450,3034,56,127
536,248,5,588,1986,3363,1868,195,6,743,520,3332,56,128
523,259,7,608,2003,3400,1848,229,7,721,519,3324,56,129
521,303,4,563,1942,3333,1837,200,7,788,466,3298,56,130
347,228,7,658,1486,2726,1489,131,20,658,321,2619,56,131
82,97,7,295,178,659,62,121,18,243,218,662,56,132
53,82,6,182,175,498,51,104,1,211,167,534,56,133
397,268,1,529,1936,3131,1797,155,5,711,443,3111,56,134
533,268,12,585,2032,3430,1896,175,9,768,526,3374,56,135
525,258,5,572,2046,3406,1864,201,8,781,494,3348,56,136
539,274,2,644,2028,3487,1936,196,8,798,553,3491,56,137
343,226,7,639,1665,2880,1591,139,21,717,380,2848,56,138
66,118,8,258,187,637,63,136,23,217,214,653,56,139
60,118,2,260,164,604,67,118,7,208,246,646,56,140
451,252,3,542,1906,3154,1774,208,4,689,432,3107,56,141
539,291,4,583,2118,3535,1947,229,7,774,544,3501,56,142
588,294,7,623,1997,3509,1877,189,7,824,566,3463,56,143
498,271,4,667,2054,3494,1947,188,8,769,496,3408,56,144
301,266,5,862,1345,2779,1435,182,22,676,314,2629,56,145
79,113,3,324,198,717,85,134,23,222,203,667,56,146
36,89,1,270,158,554,51,115,1,194,229,590,56,147
39,80,1,251,206,577,89,104,2,223,180,598,56,148
518,275,9,557,1878,3237,1812,167,9,747,523,3258,56,149
521,285,4,596,2001,3407,1889,173,9,753,531,3355,56,150
537,299,5,628,2072,3541,1945,190,8,781,493,3417,56,151
323,263,6,713,1628,2933,1630,219,25,695,377,2946,56,152
92,146,7,309,261,815,88,169,20,265,207,749,56,153
68,109,10,291,229,707,66,143,11,266,231,717,56,154
468,293,13,596,2022,3392,1871,198,10,744,484,3307,56,155
630,268,17,606,2231,3752,2015,231,11,787,637,3681,56,156
592,236,11,694,2158,3691,1999,202,5,863,563,3632,56,157
558,269,9,652,2086,3574,1899,221,8,827,523,3478,56,158
388,283,6,692,1730,3099,1589,234,40,769,415,3047,56,159
77,133,7,436,262,915,88,243,29,237,269,866,56,160
46,120,5,282,212,665,65,125,5,208,237,640,56,161
512,253,3,600,2056,3424,1917,163,9,732,493,3314,56,162
648,280,4,678,2225,3835,2004,258,2,882,640,3786,56,163
625,325,5,722,1542,3219,2032,234,8,852,402,3528,56,164
581,281,4,648,2175,3689,1964,225,8,862,548,3607,56,165
409,262,8,719,1797,3195,1675,212,27,822,382,3118,56,166
67,145,7,324,256,799,82,206,28,229,207,752,56,167
77,105,14,284,171,651,67,105,18,240,173,603,56,168
487,276,13,542,2010,3328,1885,173,14,709,488,3269,56,169
565,286,4,828,1997,3680,1978,251,9,794,564,3596,56,170
177,141,3,448,336,1105,252,140,7,360,269,1028,56,171
533,300,4,633,2089,3559,1948,227,9,776,501,3461,56,172
336,281,7,720,1746,3090,1751,201,13,671,341,2977,56,173
71,136,5,264,200,676,83,147,34,258,168,690,56,174
51,116,7,217,175,566,70,121,7,212,137,547,56,175
465,271,8,571,2097,3412,1968,202,8,736,490,3404,56,176
622,309,23,692,2309,3955,2148,211,18,824,578,3779,56,177
621,294,15,595,2141,3666,1943,227,24,802,527,3523,56,178
546,306,6,606,2105,3569,1962,227,14,778,527,3508,56,179
359,267,8,664,1732,3030,1610,182,26,727,359,2904,56,180
67,186,9,330,198,790,92,164,35,266,212,769,56,181
64,95,14,240,171,584,71,112,17,242,176,618,56,182
435,285,3,602,2004,3329,1910,179,9,765,432,3295,56,183
550,289,4,654,2172,3669,1927,192,6,864,548,3537,56,184
437,286,13,975,1698,3409,1852,195,27,725,439,3238,56,185
101,359,6,335,423,1224,80,500,18,241,228,1067,56,186
178,206,5,623,1002,2014,1005,160,18,539,277,1999,56,187
55,145,7,317,180,704,74,135,26,211,172,618,56,188
57,111,9,230,182,589,65,111,11,209,171,567,56,189
511,273,9,519,2085,3397,1925,198,7,729,491,3350,56,190
591,305,0,636,2211,3743,2062,209,5,804,510,3590,56,191
530,270,5,589,2184,3578,2048,162,8,733,505,3456,56,192
531,285,6,620,2193,3635,1994,198,7,796,499,3494,56,193
341,262,13,634,1732,2982,1638,183,21,680,342,2864,56,194
64,168,6,317,219,774,74,164,25,248,209,720,56,195
54,93,4,308,181,640,61,116,9,220,200,606,56,196
459,305,2,554,2048,3368,1931,156,5,665,436,3193,56,197
542,323,4,581,2140,3590,2002,189,9,752,567,3519,56,198
542,257,7,604,2046,3456,2173,195,8,781,484,3641,56,199
521,314,4,681,2067,3587,2050,224,7,711,512,3504,56,200
347,263,7,660,1725,3002,1630,177,26,716,356,2905,56,201
82,148,3,303,211,747,96,172,21,251,194,734,56,202
70,105,10,242,177,604,70,137,13,230,178,628,56,203
432,230,3,486,2128,3279,1870,144,8,711,458,3191,56,204
538,259,8,599,2249,3653,2069,216,13,752,546,3596,56,205
539,298,8,627,2263,3735,2048,234,10,798,496,3586,56,206
516,284,5,654,2094,3553,1973,210,8,803,480,3474,56,207
352,250,7,696,1731,3036,1656,179,25,712,360,2932,56,208
64,150,19,330,214,777,81,157,37,267,177,719,56,209
45,98,6,262,163,574,63,142,11,203,202,621,56,210
469,280,6,602,2087,3444,1879,157,16,745,468,3265,56,211
593,286,9,632,2151,3671,2055,190,10,779,515,3549,56,212
564,289,9,643,2141,3646,1792,171,12,793,501,3269,56,213
504,271,16,660,2162,3613,2002,201,15,811,467,3496,56,214
310,257,8,772,1775,3122,1691,207,25,813,322,3058,56,215
82,145,7,313,202,749,77,127,19,234,165,622,56,216
63,107,12,261,174,617,70,132,15,231,202,650,56,217
414,244,19,511,1893,3081,1782,160,19,680,433,3074,56,218
514,281,22,643,1994,3454,1868,219,24,746,510,3367,56,219
502,253,6,604,2070,3435,1882,187,9,727,495,3300,56,220
412,218,12,565,1873,3080,1740,137,13,707,431,3028,56,221
258,237,16,549,1434,2494,1369,142,38,647,268,2464,56,222
66,153,12,274,223,728,82,174,31,228,183,698,56,223
45,124,80,239,166,654,60,109,93,234,185,681,56,224
423,224,3,495,1892,3037,1795,143,4,711,418,3071,56,225
550,271,4,631,1986,3442,1926,203,5,730,530,3394,56,226
480,280,1,588,2035,3384,1928,212,3,765,508,3416,56,227
467,292,2,623,2023,3407,1896,199,4,765,447,3311,56,228
325,243,12,620,1494,2694,1491,183,14,699,325,2712,56,229
82,140,11,294,212,739,84,184,28,253,203,752,56,230
56,116,5,227,145,549,67,113,8,213,163,564,56,231
421,272,13,511,1818,3035,1746,142,19,668,406,2981,56,232
487,312,13,516,2005,3333,1870,246,16,717,534,3383,56,233
526,276,8,574,1962,3346,1844,184,16,768,517,3329,56,234
485,251,9,580,1927,3252,1817,163,10,730,502,3222,56,235
295,251,8,650,1562,2766,1484,166,23,663,375,2711,56,236
108,154,4,271,231,768,74,150,21,238,215,698,56,237
44,89,3,256,164,556,58,123,10,213,161,565,56,238
443,232,5,517,1898,3095,1745,169,6,717,459,3096,56,239
597,235,3,557,2039,3431,1913,201,4,712,545,3375,56,240
562,246,22,529,2051,3410,1884,175,23,693,550,3325,56,241
531,244,18,586,1850,3229,1830,174,15,681,483,3183,56,242
340,209,16,815,1247,2627,1359,135,39,689,301,2523,56,243
68,117,4,328,182,699,78,152,26,198,182,636,56,244
45,117,3,253,176,594,55,159,5,216,163,598,56,245
61,92,8,222,193,576,83,121,9,217,165,595,56,246
570,249,11,518,1937,3285,1837,164,13,718,550,3282,56,247
569,267,4,553,2095,3488,1917,180,6,751,535,3389,56,248
557,254,19,553,2051,3434,1959,177,18,714,502,3370,56,249
427,249,6,627,1720,3029,1675,153,20,685,397,2930,56,250
88,129,4,305,250,776,95,160,25,237,205,722,56,251
58,74,7,240,160,539,46,93,12,223,171,545,56,252
485,247,12,531,1982,3257,1934,156,12,697,486,3285,56,253
612,270,19,571,2318,3790,2186,213,35,735,590,3759,56,254
598,271,6,615,2318,3808,2166,212,9,787,558,3732,56,255
539,240,8,705,2337,3829,2295,221,15,767,519,3817,56,256
385,257,18,671,1737,3068,1718,188,38,655,392,2991,56,257
749,882,23,3380,2092,7126,421,2330,365,1913,2402,7431,56,258
542,497,6,2652,1189,4886,278,1229,70,1530,2245,5352,56,259
503,249,13,538,1924,3227,1865,172,13,700,500,3250,56,260
595,256,11,606,2235,3703,2059,233,14,751,545,3602,56,261
540,252,15,653,2100,3560,1995,217,18,777,506,3513,56,262
572,282,6,612,2134,3606,2060,206,9,753,516,3544,56,263
360,285,12,707,1629,2993,1739,159,23,703,388,3012,56,264
83,129,6,310,211,739,81,131,36,227,213,688,56,265
41,93,7,224,156,521,49,104,8,193,205,559,56,266
511,231,16,631,2055,3444,1896,167,17,785,539,3404,56,267
597,283,23,592,2255,3750,2023,199,32,834,581,3669,56,268
604,239,6,669,2138,3656,1956,230,6,913,506,3611,56,269
504,263,15,622,2054,3458,1929,189,12,786,534,3450,56,270
359,226,6,668,1654,2913,1654,191,25,670,363,2903,56,271
58,160,12,294,257,781,63,158,28,256,224,729,56,272
55,104,5,208,122,494,52,106,7,199,162,526,56,273
479,259,3,491,1930,3162,1759,151,9,746,496,3161,56,274
582,279,7,554,2177,3599,1936,177,10,765,584,3472,56,275
567,286,21,617,2093,3584,1935,183,22,831,617,3588,56,276
468,280,17,592,1957,3314,1860,198,29,808,507,3402,56,277
357,246,12,660,1610,2885,1593,150,43,707,380,2873,56,278
66,101,12,338,191,708,70,124,27,230,182,633,56,279
51,82,6,236,171,546,65,102,6,201,154,528,56,280
460,214,5,542,1943,3164,1838,152,5,690,461,3146,56,281
566,266,13,580,2182,3607,1966,222,17,749,539,3493,56,282
686,280,2,632,2129,3729,1980,193,5,936,538,3652,56,283
497,251,20,639,2048,3455,1949,197,21,737,510,3414,56,284
288,250,11,754,1499,2802,1537,155,23,735,327,2777,56,285
114,137,8,321,238,818,85,156,30,237,225,733,56,286
75,94,4,258,197,628,39,133,11,194,239,616,56,287
264,123,9,352,328,1076,207,121,10,283,306,927,56,288
563,240,8,574,2143,3528,1948,210,6,771,604,3539,56,289
591,283,10,598,2143,3625,1973,221,8,788,537,3527,56,290
494,262,41,577,2093,3467,1866,219,41,834,512,3472,56,291
355,221,21,654,1667,2918,1583,142,29,739,382,2875,56,292
74,131,13,330,223,771,68,153,30,254,188,693,56,293
63,93,8,221,223,608,69,152,13,227,189,650,56,294
462,263,17,542,2052,3336,1838,157,25,759,508,3287,56,295
614,284,16,594,2319,3827,2099,215,16,827,602,3759,56,296
586,301,20,624,2173,3704,2028,221,19,841,571,3680,56,297
531,254,19,639,2117,3560,1980,238,19,808,541,3586,56,298
357,258,6,693,1715,3029,1626,154,34,746,431,2991,56,299
71,124,6,289,202,692,84,165,34,265,204,752,56,300
91,87,6,220,152,556,64,92,11,222,190,579,56,301
480,246,7,511,2008,3252,1813,161,7,770,467,3218,56,302
571,294,11,641,2309,3826,2095,291,12,801,552,3751,56,303
579,264,8,691,2223,3765,2052,214,9,861,555,3691,56,304
469,240,9,601,2142,3461,1892,146,7,827,519,3391,56,305
324,282,9,632,1712,2959,1561,144,30,756,389,2880,56,306
74,134,10,311,255,784,83,155,26,231,220,715,56,307
66,78,7,265,180,596,71,103,10,229,180,593,56,308
460,222,4,545,2031,3262,1930,152,6,666,482,3236,56,309
483,252,19,672,1901,3327,1907,125,19,766,429,3246,56,310
488,247,18,601,2098,3452,1920,173,14,828,471,3406,56,311
607,284,7,607,2177,3682,2045,183,25,857,499,3609,56,312
345,212,31,791,1517,2896,1534,157,31,665,382,2769,56,313
832,772,24,2815,1419,5862,398,1593,179,1715,2366,6251,56,314
509,462,25,2290,1033,4319,241,1130,110,1246,2031,4758,56,315
2566,526,13,2189,1439,6733,919,1253,85,1506,3376,7139,56,316
601,279,9,581,2290,3760,2076,178,8,781,576,3619,56,317
601,279,11,572,2325,3788,2085,217,12,778,546,3638,56,318
552,253,14,558,2131,3508,1943,175,22,756,480,3376,56,319
389,251,9,612,1729,2990,1598,163,17,775,371,2924,56,320
79,87,13,307,256,742,79,140,19,258,217,713,56,321
53,85,5,215,222,580,55,95,7,220,209,586,56,322
452,261,15,498,2120,3346,1895,158,11,740,491,3295,56,323
619,306,20,587,2405,3937,2097,195,17,938,571,3818,56,324
569,278,13,632,2252,3744,2069,196,9,891,568,3733,56,325
513,305,13,618,2176,3625,2056,175,15,779,495,3520,56,326
347,224,8,591,1742,2912,1679,128,15,648,336,2806,56,327
74,122,6,284,219,705,74,141,13,259,178,665,56,328
29,96,10,228,185,548,56,104,9,225,179,573,56,329
430,265,1,565,1874,3135,1759,121,13,705,477,3075,56,330
421,261,6,632,1850,3170,1662,165,7,761,463,3058,56,331
248,168,11,981,979,2387,1285,105,19,604,294,2307,56,332
57,90,6,128,111,392,53,49,5,157,101,365,56,333
103,139,5,530,467,1244,470,97,13,380,221,1181,56,334
40,108,8,224,197,577,61,105,20,176,160,522,56,335
35,72,4,191,168,470,66,87,7,156,145,461,56,336
406,227,5,557,1979,3174,1789,135,8,710,428,3070,56,337
520,287,36,554,2181,3578,1993,177,37,806,493,3506,56,338
552,266,11,607,2166,3602,1982,196,12,833,496,3519,56,339
526,275,4,598,2152,3555,1930,201,6,802,503,3442,56,340
310,241,6,590,1748,2895,1681,153,17,714,323,2888,56,341
49,99,8,267,275,698,73,151,15,243,182,664,56,342
47,92,5,199,215,558,52,104,11,222,165,554,56,343
423,264,3,510,2045,3245,1870,147,5,774,460,3256,56,344
554,259,6,607,2183,3609,2061,184,6,857,544,3652,56,345
525,283,31,580,2067,3486,1862,190,27,827,491,3397,56,346
523,252,5,627,2148,3555,1980,196,11,824,506,3517,56,347
339,295,18,685,1741,3078,1699,174,38,820,409,3140,56,348
74,144,9,331,260,818,84,151,31,268,226,760,56,349
49,95,4,213,195,556,71,93,6,242,195,607,56,350
402,244,4,538,2011,3199,1762,129,4,868,401,3164,56,351
491,280,19,625,2210,3625,2004,209,19,782,506,3520,56,352
477,241,7,668,2132,3525,1987,179,5,810,480,3461,56,353
433,225,8,614,1942,3222,1754,165,8,751,483,3161,56,354
270,210,14,662,1440,2596,1321,148,39,685,332,2525,56,355
59,101,15,289,197,661,66,117,22,188,164,557,56,356
47,73,6,189,154,469,48,104,9,149,155,465,56,357
233,145,16,531,956,1881,944,91,19,489,260,1803,56,358
125,77,11,312,200,725,235,48,10,234,133,660,56,359
29,57,3,88,96,273,39,32,2,85,82,240,56,360
151,132,8,405,636,1332,612,94,15,314,266,1301,56,361
126,135,8,505,593,1367,614,85,16,368,231,1314,56,362
40,93,9,181,145,468,54,73,13,150,119,409,56,363
43,86,6,174,130,439,45,73,11,163,134,426,56,364
185,165,2,519,960,1831,972,92,6,443,296,1809,56,365
157,151,17,690,564,1579,767,87,39,430,203,1526,56,366
190,541,12,1710,1297,3750,249,268,17,1816,782,3132,57,1
641,1228,60,1904,6393,10226,4772,358,64,3234,1552,9980,57,2
804,2185,50,1972,7515,12526,5824,645,62,3564,2208,12303,57,3
797,1700,41,2051,7228,11817,5724,557,44,3416,1914,11655,57,4
603,2317,93,2031,4451,9495,3037,681,37,2772,2605,9132,57,5
240,1282,67,1305,1370,4264,388,561,47,1914,1387,4297,57,6
186,779,19,1385,2557,4926,295,402,23,2623,1179,4522,57,7
706,1845,27,1654,5938,10170,4697,448,26,2675,1951,9797,57,8
842,1349,37,2451,6839,11518,6648,411,49,3028,1403,11539,57,9
896,2051,45,2350,8778,14120,7238,566,43,3866,2112,13825,57,10
924,2826,50,2323,8063,14186,6493,605,57,3880,2660,13695,57,11
657,1517,81,1864,4095,8214,3172,619,26,2736,1764,8317,57,12
204,1555,74,2325,7701,11859,419,490,41,9356,2590,12896,57,13
143,865,24,1370,1784,4186,257,364,34,2062,1006,3723,57,14
295,771,19,1315,1861,4261,532,316,19,2045,907,3819,57,15
460,1363,26,1115,2293,5257,1717,465,22,1673,1439,5316,57,16
738,2069,31,1829,7163,11830,5584,529,28,3565,1978,11684,57,17
891,3417,14,2162,8267,14751,6780,982,20,3871,3013,14666,57,18
586,1899,127,1705,2853,7170,1825,884,59,3068,2320,8156,57,19
213,2064,103,2110,2871,7361,657,901,62,3356,2188,7164,57,20
200,1134,17,1444,1866,4661,271,334,21,2304,1386,4316,57,21
686,1385,21,1611,6264,9967,5085,385,24,2738,1653,9885,57,22
1002,2591,110,2071,9317,15091,7714,633,120,3908,2411,14786,57,23
974,2871,89,2382,9203,15519,7861,658,84,4120,2624,15347,57,24
892,2780,53,2128,8279,14132,7021,646,48,3702,2537,13954,57,25
634,2175,167,2271,4956,10203,3604,980,49,3187,2302,10122,57,26
222,1864,134,2035,3703,7958,469,791,41,4157,2298,7756,57,27
136,717,16,1431,2093,4393,261,331,19,2481,1027,4119,57,28
674,1421,17,1827,6371,10310,5128,470,20,2983,1673,10274,57,29
959,2222,30,2108,9507,14826,7942,601,32,3899,2130,14604,57,30
953,2608,46,2177,9050,14834,7666,542,51,3954,2419,14632,57,31
942,2268,31,2235,8393,13869,6991,630,29,4067,2249,13966,57,32
669,2554,153,2144,4736,10256,3682,959,37,3006,2682,10366,57,33
206,1872,133,1806,2990,7007,507,629,38,3136,2190,6500,57,34
151,719,17,1585,2472,4944,302,314,21,2690,1226,4553,57,35
716,1400,17,1754,6006,9893,5075,385,17,2687,1586,9750,57,36
1031,2793,12,2166,9349,15351,7966,499,14,3882,2779,15140,57,37
947,2594,33,2279,9147,15000,7656,560,36,4055,2586,14893,57,38
924,2455,22,2326,8382,14109,7234,633,20,3828,2265,13980,57,39
656,1976,135,2108,4839,9714,3697,941,52,2999,2228,9917,57,40
212,2092,114,2169,3006,7593,546,843,52,3782,2283,7506,57,41
200,634,28,1389,3035,5286,288,361,36,2959,985,4629,57,42
707,1432,30,1796,6079,10044,4881,384,24,2843,1724,9856,57,43
832,2978,20,2049,8491,14370,6884,565,30,3757,3317,14553,57,44
1134,2366,40,2393,9249,15182,7156,787,26,4330,2429,14728,57,45
879,2463,15,2222,8165,13744,6781,670,31,3757,2303,13542,57,46
609,2023,134,2423,4525,9714,3413,834,41,3437,2213,9938,57,47
227,1678,105,1841,2945,6796,514,879,54,3412,2074,6933,57,48
173,1053,26,1700,2804,5756,332,425,22,3118,1440,5337,57,49
275,965,21,1877,2908,6046,1093,383,29,2858,1370,5733,57,50
873,2650,22,2195,8815,14555,7572,587,20,3723,2571,14473,57,51
930,2472,35,2384,9057,14878,7681,503,36,4135,2394,14749,57,52
922,2884,59,2255,8406,14526,7184,612,51,3961,2494,14302,57,53
640,1990,137,2137,4832,9736,3697,827,34,3120,2086,9764,57,54
190,1669,121,1821,2992,6793,502,691,43,3152,2034,6422,57,55
141,1185,15,1415,2229,4985,370,334,11,2435,1463,4613,57,56
748,2218,19,1830,6225,11040,5297,433,21,2988,2341,11080,57,57
987,2773,20,2228,9149,15157,8057,609,24,3732,2569,14991,57,58
986,2236,30,2322,8883,14457,7609,464,37,3949,2274,14333,57,59
984,2322,28,2358,8290,13982,7149,622,29,4059,2293,14152,57,60
692,2512,126,2290,4934,10554,3911,808,26,3059,3014,10818,57,61
192,1741,128,1822,2825,6708,494,798,53,3212,2101,6658,57,62
175,1063,14,1618,3461,6331,346,362,22,3693,1273,5696,57,63
742,1633,31,1847,6386,10639,5160,450,23,2990,1894,10517,57,64
956,2987,33,2414,9291,15681,7806,707,36,4140,2681,15370,57,65
920,3336,16,2450,9165,15887,7712,672,12,4262,2987,15645,57,66
894,3180,30,2697,8526,15327,6972,921,26,4272,2948,15139,57,67
759,2802,142,2491,5222,11416,3724,1023,38,3579,2986,11350,57,68
201,2413,140,2563,2965,8282,905,797,62,4126,2133,8023,57,69
169,1300,26,1736,2868,6099,391,481,22,3250,1569,5713,57,70
742,1988,30,1910,6563,11233,5031,570,28,3323,1986,10938,57,71
958,3528,24,2719,9787,17016,7834,792,22,4998,3146,16792,57,72
1088,4416,40,2877,10041,18462,7830,963,29,5815,3709,18346,57,73
945,3964,244,3023,9365,17541,7239,1030,55,5655,4030,18009,57,74
711,2978,659,3065,5753,13166,3683,1269,54,4379,4002,13387,57,75
413,3607,184,3294,4030,11528,1540,1546,51,4994,3093,11224,57,76
249,2310,8,1821,3122,7510,429,543,11,3617,2507,7107,57,77
793,2113,15,2351,6731,12003,5276,599,12,3749,2171,11807,57,78
1057,3190,22,2658,9931,16858,8049,719,33,4921,2890,16612,57,79
1036,4179,33,3210,10017,18475,7991,1018,26,5315,3840,18190,57,80
1043,3916,38,3347,9365,17709,7317,1004,41,5198,3768,17328,57,81
777,3849,172,3132,6138,14068,3834,1249,56,4528,3919,13586,57,82
241,2782,148,2149,4071,9391,598,1198,32,3845,3337,9010,57,83
322,1737,30,3422,5796,11307,554,683,22,6071,2411,9741,57,84
983,3317,28,3036,7670,15034,4938,997,24,5042,3695,14696,57,85
1133,4247,19,3405,10528,19332,7458,974,19,5785,4419,18655,57,86
1098,2953,15,3241,9255,16562,6969,778,17,5282,3035,16081,57,87
1099,2841,16,3512,8897,16365,6055,961,17,5668,3023,15724,57,88
1000,3226,125,4205,6278,14834,3260,1436,36,5934,3896,14562,57,89
510,3634,107,4552,6475,15278,852,1231,28,7472,4049,13632,57,90
407,1833,16,2679,3091,8026,588,654,20,3914,2431,7607,57,91
817,2210,30,2992,7474,13523,4650,771,30,4667,2711,12829,57,92
1112,2949,14,3087,10176,17338,7933,689,13,5323,2990,16948,57,93
1057,3310,28,2927,9663,16985,7629,744,23,4815,3655,16866,57,94
1031,4205,18,3281,9671,18206,7347,1035,36,5467,3949,17834,57,95
754,3037,116,3385,6269,13561,3948,1283,60,4953,3446,13690,57,96
366,2310,114,5924,3914,12628,3496,980,44,5328,2652,12500,57,97
483,2204,27,3755,2874,9343,1198,503,20,3674,2540,7935,57,98
868,2012,30,2274,6554,11738,5237,617,54,3469,2104,11481,57,99
1071,3258,23,2731,9432,16515,7898,1068,27,4590,3043,16626,57,100
1123,3312,17,3038,9425,16915,7976,858,13,5022,2982,16851,57,101
975,3342,27,2632,8755,15731,7218,892,17,4487,2842,15456,57,102
762,3246,172,2717,5372,12269,4002,1167,41,3742,3165,12117,57,103
335,3495,147,3030,4386,11393,801,1105,68,5285,3296,10555,57,104
271,2337,17,2327,3899,8851,492,748,14,4097,2348,7699,57,105
771,3060,14,2241,6519,12605,5125,596,11,3653,2843,12228,57,106
1000,3078,19,2776,9581,16454,7909,762,16,4599,2832,16118,57,107
911,3529,24,2838,9915,17217,7915,816,23,4798,3147,16699,57,108
1021,3169,34,2935,9167,16326,7287,886,17,5127,2964,16281,57,109
697,2693,115,2908,5594,12007,3820,1078,30,3883,3069,11880,57,110
279,3260,184,2287,4380,10390,587,1161,47,4633,3350,9778,57,111
208,1206,22,1754,2620,5810,390,439,29,2853,1545,5256,57,112
760,1863,22,2101,6414,11160,4959,575,20,3379,2083,11016,57,113
1017,2515,27,2435,9373,15367,7773,725,23,4317,2534,15372,57,114
1029,3060,28,2778,9359,16254,7751,772,27,4686,2742,15978,57,115
1000,3553,17,2949,9053,16572,7620,1026,13,4709,2987,16355,57,116
766,3814,156,2685,5391,12812,3854,1148,44,3694,3763,12503,57,117
282,2093,205,2325,3066,7971,797,990,140,3543,2449,7919,57,118
210,2297,29,1825,2392,6753,381,1279,80,2807,2110,6657,57,119
763,1897,23,2147,6186,11016,5026,554,20,3256,1986,10842,57,120
1012,2780,32,2599,9569,15992,7953,728,24,4293,2702,15700,57,121
997,3019,37,2619,9455,16127,7665,679,25,4603,2882,15854,57,122
1015,3010,18,2728,8681,15452,7210,859,18,4462,2537,15086,57,123
837,2089,123,2692,5243,10984,3879,1018,38,3614,2367,10916,57,124
307,1876,111,2064,2626,6984,530,905,55,2941,1969,6400,57,125
218,969,19,2025,2114,5345,763,365,24,2573,1317,5042,57,126
741,1855,41,1959,6411,11007,5035,452,35,3254,1867,10643,57,127
965,2710,35,2667,9693,16070,7958,621,37,4634,2491,15741,57,128
938,3164,30,2675,9648,16455,7848,777,19,4606,2650,15900,57,129
871,2954,40,2572,8524,14961,6988,686,30,4343,2708,14755,57,130
718,2188,117,2597,5248,10868,3656,1000,50,3482,2428,10616,57,131
318,1761,134,2348,3377,7938,731,749,45,3940,2333,7798,57,132
240,1137,23,1813,2355,5568,490,420,19,3017,1447,5393,57,133
789,2174,12,2414,6537,11926,5128,549,11,3710,2168,11566,57,134
1005,2760,40,2557,9891,16253,7947,720,49,4676,2601,15993,57,135
1066,3344,26,2798,9489,16723,7806,719,26,4839,2781,16171,57,136
1017,3349,41,2865,9111,16383,7256,934,19,5042,3032,16283,57,137
715,2528,151,2806,5452,11652,3830,1011,57,3836,2736,11470,57,138
220,2437,116,1903,3257,7933,675,916,58,3550,2052,7251,57,139
193,1409,17,1980,2666,6265,451,544,19,3107,1581,5702,57,140
729,2233,28,2149,6947,12086,5518,637,30,3990,2117,12292,57,141
1046,2895,23,2772,9851,16587,8255,769,22,4665,2614,16325,57,142
1051,2991,31,2677,9422,16172,7880,747,30,4645,2753,16055,57,143
1008,2617,30,2904,8476,15035,7135,772,28,4266,2516,14717,57,144
751,2001,121,3071,4413,10357,3339,1010,34,3502,2376,10261,57,145
337,1914,105,2548,3084,7988,573,1053,58,3897,2287,7868,57,146
372,1444,35,2501,2942,7294,474,834,20,3697,1827,6852,57,147
363,1081,17,2036,2607,6104,474,462,18,3000,1351,5305,57,148
1010,2633,29,2648,8925,15245,7489,973,32,4200,2624,15318,57,149
1140,2650,15,2894,9413,16112,8059,662,22,4539,2602,15884,57,150
1113,3208,46,2814,9025,16206,7426,829,42,4629,2909,15835,57,151
769,2467,130,2749,5425,11540,4143,1148,53,3780,2666,11790,57,152
393,1988,122,2145,2853,7501,613,1005,42,3220,2025,6905,57,153
274,1361,21,1827,2163,5646,416,514,21,2755,1636,5342,57,154
1134,1929,12,2322,6852,12249,5565,616,17,3375,2215,11788,57,155
1398,2806,27,3044,9832,17107,8424,779,22,4635,3042,16902,57,156
1319,3175,20,3014,9698,17226,8246,867,27,4753,2971,16864,57,157
1308,3244,27,2973,9131,16683,7582,899,14,4539,3014,16048,57,158
1090,3507,180,3311,5738,13826,4064,1525,58,4315,3541,13503,57,159
353,4531,179,3145,6486,14694,780,1682,52,5184,6113,13811,57,160
300,1710,24,2194,2864,7092,470,580,20,3330,1980,6380,57,161
1206,2108,36,2441,7085,12876,5538,642,33,3708,2560,12481,57,162
1464,3014,17,3104,10115,17714,8409,818,22,4859,3089,17197,57,163
1500,3322,32,3024,9591,17469,8090,887,38,5147,3204,17366,57,164
1362,3309,15,3105,8928,16719,7219,945,14,4785,3319,16282,57,165
1122,2284,117,3230,5447,12200,3859,1170,76,3989,2779,11873,57,166
326,2381,123,2398,3286,8514,683,1163,57,3857,2320,8080,57,167
259,1494,7,1931,2273,5964,452,590,7,2845,1634,5528,57,168
1063,2339,22,2372,6895,12691,5425,830,19,3627,2565,12466,57,169
1321,2642,37,3235,9398,16633,7990,900,40,4569,2837,16336,57,170
473,1585,17,2339,3888,8302,1769,670,14,3526,1791,7770,57,171
1216,2982,13,3066,8404,15681,6930,1053,27,4669,3094,15773,57,172
968,2443,124,3006,5229,11770,3780,1073,48,3676,2851,11428,57,173
459,2695,264,2132,2624,8174,594,1663,70,3385,2513,8225,57,174
249,1299,25,1922,2051,5546,461,569,17,2692,1323,5062,57,175
1047,1858,22,2151,6647,11725,5135,629,25,3441,2322,11552,57,176
1475,2890,46,2894,9636,16941,8117,819,57,4620,3021,16634,57,177
1339,3244,43,3072,9566,17264,8074,800,47,4904,3227,17052,57,178
1257,3168,24,3145,9171,16765,7423,1006,19,4965,3056,16469,57,179
965,2607,163,3053,5474,12262,3714,1117,58,4078,2825,11792,57,180
257,2230,128,2409,3085,8109,694,1210,34,3544,2282,7764,57,181
268,1376,13,2024,2510,6191,408,568,14,2901,2037,5928,57,182
1040,1813,35,2432,6835,12155,5183,685,46,3518,2415,11847,57,183
1213,2409,84,2836,8754,15296,6979,843,81,4608,2692,15203,57,184
1130,2348,45,3979,6700,14202,5476,1168,35,4374,2647,13700,57,185
400,13309,67,3004,4194,20974,696,9168,60,4716,5514,20154,57,186
829,1964,107,3199,4145,10244,1915,1035,25,4322,2341,9638,57,187
325,1612,124,2537,2676,7274,616,820,36,3299,1825,6596,57,188
261,1036,20,1738,2114,5169,425,509,21,2525,1361,4841,57,189
1058,1984,24,2494,6536,12096,5100,729,20,3590,2220,11659,57,190
1330,3545,55,3495,9578,18003,7709,1163,52,4970,3175,17069,57,191
1305,2805,45,3153,9299,16607,7130,859,46,4761,3029,15825,57,192
1245,3195,24,3358,8310,16132,6734,1050,26,4609,3034,15453,57,193
914,2192,142,2918,5120,11286,3802,1142,44,3512,2553,11053,57,194
352,2067,126,2516,3259,8320,707,1004,35,3801,2347,7894,57,195
291,1112,24,1877,2084,5388,399,570,26,2764,1334,5093,57,196
1064,1830,21,2301,6516,11732,5408,653,22,3376,2123,11582,57,197
1342,2453,28,2780,9389,15992,7829,810,33,4378,2576,15626,57,198
1324,2478,30,2979,9489,16300,7816,642,35,4489,2815,15797,57,199
1299,2894,21,2956,8736,15906,7117,959,23,4669,2965,15733,57,200
915,2153,131,2706,5196,11101,3549,1221,69,3603,2501,10943,57,201
327,2635,165,2220,2953,8300,639,1273,68,3619,2455,8054,57,202
308,1357,27,2004,2468,6164,398,633,26,2920,1722,5699,57,203
1053,3168,39,2421,6647,13328,5294,793,37,3677,3280,13081,57,204
1365,3097,26,2833,9915,17236,7861,1013,33,4979,3151,17037,57,205
1271,2717,42,3168,9852,17050,7505,921,55,5022,3181,16684,57,206
1294,3026,38,3225,8753,16336,6909,1049,41,4952,3331,16282,57,207
936,2424,147,2935,5424,11866,3754,1170,87,3776,2619,11406,57,208
334,2841,205,2287,3577,9244,611,1129,90,3823,2981,8634,57,209
296,1161,28,2057,2400,5942,455,584,19,2811,1366,5235,57,210
1020,1808,29,2351,6609,11817,5047,660,28,3487,2337,11559,57,211
1339,2616,34,2760,9666,16415,7686,827,25,4559,2785,15882,57,212
1340,2460,26,2764,9023,15613,6881,842,25,4658,2649,15055,57,213
1265,2770,24,2893,8304,15256,6630,932,28,4459,2799,14848,57,214
901,3253,146,2623,5084,12007,3659,1208,63,3883,2971,11784,57,215
289,1700,184,1992,2968,7133,558,642,49,3795,1885,6929,57,216
193,1154,21,1857,2578,5803,482,491,28,2872,1447,5320,57,217
968,1738,33,2147,6091,10977,4730,745,26,3267,2104,10872,57,218
1316,2745,30,2579,8766,15436,7062,839,34,4218,2903,15056,57,219
1277,2299,27,2793,8612,15008,6853,787,26,4280,2570,14516,57,220
1177,2251,23,2433,7463,13347,5836,717,22,3840,2352,12767,57,221
754,1785,112,2205,3988,8844,2780,910,45,2805,1951,8491,57,222
274,1744,94,2180,2669,6961,581,949,51,3324,1850,6755,57,223
235,1325,27,1805,2129,5521,393,455,29,2564,1607,5048,57,224
1014,1854,35,2061,5796,10760,4488,652,30,3281,2169,10620,57,225
1195,2533,33,2479,8602,14842,6803,799,24,4106,2602,14334,57,226
1219,2658,42,2631,8284,14834,6629,813,35,4230,2911,14618,57,227
1190,2536,37,2551,7381,13695,5686,812,37,4091,2569,13195,57,228
878,2308,141,2483,4516,10326,3162,1074,56,3279,2478,10049,57,229
321,2309,196,1987,2905,7718,487,1158,65,3317,2117,7144,57,230
215,1123,17,1888,2167,5410,328,489,20,2668,1329,4834,57,231
849,1471,20,1982,5748,10070,4318,586,18,3064,1911,9897,57,232
1195,2414,27,2338,8002,13976,6484,794,36,3742,2571,13627,57,233
1196,2374,38,2525,8016,14149,6414,889,44,3936,2529,13812,57,234
1185,2358,30,2417,7109,13099,5580,866,38,3876,2557,12917,57,235
898,2448,194,2512,4406,10458,3044,1275,77,3282,2622,10300,57,236
270,2539,129,2283,3703,8924,774,902,61,4316,2471,8524,57,237
240,1090,23,1737,2241,5331,343,521,54,2655,1306,4879,57,238
958,1437,47,2033,5928,10403,4670,574,47,2881,1899,10071,57,239
1239,2334,28,2503,8438,14542,7105,814,34,3907,2461,14321,57,240
1201,2296,32,2489,8392,14410,6904,832,27,3729,2401,13893,57,241
1164,2413,24,2546,7395,13542,5780,1030,25,3650,2393,12878,57,242
878,1725,188,2641,4025,9457,2974,978,82,3077,2223,9334,57,243
245,1850,147,1965,3081,7288,539,852,55,3670,2150,7266,57,244
230,1477,14,2003,2762,6486,413,663,10,3258,1698,6042,57,245
240,995,20,1630,2027,4912,446,481,25,2403,1221,4576,57,246
982,2014,14,2153,8872,14035,7301,700,21,3763,2032,13817,57,247
1032,2441,11,2427,9323,15234,7871,587,11,4075,2378,14922,57,248
954,2483,25,2436,8690,14588,7196,723,22,4162,2427,14530,57,249
756,2373,147,2305,4829,10410,3820,987,45,3129,2529,10510,57,250
286,1672,119,2434,3202,7713,668,983,61,3959,1856,7527,57,251
217,1089,17,1965,2161,5449,680,458,20,2611,1302,5071,57,252
812,1923,21,1958,6809,11523,5656,584,22,3132,2028,11422,57,253
1049,2919,30,2473,10002,16473,8625,811,30,4246,2609,16321,57,254
1130,3165,34,2472,9803,16604,8267,740,42,4498,2756,16303,57,255
997,3079,37,2500,8911,15524,7427,807,44,4376,2774,15428,57,256
796,2697,427,2565,5355,11840,3946,1364,72,3663,2929,11974,57,257
230,2207,161,2309,3057,7964,735,980,75,3664,2286,7740,57,258
231,1129,25,1772,2246,5403,449,501,32,2762,1680,5424,57,259
760,1966,23,2069,6754,11572,5548,505,20,3413,2052,11538,57,260
1353,3087,19,2706,10017,17182,8698,761,19,4418,2784,16680,57,261
1096,2970,21,2801,9850,16738,7705,752,19,4790,2700,15966,57,262
1054,4045,25,2734,9107,16965,7802,903,34,4514,3242,16495,57,263
882,2724,192,2623,5654,12075,4332,1373,80,3584,2593,11962,57,264
264,2438,144,2233,3093,8172,659,1063,70,3483,2700,7975,57,265
216,1183,16,1661,2516,5592,382,466,22,2818,1367,5055,57,266
810,1847,16,2236,6785,11694,5736,528,14,3335,2003,11616,57,267
1161,3100,21,2663,10037,16982,8461,842,26,4332,2844,16505,57,268
1090,3261,42,2654,9662,16709,8202,909,39,4458,2900,16508,57,269
1058,3123,24,2705,8716,15626,7021,824,27,4608,2946,15426,57,270
791,3236,235,2704,5250,12216,3682,1407,69,3686,3086,11930,57,271
266,3269,244,2294,3720,9793,649,1566,64,4216,2905,9400,57,272
208,1212,20,1655,2819,5914,437,422,23,2838,1459,5179,57,273
802,2035,29,2489,6745,12100,5618,499,29,3730,2075,11951,57,274
1050,2561,54,2656,9962,16283,8468,652,52,4533,2496,16201,57,275
1099,2699,28,2904,9970,16700,8278,628,34,4668,2634,16242,57,276
1000,2905,43,2808,8645,15401,6787,861,44,4732,2838,15262,57,277
765,2716,195,2718,5532,11926,3873,1252,71,3770,2857,11823,57,278
309,2798,153,2390,3310,8960,620,1018,76,3970,2933,8617,57,279
237,1393,65,1965,2512,6172,418,539,62,2900,1823,5742,57,280
877,2022,13,2316,7119,12347,5850,567,14,3644,2183,12258,57,281
1097,2693,24,2977,10714,17505,9056,726,19,4911,2725,17437,57,282
1126,3128,41,3261,10347,17903,8725,827,33,5205,2980,17770,57,283
1020,3390,28,2874,9001,16313,7273,842,37,4914,3186,16252,57,284
764,2818,157,3083,5404,12226,3668,1264,51,4189,2944,12116,57,285
394,3597,185,2735,4028,10939,931,1218,65,5168,3576,10958,57,286
423,1850,18,2530,3018,7839,713,710,21,4141,2139,7724,57,287
507,1667,32,2371,4580,9157,2597,548,26,3651,1907,8729,57,288
1047,4166,33,2841,10386,18473,8775,961,36,5010,3579,18361,57,289
1086,3398,40,3163,10632,18319,8831,880,32,5178,3296,18217,57,290
1035,4408,36,2902,9447,17828,7536,1056,39,5033,3726,17390,57,291
776,3331,266,3134,5838,13345,4004,1436,120,4079,3336,12975,57,292
350,2633,215,3434,3675,10307,1430,1393,65,4113,2629,9630,57,293
241,1908,40,2274,2931,7394,494,964,33,3323,1856,6670,57,294
888,2179,45,2401,7046,12559,5625,628,39,3626,2407,12325,57,295
1106,2830,24,2773,10446,17179,8621,741,30,4632,2789,16813,57,296
1210,4311,37,3256,10393,19207,8683,1008,26,5266,3505,18488,57,297
1033,4229,41,2890,9663,17856,7858,954,45,4968,3646,17471,57,298
792,2908,136,2875,5919,12630,4034,1309,74,4276,3055,12748,57,299
277,2846,204,2703,3745,9775,769,1081,121,4301,2914,9186,57,300
541,1518,32,2653,2812,7556,692,812,31,3786,1745,7066,57,301
802,2207,27,2368,7208,12612,5648,590,18,3900,2306,12462,57,302
996,8727,32,3327,9626,22708,8248,1382,27,5104,7064,21825,57,303
1058,3402,35,2993,10606,18094,8588,713,35,5223,3204,17763,57,304
1027,2778,46,2983,8334,15168,6745,1076,55,4396,3000,15272,57,305
657,2369,141,2546,4920,10633,3595,1162,69,3631,2430,10887,57,306
241,3665,180,2043,4734,10863,589,895,71,4592,4517,10664,57,307
246,990,26,1829,2404,5495,455,415,27,2679,1370,4946,57,308
794,2376,24,2297,6863,12354,5644,645,28,3447,2415,12179,57,309
905,1681,40,2846,7131,12603,6288,661,29,3823,1977,12778,57,310
997,2790,37,2419,7563,13806,6327,578,34,3673,2718,13330,57,311
1032,2436,20,2499,8651,14638,7185,720,24,4059,2413,14401,57,312
745,3385,175,2540,5217,12062,3774,1303,48,3658,3318,12101,57,313
280,2205,161,2476,3518,8640,642,947,53,4160,2472,8274,57,314
247,1080,21,2042,2560,5950,404,395,25,2705,1752,5281,57,315
479,1376,22,2170,4144,8191,2612,453,20,3185,1553,7823,57,316
1094,2738,27,2646,10305,16810,8803,697,29,4376,2649,16554,57,317
1125,3788,44,2881,10485,18323,8843,788,44,4856,3546,18077,57,318
1019,3145,34,2893,9448,16539,7794,687,37,4567,3021,16106,57,319
708,2365,160,2636,5803,11672,4264,1036,62,3537,2679,11578,57,320
225,2001,180,2232,3633,8271,553,912,73,3779,2273,7590,57,321
151,1563,40,1704,2498,5956,348,452,47,2683,1750,5280,57,322
863,1923,34,2207,7008,12035,5786,508,27,3264,2162,11747,57,323
1164,3515,11,2982,10360,18032,8736,969,16,4815,3108,17644,57,324
1212,3186,32,2952,10186,17568,8678,783,34,4662,3216,17373,57,325
1093,4279,37,2773,9197,17379,7602,856,36,4567,3875,16936,57,326
871,2683,167,2747,4924,11392,3839,906,44,3398,2893,11080,57,327
281,3226,125,2151,3767,9550,588,938,60,4146,3557,9289,57,328
255,1262,18,2000,2620,6155,355,479,22,2871,1823,5550,57,329
788,1814,26,2561,6310,11499,4711,613,26,3687,2015,11052,57,330
928,2508,24,2600,7130,13190,5176,680,28,4011,2935,12830,57,331
630,2026,13,3415,3942,10026,2817,679,14,3626,2539,9675,57,332
557,537,12,1239,948,3293,823,289,19,1131,698,2960,57,333
409,1808,92,2533,4225,9067,1087,628,34,4687,2177,8613,57,334
204,2230,92,1955,3588,8069,454,721,28,3758,2805,7766,57,335
184,1551,21,1572,2623,5951,341,501,24,2951,1837,5654,57,336
825,1805,41,2008,6389,11068,5175,592,44,3325,2166,11302,57,337
1038,4156,32,2567,9956,17749,8389,741,40,4596,3978,17744,57,338
1157,3574,33,2928,10124,17816,8401,772,33,4966,3456,17628,57,339
1030,4583,51,2970,9623,18257,7585,1011,50,5126,4421,18193,57,340
762,2982,175,2872,5862,12653,4083,1150,70,3854,3565,12722,57,341
226,3800,196,2601,4963,11786,548,1556,62,5194,4237,11597,57,342
211,2319,31,2346,3894,8801,431,724,30,4312,3089,8586,57,343
884,2855,29,2175,7440,13383,5713,672,30,3719,2563,12697,57,344
1064,4205,39,3054,11043,19405,8913,823,27,5317,3330,18410,57,345
1039,3749,41,3242,10132,18203,8701,752,44,5109,3222,17828,57,346
1022,5044,47,3286,10142,19541,8104,1096,34,5844,4421,19499,57,347
810,3639,216,3359,6554,14578,4089,1428,62,4395,4069,14043,57,348
683,4919,227,3811,5117,14757,653,2671,66,5766,4369,13525,57,349
342,1990,29,2513,3078,7952,443,486,30,3722,2171,6852,57,350
851,2149,42,2372,6957,12371,5386,599,40,3639,2475,12139,57,351
1080,3955,43,2804,10175,18057,7867,901,55,4889,4500,18212,57,352
997,3283,53,2861,9348,16542,7314,660,63,4959,3567,16563,57,353
923,3429,110,2902,8111,15475,6170,836,108,4549,3615,15278,57,354
1321,2137,109,2670,4755,10992,4121,1444,108,4194,3449,13316,57,355
275,1558,132,1795,2931,6691,671,1003,104,3629,2332,7739,57,356
233,1345,43,1375,2547,5543,494,830,49,2928,1848,6149,57,357
850,1372,141,2358,4284,9005,2769,855,139,3830,2460,10053,57,358
584,790,51,1886,2211,5522,1425,505,67,2736,1484,6217,57,359
160,434,21,420,866,1901,192,322,42,897,755,2208,57,360
510,1348,109,1762,3255,6984,1666,624,116,3602,2026,8034,57,361
693,1693,114,2271,4303,9074,1809,922,66,4524,2565,9886,57,362
277,1373,105,1667,3153,6575,587,791,71,3980,1909,7338,57,363
260,1046,283,1651,2992,6232,504,694,184,3768,1899,7049,57,364
542,1842,35,2294,4715,9428,2178,570,34,3915,2299,8996,57,365
519,1290,736,2619,4080,9244,1993,1210,364,3691,1598,8856,57,366
123,127,5,299,253,807,82,187,11,214,255,749,58,1
399,158,8,443,400,1408,225,302,17,394,558,1496,58,2
577,219,6,492,556,1850,353,338,21,487,694,1893,58,3
625,167,3,487,494,1776,348,329,8,447,718,1850,58,4
524,146,8,503,464,1645,304,354,24,395,651,1728,58,5
114,168,10,309,199,800,90,238,25,221,218,792,58,6
115,136,10,374,196,831,59,222,17,241,213,752,58,7
647,203,6,509,630,1995,428,324,23,542,738,2055,58,8
717,151,3,537,451,1859,381,226,22,460,624,1713,58,9
787,211,8,612,582,2200,411,304,24,463,783,1985,58,10
663,181,14,499,679,2036,388,353,23,429,736,1929,58,11
526,218,11,601,542,1898,355,331,26,496,688,1896,58,12
158,145,11,484,267,1065,80,278,21,304,389,1072,58,13
84,124,3,325,190,726,68,207,8,219,243,745,58,14
140,134,32,280,181,767,101,235,45,264,298,943,58,15
250,129,5,321,231,936,198,216,13,296,296,1019,58,16
523,110,2,386,392,1413,260,351,18,468,659,1756,58,17
522,118,3,379,367,1389,358,359,9,465,762,1953,58,18
251,126,21,296,180,874,175,250,31,296,309,1061,58,19
94,76,6,242,176,594,87,241,31,259,263,881,58,20
77,97,4,250,154,582,70,199,5,187,247,708,58,21
534,104,9,380,418,1445,343,332,34,433,752,1894,58,22
700,109,5,417,443,1674,396,336,22,474,826,2054,58,23
612,179,5,515,576,1887,424,372,9,434,817,2056,58,24
734,183,7,560,645,2129,408,362,10,447,762,1989,58,25
587,289,9,618,588,2091,293,417,34,503,620,1867,58,26
165,145,12,490,317,1129,81,244,30,319,357,1031,58,27
91,145,7,305,178,726,74,229,15,216,250,784,58,28
583,150,2,436,515,1686,408,369,11,499,777,2064,58,29
772,83,1,564,341,1761,427,206,3,500,617,1753,58,30
740,133,1,541,470,1885,398,348,12,448,784,1990,58,31
709,213,12,573,689,2196,388,361,21,472,853,2095,58,32
650,224,16,514,531,1935,292,359,24,498,695,1868,58,33
176,193,8,463,329,1169,123,274,28,251,335,1011,58,34
134,194,6,368,235,937,75,263,15,213,256,822,58,35
775,219,7,577,658,2236,416,333,17,470,809,2045,58,36
775,243,5,564,720,2307,411,347,16,455,889,2118,58,37
833,251,10,593,634,2321,407,370,21,468,814,2080,58,38
810,210,9,549,650,2228,398,361,20,470,821,2070,58,39
646,263,16,607,610,2142,392,345,42,482,714,1975,58,40
156,214,33,495,298,1196,83,273,49,351,335,1091,58,41
108,138,10,317,226,799,54,222,21,240,266,803,58,42
918,323,13,719,943,2916,483,425,22,562,969,2461,58,43
798,261,22,494,630,2205,491,506,36,546,905,2484,58,44
867,286,9,706,755,2623,485,451,24,606,976,2542,58,45
750,183,12,472,502,1919,390,330,15,425,736,1896,58,46
490,214,20,648,476,1848,265,315,43,500,615,1738,58,47
130,175,13,402,273,993,66,254,34,247,313,914,58,48
118,186,5,336,226,871,62,233,17,210,261,783,58,49
299,172,6,247,344,1068,374,270,22,172,359,1197,58,50
739,215,8,595,652,2209,371,376,20,513,821,2101,58,51
786,180,7,593,615,2181,391,356,17,452,794,2010,58,52
704,231,5,380,538,1858,349,402,19,458,806,2034,58,53
568,177,14,601,521,1881,299,304,33,483,714,1833,58,54
167,113,14,545,302,1141,101,255,48,388,391,1183,58,55
140,95,1,346,147,729,72,230,11,254,289,856,58,56
721,218,12,546,660,2157,399,365,29,427,807,2027,58,57
804,183,20,524,585,2116,408,340,27,448,808,2031,58,58
799,148,19,528,578,2072,388,309,30,446,779,1952,58,59
771,208,10,553,570,2112,391,369,17,485,811,2073,58,60
695,219,11,643,544,2112,326,364,23,507,782,2002,58,61
154,189,25,462,331,1161,108,332,44,294,412,1190,58,62
150,163,13,467,288,1081,77,327,27,334,389,1154,58,63
771,202,15,504,625,2117,395,338,30,417,798,1978,58,64
759,202,3,557,570,2091,346,371,15,436,815,1983,58,65
815,198,5,535,565,2118,384,348,11,479,773,1995,58,66
806,219,3,567,683,2278,385,390,17,488,939,2219,58,67
694,247,22,640,573,2176,356,373,38,465,751,1983,58,68
185,148,15,404,257,1009,75,277,35,259,325,971,58,69
116,157,14,401,232,920,50,254,31,243,292,870,58,70
746,212,33,538,587,2116,367,363,51,420,764,1965,58,71
956,289,10,623,627,2505,495,426,15,523,874,2333,58,72
783,221,14,593,592,2203,400,431,31,503,806,2171,58,73
803,281,10,861,799,2754,422,519,29,594,908,2472,58,74
665,310,14,807,737,2533,364,499,26,557,800,2246,58,75
267,325,30,853,519,1994,143,467,55,615,520,1800,58,76
136,291,67,495,378,1367,69,431,69,359,372,1300,58,77
728,225,54,536,594,2137,368,401,46,484,775,2074,58,78
767,240,40,516,643,2206,438,403,62,508,908,2319,58,79
730,151,28,463,481,1853,341,356,28,414,725,1864,58,80
642,141,34,426,538,1781,367,346,35,388,790,1926,58,81
589,130,9,473,465,1666,332,306,39,401,760,1838,58,82
129,105,9,264,226,733,44,230,35,191,278,778,58,83
109,113,3,323,134,682,65,208,7,195,245,720,58,84
647,151,13,450,470,1731,356,278,29,342,763,1768,58,85
695,142,3,424,504,1768,377,311,19,374,802,1883,58,86
644,106,9,385,391,1535,326,250,16,381,639,1612,58,87
654,139,7,413,517,1730,384,316,22,355,793,1870,58,88
571,151,11,513,437,1683,341,311,33,383,724,1792,58,89
140,115,6,388,214,863,56,259,32,239,312,898,58,90
119,107,3,306,151,686,48,207,7,202,237,701,58,91
562,136,4,406,380,1488,310,283,12,337,669,1611,58,92
667,93,6,421,454,1641,367,295,13,336,724,1735,58,93
620,104,10,360,349,1443,302,265,12,329,622,1530,58,94
693,136,5,438,540,1812,343,342,21,377,834,1917,58,95
505,154,5,533,436,1633,292,344,27,384,554,1601,58,96
150,101,3,417,209,880,84,271,21,255,287,918,58,97
115,106,5,308,168,702,53,242,18,194,218,725,58,98
589,105,9,466,481,1650,326,272,19,384,806,1807,58,99
724,128,3,431,489,1775,374,316,16,361,789,1856,58,100
692,114,3,469,431,1709,378,298,18,377,742,1813,58,101
728,107,14,422,482,1753,376,250,26,412,783,1847,58,102
615,117,10,472,424,1638,298,307,31,418,714,1768,58,103
184,138,5,393,230,950,93,297,38,263,315,1006,58,104
111,115,3,379,204,812,60,256,6,233,286,841,58,105
530,125,13,470,326,1464,227,314,14,382,552,1489,58,106
492,119,6,466,304,1387,170,358,12,302,591,1433,58,107
565,165,15,550,445,1740,262,354,27,413,642,1698,58,108
529,156,22,502,382,1591,203,339,31,374,679,1626,58,109
448,107,19,442,321,1337,205,280,34,340,538,1397,58,110
159,981,58,353,820,2371,449,246,13,1139,765,2612,58,111
105,321,41,296,501,1264,273,153,13,632,222,1293,58,112
634,138,23,386,494,1675,335,270,21,329,759,1714,58,113
692,147,9,438,525,1811,329,322,20,390,815,1876,58,114
724,145,2,413,503,1787,335,326,9,408,814,1892,58,115
718,115,3,461,526,1823,354,298,8,419,804,1883,58,116
606,168,9,387,493,1663,293,341,32,399,675,1740,58,117
17,8,19,48,21,113,14,7,11,45,23,100,58,118
116,446,60,291,523,1436,238,177,13,760,392,1580,58,119
672,137,4,387,535,1735,351,269,4,335,769,1728,58,120
741,159,7,493,545,1945,427,327,16,391,864,2025,58,121
705,146,5,501,515,1872,398,326,16,451,784,1975,58,122
735,159,7,494,530,1925,388,348,14,443,776,1969,58,123
632,142,9,462,539,1784,365,322,28,433,754,1902,58,124
131,95,6,344,202,778,64,230,26,192,266,778,58,125
105,127,5,247,162,646,53,271,13,174,212,723,58,126
646,129,30,416,532,1753,344,289,32,393,738,1796,58,127
770,143,64,474,527,1978,431,374,76,387,790,2058,58,128
772,200,119,562,584,2237,423,412,71,486,858,2250,58,129
798,169,11,529,553,2060,464,342,21,401,881,2109,58,130
648,166,11,430,527,1782,356,292,40,410,762,1860,58,131
154,132,11,435,222,954,77,240,35,325,344,1021,58,132
126,118,4,307,174,729,61,239,13,210,251,774,58,133
714,146,17,456,552,1885,404,331,23,369,775,1902,58,134
709,134,2,487,529,1861,415,343,14,420,852,2044,58,135
722,141,5,459,537,1864,414,330,15,429,856,2044,58,136
737,172,7,490,581,1987,423,369,17,420,938,2167,58,137
636,171,10,542,486,1845,345,341,32,415,751,1884,58,138
146,120,9,364,154,793,61,221,28,232,232,774,58,139
125,106,4,338,146,719,50,234,15,210,248,757,58,140
708,161,8,446,551,1874,384,389,14,385,831,2003,58,141
739,173,6,506,584,2008,399,358,16,442,894,2109,58,142
732,170,4,478,548,1932,385,360,12,472,896,2125,58,143
741,124,4,454,486,1809,384,304,9,399,805,1901,58,144
630,180,8,466,477,1761,328,354,39,433,727,1881,58,145
146,167,8,375,223,919,67,283,41,231,310,932,58,146
125,135,2,312,197,771,61,280,8,204,269,822,58,147
140,128,8,332,208,816,70,197,19,265,256,807,58,148
729,142,11,545,561,1988,430,332,29,476,873,2140,58,149
789,172,9,468,495,1933,433,314,21,456,804,2028,58,150
749,177,11,525,539,2001,409,344,17,438,857,2065,58,151
651,226,16,568,501,1962,377,329,37,439,733,1915,58,152
159,159,10,440,252,1020,100,315,36,290,314,1055,58,153
110,113,9,346,175,753,54,255,13,192,252,766,58,154
689,157,2,478,466,1792,386,305,6,422,751,1870,58,155
709,162,5,491,479,1846,386,337,16,404,720,1863,58,156
797,143,14,491,480,1925,411,349,17,469,729,1975,58,157
827,170,5,570,475,2047,413,374,18,488,740,2033,58,158
673,214,17,504,520,1928,304,395,42,435,758,1934,58,159
198,194,13,468,329,1202,110,424,61,275,355,1225,58,160
109,138,3,314,196,760,61,260,21,209,231,782,58,161
654,127,2,468,432,1683,301,310,9,409,707,1736,58,162
716,155,6,478,467,1822,349,326,19,385,818,1897,58,163
719,131,7,503,500,1860,326,327,6,437,719,1815,58,164
688,162,3,540,476,1869,363,385,11,446,709,1914,58,165
541,137,7,447,435,1567,266,348,34,357,590,1595,58,166
136,140,14,453,279,1022,84,295,60,327,323,1089,58,167
140,96,7,341,178,762,65,236,15,191,263,770,58,168
639,141,11,503,422,1716,328,311,16,397,630,1682,58,169
586,147,7,578,402,1720,298,329,37,406,666,1736,58,170
272,120,6,407,284,1089,118,291,11,289,355,1064,58,171
579,176,5,524,476,1760,285,329,27,439,692,1772,58,172
495,191,11,467,377,1541,239,306,34,380,527,1486,58,173
167,159,12,329,202,869,78,301,33,231,213,856,58,174
104,109,2,276,131,622,60,194,16,179,214,663,58,175
615,151,10,582,368,1726,338,296,22,535,611,1802,58,176
622,152,20,565,449,1808,361,328,22,449,679,1839,58,177
681,223,5,601,495,2005,319,369,16,543,695,1942,58,178
654,185,15,545,460,1859,360,347,20,476,656,1859,58,179
545,199,22,558,441,1765,302,346,30,472,628,1778,58,180
162,135,15,396,242,950,79,307,22,256,256,920,58,181
114,105,3,293,149,664,73,201,7,198,192,671,58,182
627,179,6,536,422,1770,343,303,14,477,681,1818,58,183
655,151,28,549,445,1828,358,310,22,491,646,1827,58,184
571,190,10,585,418,1774,336,299,26,518,581,1760,58,185
127,403,10,294,273,1107,72,500,23,192,292,1079,58,186
402,134,14,408,315,1273,214,264,44,349,426,1297,58,187
155,126,10,300,197,788,100,244,19,213,240,816,58,188
103,104,2,263,142,614,52,217,7,169,231,676,58,189
593,159,3,498,392,1645,337,265,20,473,633,1728,58,190
605,149,13,493,432,1692,326,323,24,483,666,1822,58,191
605,120,5,533,440,1703,315,262,18,522,632,1749,58,192
586,143,5,499,430,1663,362,380,19,453,595,1809,58,193
472,142,9,452,361,1436,280,275,36,395,520,1506,58,194
128,123,11,318,201,781,81,276,36,206,239,838,58,195
107,115,9,273,154,658,53,245,24,186,199,707,58,196
624,111,9,554,346,1644,336,279,23,455,579,1672,58,197
632,111,5,402,352,1502,290,304,20,379,606,1599,58,198
619,136,3,491,342,1591,305,283,16,415,607,1626,58,199
632,142,5,506,394,1679,308,344,17,464,597,1730,58,200
440,130,7,436,428,1441,215,279,33,378,534,1439,58,201
161,115,7,361,183,827,70,220,25,238,248,801,58,202
119,118,2,265,162,666,67,242,12,156,248,725,58,203
568,126,3,473,317,1487,273,250,22,369,582,1496,58,204
655,123,5,493,435,1711,322,332,26,431,688,1799,58,205
650,130,4,480,403,1667,320,320,17,436,658,1751,58,206
579,144,6,498,416,1643,285,360,17,439,654,1755,58,207
479,180,15,480,390,1544,246,288,35,379,572,1520,58,208
158,147,18,408,189,920,73,256,44,244,259,876,58,209
98,108,2,250,168,626,52,249,13,150,209,673,58,210
518,126,4,449,357,1454,261,288,12,380,583,1524,58,211
611,133,13,430,417,1604,317,315,19,386,598,1635,58,212
629,164,64,468,404,1729,323,310,73,416,640,1762,58,213
581,145,5,503,419,1653,294,320,10,454,672,1750,58,214
556,187,8,579,374,1704,269,328,33,514,560,1704,58,215
161,111,11,383,189,855,98,237,31,247,249,862,58,216
127,102,3,240,152,624,68,203,9,166,235,681,58,217
556,147,3,477,344,1527,268,312,7,387,559,1533,58,218
596,135,1,397,373,1502,265,327,10,361,632,1595,58,219
566,117,5,421,374,1483,279,305,10,351,584,1529,58,220
540,138,3,425,259,1365,236,249,18,369,542,1414,58,221
437,134,6,345,283,1205,200,262,23,301,425,1211,58,222
136,128,5,352,223,844,82,241,28,237,239,827,58,223
103,105,4,235,171,618,54,197,5,168,231,655,58,224
520,138,14,410,359,1441,278,325,20,333,566,1522,58,225
535,151,5,389,393,1473,258,282,10,338,599,1487,58,226
531,137,9,438,392,1507,288,311,14,350,621,1584,58,227
546,125,2,470,392,1535,288,320,9,391,609,1617,58,228
486,139,6,462,312,1405,230,281,31,385,523,1450,58,229
127,181,15,343,247,913,60,230,30,267,349,936,58,230
103,89,2,271,135,600,59,208,6,166,198,637,58,231
525,116,2,430,347,1420,285,251,3,302,615,1456,58,232
581,123,5,385,459,1553,326,299,7,327,639,1598,58,233
575,158,8,406,461,1608,328,300,19,346,650,1643,58,234
553,139,6,406,438,1542,309,309,12,334,647,1611,58,235
474,140,13,438,393,1458,276,295,24,382,552,1529,58,236
157,121,6,374,205,863,56,245,27,245,274,847,58,237
109,82,5,290,160,646,45,202,17,167,225,656,58,238
694,94,11,390,468,1657,370,283,14,343,706,1716,58,239
860,137,4,405,477,1883,505,325,22,352,767,1971,58,240
762,129,3,384,537,1815,451,286,11,342,778,1868,58,241
722,105,3,425,514,1769,428,267,17,380,764,1856,58,242
601,110,4,430,449,1594,353,316,13,409,654,1745,58,243
155,94,8,394,177,828,65,243,31,265,248,852,58,244
118,115,2,289,157,681,58,230,8,193,275,764,58,245
137,85,5,304,163,694,65,192,10,206,249,722,58,246
805,125,7,460,496,1893,455,322,7,428,840,2052,58,247
831,150,18,459,541,1999,490,369,23,399,833,2114,58,248
774,120,4,428,500,1826,422,346,7,372,780,1927,58,249
686,152,5,441,441,1725,382,328,17,338,715,1780,58,250
162,123,13,373,154,825,87,200,35,272,254,848,58,251
147,94,2,309,174,726,56,219,6,232,259,772,58,252
857,130,3,415,427,1832,496,347,8,342,723,1916,58,253
829,176,9,426,525,1965,458,412,14,361,830,2075,58,254
781,150,19,494,500,1944,453,345,16,405,841,2060,58,255
791,147,3,467,503,1911,377,382,5,421,881,2066,58,256
691,168,8,463,502,1832,354,393,45,408,754,1954,58,257
135,115,10,424,258,942,73,264,25,273,342,977,58,258
119,105,2,299,160,685,48,248,8,194,248,746,58,259
780,128,2,458,475,1843,417,314,4,380,829,1944,58,260
851,141,2,450,513,1957,430,352,9,398,859,2048,58,261
815,147,14,529,579,2084,456,366,15,417,826,2080,58,262
804,164,6,488,503,1965,439,377,12,409,890,2127,58,263
698,331,18,540,584,2171,366,396,44,460,986,2252,58,264
46,36,10,45,28,165,37,37,11,51,24,160,58,265
45,26,13,34,32,150,28,24,13,37,27,129,58,266
796,122,4,449,535,1906,443,307,13,386,934,2083,58,267
848,135,10,469,551,2013,479,353,13,416,888,2149,58,268
815,136,17,451,496,1915,455,363,23,382,838,2061,58,269
752,164,7,455,578,1956,401,400,12,359,864,2036,58,270
669,139,11,513,460,1792,351,364,43,405,718,1881,58,271
151,165,9,379,274,978,69,299,44,283,306,1001,58,272
116,102,4,296,159,677,51,235,5,166,283,740,58,273
756,127,3,436,496,1818,405,300,9,367,817,1898,58,274
823,146,8,483,528,1988,483,358,19,432,834,2126,58,275
840,131,5,488,511,1975,493,353,11,385,764,2006,58,276
787,136,4,504,569,2000,392,353,11,413,855,2024,58,277
672,164,5,578,519,1938,366,310,31,369,807,1883,58,278
141,133,3,328,241,846,77,282,32,243,304,938,58,279
123,104,4,304,142,677,58,232,7,204,255,756,58,280
775,142,4,482,544,1947,440,343,11,406,840,2040,58,281
845,163,13,483,505,2009,477,364,18,455,842,2156,58,282
791,131,5,486,534,1947,475,322,7,372,814,1990,58,283
648,128,8,563,547,1894,386,346,10,398,783,1923,58,284
524,177,7,572,444,1724,312,377,26,412,555,1682,58,285
160,153,15,421,238,987,81,305,29,260,346,1021,58,286
140,117,0,347,196,800,65,248,7,193,296,809,58,287
301,96,4,375,271,1047,129,231,8,271,423,1062,58,288
794,146,23,434,549,1946,420,362,31,345,898,2056,58,289
803,121,4,514,662,2104,434,330,12,387,958,2121,58,290
775,149,5,493,583,2005,426,392,12,406,802,2038,58,291
662,162,12,529,562,1927,381,383,43,390,844,2041,58,292
166,171,7,412,311,1067,75,340,39,269,330,1053,58,293
131,95,4,347,200,777,57,264,17,236,262,836,58,294
786,150,5,470,505,1916,424,345,13,398,820,2000,58,295
801,121,2,484,538,1946,412,338,14,379,900,2043,58,296
831,114,5,591,514,2055,457,355,16,461,904,2193,58,297
807,156,7,544,592,2106,417,374,11,430,970,2202,58,298
710,177,5,552,549,1993,420,388,28,429,809,2074,58,299
152,176,4,438,286,1056,57,341,27,375,302,1102,58,300
148,94,2,333,168,745,71,240,5,215,280,811,58,301
773,136,5,455,539,1908,361,304,13,387,804,1869,58,302
799,141,6,456,602,2004,387,383,20,399,867,2056,58,303
801,169,5,474,584,2033,391,386,7,454,893,2131,58,304
764,197,5,443,612,2021,394,426,15,408,866,2109,58,305
643,249,6,498,484,1880,282,331,40,419,903,1975,58,306
7,0,0,1,0,8,10,5,0,9,4,28,58,307
0,0,0,0,0,0,4,9,1,10,9,33,58,308
650,113,6,483,484,1736,405,264,16,419,739,1843,58,309
573,122,2,492,467,1656,373,270,30,405,670,1748,58,310
814,155,4,541,492,2006,461,333,9,481,820,2104,58,311
756,112,6,485,544,1903,400,321,13,374,850,1958,58,312
704,178,4,538,498,1922,374,312,21,507,778,1992,58,313
149,92,7,381,248,877,70,223,24,276,325,918,58,314
113,90,4,287,133,627,63,165,11,173,266,678,58,315
283,94,5,378,229,989,119,218,10,291,381,1019,58,316
816,120,1,489,527,1953,430,279,10,407,863,1989,58,317
816,116,18,530,598,2078,470,287,25,467,919,2168,58,318
761,101,6,456,574,1898,399,271,24,364,799,1857,58,319
686,153,7,523,482,1851,354,296,21,374,822,1867,58,320
138,96,10,355,256,855,61,221,22,285,342,931,58,321
117,75,3,295,145,635,58,192,10,196,213,669,58,322
745,112,9,491,563,1920,376,277,17,402,866,1938,58,323
798,146,11,457,500,1912,466,316,20,409,833,2044,58,324
767,108,4,501,522,1902,425,295,12,428,806,1966,58,325
731,110,6,596,552,1995,434,326,10,473,895,2138,58,326
641,103,7,507,440,1698,339,292,28,425,753,1837,58,327
142,118,12,373,208,853,67,240,26,245,305,883,58,328
122,79,5,279,163,648,59,184,7,225,237,712,58,329
687,135,4,419,516,1761,385,279,23,403,818,1908,58,330
691,120,5,467,486,1769,389,305,9,415,747,1865,58,331
431,109,5,516,289,1350,223,273,12,398,504,1410,58,332
67,79,3,208,119,476,54,111,7,137,146,455,58,333
218,114,5,331,218,886,110,211,13,240,388,962,58,334
100,90,10,298,170,668,63,216,17,191,261,748,58,335
105,75,2,249,163,594,51,220,3,160,246,680,58,336
768,111,3,401,501,1784,483,278,8,374,788,1931,58,337
696,134,2,417,460,1709,353,312,11,344,801,1821,58,338
722,108,6,478,475,1789,376,302,11,438,799,1926,58,339
709,113,5,407,473,1707,349,307,7,380,797,1840,58,340
624,125,9,515,461,1734,369,303,30,433,809,1944,58,341
15,18,0,15,13,61,13,16,0,16,14,59,58,342
11,19,4,25,24,83,12,20,4,25,24,85,58,343
754,119,7,443,495,1818,360,311,10,394,792,1867,58,344
770,143,2,540,499,1954,412,290,10,448,997,2157,58,345
805,87,5,428,406,1731,437,308,8,369,741,1863,58,346
802,117,10,477,544,1950,436,345,26,398,819,2024,58,347
653,121,11,510,435,1730,342,323,27,402,744,1838,58,348
155,119,3,377,237,891,80,263,24,291,327,985,58,349
108,92,1,284,143,628,62,189,8,189,210,658,58,350
748,114,4,437,539,1842,404,346,9,409,864,2032,58,351
756,154,20,500,571,2001,427,344,17,389,948,2125,58,352
726,132,10,519,568,1955,415,346,13,444,816,2034,58,353
678,127,5,449,526,1785,343,313,5,424,801,1886,58,354
535,144,10,485,477,1651,333,343,26,366,666,1734,58,355
112,71,8,310,215,716,59,197,20,242,288,806,58,356
90,90,1,201,169,551,50,156,14,172,197,589,58,357
313,96,10,369,304,1092,153,246,21,290,452,1162,58,358
234,86,5,312,179,816,153,180,5,256,292,886,58,359
49,71,3,152,84,359,43,96,5,110,111,365,58,360
251,104,7,302,262,926,136,228,18,256,377,1015,58,361
241,121,15,299,285,961,118,198,38,252,362,968,58,362
75,98,10,218,144,545,43,145,19,149,168,524,58,363
64,62,3,176,134,439,52,111,10,131,152,456,58,364
284,103,4,343,302,1036,151,243,16,277,485,1172,58,365
339,187,25,407,231,1189,186,245,42,343,456,1272,58,366
49,37,2,110,56,254,25,52,9,72,80,238,59,1
443,45,5,214,200,907,114,136,10,155,455,870,59,2
541,57,6,228,203,1035,114,164,11,162,527,978,59,3
545,53,2,203,176,979,117,138,11,159,524,949,59,4
433,63,3,195,201,895,106,150,8,154,410,828,59,5
54,69,5,140,66,334,37,90,20,111,68,326,59,6
44,2865,1,199,345,3454,67,142,11,1230,1781,3231,59,7
523,55,1,184,186,949,101,140,8,140,513,902,59,8
590,38,2,161,121,912,99,100,7,204,490,900,59,9
621,62,4,190,165,1042,118,165,12,145,568,1008,59,10
597,51,6,203,191,1048,111,166,17,138,599,1031,59,11
466,49,5,204,131,855,115,121,16,199,413,864,59,12
68,44,4,195,94,405,51,89,20,100,109,369,59,13
36,31,3,123,68,261,21,77,9,60,94,261,59,14
87,43,21,141,71,363,54,93,28,81,93,349,59,15
178,43,5,158,96,480,97,106,10,91,161,465,59,16
495,43,15,226,136,915,115,127,17,136,489,884,59,17
585,48,9,208,181,1031,114,161,17,144,539,975,59,18
253,48,4,158,94,557,120,111,20,104,176,531,59,19
75,57,5,152,106,395,40,100,37,107,103,387,59,20
46,39,3,105,68,261,16,89,7,45,93,250,59,21
451,43,3,180,152,829,100,141,20,104,480,845,59,22
638,43,5,178,159,1023,98,173,13,157,595,1036,59,23
634,59,4,189,171,1057,109,173,10,97,603,992,59,24
581,40,3,177,153,954,105,167,9,118,548,947,59,25
426,47,6,240,170,889,100,169,28,192,376,865,59,26
81,58,6,189,131,465,45,136,20,135,151,487,59,27
62,69,2,111,51,295,37,82,9,75,109,312,59,28
498,44,11,160,153,866,103,132,19,125,468,847,59,29
667,45,9,191,172,1084,100,171,16,148,602,1037,59,30
677,47,4,233,175,1136,111,198,6,160,605,1080,59,31
603,46,14,194,166,1023,101,168,19,135,553,976,59,32
482,53,3,195,213,946,106,148,25,178,430,887,59,33
77,55,2,191,115,440,38,93,16,121,106,374,59,34
48,38,3,150,60,299,25,89,11,78,80,283,59,35
540,51,3,174,152,920,101,147,8,144,530,930,59,36
672,49,6,198,197,1122,103,178,17,156,606,1060,59,37
667,42,4,212,232,1157,96,192,9,167,628,1092,59,38
613,53,3,201,164,1034,105,190,6,157,548,1006,59,39
444,50,4,207,189,894,104,147,25,152,398,826,59,40
77,57,7,172,120,433,35,130,29,109,104,407,59,41
55,41,6,115,50,267,18,92,14,70,90,284,59,42
496,42,2,209,157,906,91,129,10,134,503,867,59,43
593,44,10,208,179,1034,115,174,19,131,566,1005,59,44
653,52,6,195,198,1104,143,198,13,158,561,1073,59,45
588,41,15,201,171,1016,111,172,18,110,532,943,59,46
424,48,23,214,183,892,124,150,42,209,379,904,59,47
71,42,7,165,89,374,34,81,26,85,133,359,59,48
47,38,6,105,76,272,18,87,16,52,94,267,59,49
143,40,20,167,99,469,67,92,23,97,152,431,59,50
599,61,9,227,171,1067,92,187,13,151,593,1036,59,51
655,49,15,228,168,1115,111,180,21,158,613,1083,59,52
607,65,6,204,195,1077,114,209,12,141,580,1056,59,53
424,55,3,194,181,857,99,135,26,141,415,816,59,54
88,41,8,173,100,410,50,98,23,98,130,399,59,55
43,42,2,109,85,281,24,80,14,58,89,265,59,56
534,47,14,169,161,925,103,167,20,121,484,895,59,57
688,43,1,215,158,1105,116,167,5,155,615,1058,59,58
640,33,3,221,154,1051,108,159,6,151,608,1032,59,59
589,47,7,192,152,987,109,166,12,164,518,969,59,60
444,48,7,193,179,871,107,162,22,153,415,859,59,61
56,37,4,125,87,309,25,55,16,49,69,214,59,62
38,33,5,97,55,228,17,57,14,45,54,187,59,63
504,35,8,199,144,890,95,134,12,128,495,864,59,64
675,43,5,203,184,1110,101,213,10,149,603,1076,59,65
683,45,19,193,193,1133,122,217,18,170,614,1141,59,66
641,59,2,248,192,1142,115,196,24,178,572,1085,59,67
467,47,3,211,206,934,136,177,31,134,426,904,59,68
78,61,4,154,130,427,44,123,26,107,114,414,59,69
45,33,13,120,77,288,21,90,14,65,81,271,59,70
539,46,1,163,138,887,96,167,8,130,474,875,59,71
675,59,7,230,188,1159,101,246,19,162,628,1156,59,72
690,56,5,224,203,1178,101,217,17,162,665,1162,59,73
618,56,7,261,150,1092,110,213,27,200,545,1095,59,74
406,62,2,250,199,919,114,169,31,171,416,901,59,75
105,64,6,236,161,572,45,149,42,120,176,532,59,76
46,53,5,145,78,327,21,123,23,57,97,321,59,77
552,45,2,210,186,995,99,174,6,144,525,948,59,78
669,76,7,204,174,1130,85,227,20,153,625,1110,59,79
663,48,2,252,208,1173,104,253,9,154,607,1127,59,80
638,55,7,234,201,1135,112,205,28,170,588,1103,59,81
452,45,5,224,168,894,99,179,37,157,428,900,59,82
72,42,1,162,103,380,29,126,17,87,121,380,59,83
57,49,3,187,67,363,21,100,11,71,142,345,59,84
555,63,4,219,189,1030,92,199,11,108,589,999,59,85
647,67,5,260,186,1165,85,244,17,164,646,1156,59,86
690,62,6,211,179,1148,119,233,12,154,648,1166,59,87
602,60,4,231,168,1065,127,196,13,158,564,1058,59,88
442,51,3,249,203,948,91,170,23,154,446,884,59,89
89,56,4,270,131,550,43,151,33,135,180,542,59,90
55,55,3,174,85,372,28,123,13,98,140,402,59,91
478,59,16,222,187,962,105,161,36,122,519,943,59,92
636,55,2,267,204,1164,125,237,9,182,610,1163,59,93
651,61,12,236,191,1151,88,227,12,133,626,1086,59,94
669,51,8,273,180,1181,107,249,13,186,585,1140,59,95
500,65,11,267,214,1057,123,197,37,173,469,999,59,96
100,68,3,219,109,499,40,143,25,111,184,503,59,97
59,43,1,169,95,367,18,126,8,71,105,328,59,98
560,49,4,218,158,989,101,162,22,164,535,984,59,99
681,56,13,199,187,1136,105,216,31,173,655,1180,59,100
728,47,23,246,197,1241,139,229,29,159,675,1231,59,101
629,60,3,242,166,1100,144,200,12,178,575,1109,59,102
512,62,4,224,200,1002,116,177,31,192,453,969,59,103
119,56,6,221,143,545,50,134,38,123,185,530,59,104
67,52,4,179,94,396,26,136,15,95,142,414,59,105
546,54,11,218,171,1000,113,158,21,157,519,968,59,106
616,69,9,266,162,1122,109,193,19,164,596,1081,59,107
641,54,7,215,210,1127,118,210,16,149,619,1112,59,108
589,64,13,248,191,1105,109,218,30,162,548,1067,59,109
469,53,4,268,171,965,130,164,26,186,428,934,59,110
81,55,3,205,137,481,37,113,29,112,116,407,59,111
38,35,4,118,63,258,17,81,9,61,82,250,59,112
578,58,5,216,160,1017,106,177,15,155,572,1025,59,113
723,58,9,265,196,1251,118,211,22,162,699,1212,59,114
708,82,3,250,212,1255,123,239,12,177,676,1227,59,115
650,67,2,231,187,1137,125,226,12,175,610,1148,59,116
531,67,8,233,187,1026,150,187,36,184,460,1017,59,117
80,52,5,155,113,405,35,89,26,75,89,314,59,118
55,55,2,163,107,382,31,115,29,90,135,400,59,119
536,57,2,176,175,946,108,168,13,118,535,942,59,120
683,50,5,183,169,1090,95,198,11,138,649,1091,59,121
699,59,3,221,193,1175,127,226,8,169,649,1179,59,122
652,65,2,217,177,1113,126,233,10,138,580,1087,59,123
490,68,14,223,236,1031,126,181,25,179,468,979,59,124
27,17,5,16,19,84,31,18,6,15,20,90,59,125
14,5,5,17,7,48,14,6,7,16,8,51,59,126
582,50,16,198,165,1011,122,162,20,154,551,1009,59,127
722,80,4,228,220,1254,130,196,10,144,741,1221,59,128
711,53,4,241,210,1219,123,236,12,162,656,1189,59,129
626,49,12,224,190,1101,116,203,29,157,615,1120,59,130
471,39,103,225,213,1051,107,149,70,189,442,957,59,131
73,2,0,11,1,87,75,2,0,5,0,82,59,132
0,0,2,1,0,3,2,3,1,9,0,15,59,133
542,49,4,224,169,988,94,178,6,140,569,987,59,134
683,73,6,249,185,1196,127,195,10,216,694,1242,59,135
687,64,17,250,186,1204,127,204,23,167,669,1190,59,136
673,73,9,283,186,1224,137,237,20,199,606,1199,59,137
471,74,10,251,174,980,127,161,34,179,469,970,59,138
71,53,5,178,95,402,44,126,20,114,122,426,59,139
51,53,3,137,101,345,18,107,15,88,101,329,59,140
565,58,6,236,139,1004,123,172,17,174,571,1057,59,141
729,59,3,236,194,1221,116,202,16,198,667,1199,59,142
695,57,4,250,198,1204,129,204,19,166,642,1160,59,143
597,55,6,243,209,1110,148,196,16,179,584,1123,59,144
421,56,19,212,185,893,145,153,45,197,358,898,59,145
78,1934,52,208,149,2421,50,207,45,296,1619,2217,59,146
19,0,0,0,1,20,29,0,0,0,0,29,59,147
627,75,3,227,211,1143,115,196,11,168,607,1097,59,149
671,52,7,207,152,1089,119,171,11,167,600,1068,59,150
653,69,5,233,195,1155,143,219,20,171,604,1157,59,151
504,76,10,233,186,1009,135,178,34,144,469,960,59,152
83,57,3,153,109,405,42,152,29,111,113,447,59,153
59,43,2,144,83,331,30,104,11,75,110,330,59,154
606,55,5,221,193,1080,129,174,18,180,610,1111,59,155
688,55,2,215,213,1173,123,202,10,195,654,1184,59,156
693,51,6,197,201,1148,112,188,14,169,646,1129,59,157
654,64,5,252,239,1214,154,242,13,186,591,1186,59,158
467,90,14,213,228,1012,139,229,38,192,443,1041,59,159
80,5432,32,271,301,6116,50,292,91,710,4688,5831,59,160
49,66,7,156,133,411,30,135,26,71,107,369,59,161
595,66,3,231,214,1109,114,178,20,159,629,1100,59,162
690,68,5,233,197,1193,136,196,22,171,651,1176,59,163
693,58,6,249,236,1242,135,218,20,174,661,1208,59,164
621,82,6,219,224,1152,123,215,20,160,620,1138,59,165
441,3062,30,208,184,3925,130,1111,52,287,2552,4132,59,166
79,71,7,200,125,482,41,144,35,129,128,477,59,167
41,66,3,141,86,337,22,126,16,79,136,379,59,168
562,74,4,206,170,1016,115,195,14,165,520,1009,59,169
625,69,12,248,161,1115,126,182,24,186,559,1077,59,170
175,75,11,190,164,615,94,167,21,127,185,594,59,171
554,78,4,224,224,1084,121,206,11,173,508,1019,59,172
427,94,9,204,154,888,117,184,35,138,420,894,59,173
106,73,12,204,142,537,68,149,27,131,144,519,59,174
55,60,17,120,96,348,29,130,68,68,102,397,59,175
536,82,62,195,206,1081,105,206,74,156,483,1024,59,176
648,90,62,235,174,1209,137,210,73,187,593,1200,59,177
640,83,74,245,201,1243,120,247,70,193,612,1242,59,178
588,87,6,236,185,1102,116,218,18,176,570,1098,59,179
421,53,4,239,195,912,106,185,29,160,422,902,59,180
113,71,7,189,138,518,46,169,28,144,166,553,59,181
51,54,2,164,73,344,36,111,13,74,120,354,59,182
575,71,5,250,182,1083,121,189,16,184,561,1071,59,183
668,74,5,244,193,1184,132,240,21,183,627,1203,59,184
568,70,2,270,243,1153,109,195,35,212,551,1102,59,185
70,184,11,193,167,625,33,276,27,117,146,599,59,186
322,66,8,219,173,788,84,179,28,188,359,838,59,187
71,90,11,202,108,482,51,146,37,120,127,481,59,188
54,52,8,149,77,340,26,139,11,87,100,363,59,189
509,92,4,233,170,1008,119,197,20,180,633,1149,59,190
714,92,19,255,180,1260,147,199,36,204,683,1269,59,191
679,126,9,211,180,1205,134,252,22,191,625,1224,59,192
647,106,15,206,195,1169,132,209,41,166,572,1120,59,193
424,83,16,209,194,926,115,161,50,195,395,916,59,194
99,70,5,222,102,498,45,118,32,104,151,450,59,195
68,57,10,109,81,325,35,128,26,72,100,361,59,196
489,86,3,231,146,955,102,186,19,158,528,993,59,197
621,45,5,172,142,985,105,168,16,163,541,993,59,198
616,47,3,192,143,1001,113,135,14,161,580,1003,59,199
549,56,3,193,193,994,100,176,24,166,549,1015,59,200
414,78,11,208,159,870,117,208,43,169,355,892,59,201
82,49,10,142,97,380,43,120,25,98,116,402,59,202
53,51,6,137,66,313,30,110,14,62,111,327,59,203
508,53,7,199,152,919,101,139,19,125,510,894,59,204
635,40,6,198,127,1006,98,194,16,166,588,1062,59,205
576,33,4,180,156,949,102,148,25,141,554,970,59,206
509,54,7,223,148,941,105,140,20,160,494,919,59,207
405,2630,88,230,243,3596,121,888,65,379,1872,3325,59,208
89,2558,80,176,162,3065,60,600,47,304,1660,2671,59,209
68,42,6,129,67,312,32,127,22,82,103,366,59,210
468,50,2,218,127,865,109,157,13,181,447,907,59,211
616,40,4,230,136,1026,107,205,13,154,570,1049,59,212
609,72,3,184,142,1010,109,172,21,130,480,912,59,213
523,55,4,215,150,947,109,171,25,161,537,1003,59,214
390,67,9,183,116,765,108,160,38,134,339,779,59,215
91,40,8,163,105,407,47,120,24,102,140,433,59,216
50,45,2,159,54,310,26,111,12,78,97,324,59,217
465,51,3,215,154,888,98,172,9,126,530,935,59,218
599,58,2,205,182,1046,106,206,13,169,570,1064,59,219
596,49,15,193,161,1014,104,153,21,135,604,1017,59,220
499,70,5,171,165,910,91,194,39,108,530,962,59,221
349,48,14,164,129,704,95,130,25,148,312,710,59,222
75,70,7,170,88,410,51,108,22,87,120,388,59,223
37,37,3,146,74,297,38,116,15,57,92,318,59,224
461,65,11,173,113,823,96,157,18,120,486,877,59,225
601,53,16,226,133,1029,96,151,20,161,585,1013,59,226
558,42,6,188,125,919,110,163,11,164,535,983,59,227
537,62,8,210,171,988,103,167,20,159,547,996,59,228
392,60,12,184,123,771,121,152,27,171,382,853,59,229
72,45,9,178,105,409,43,101,28,112,124,408,59,230
57,52,2,125,68,304,39,99,7,76,105,326,59,231
502,45,2,194,162,905,112,136,11,136,544,939,59,232
573,63,4,180,164,984,99,188,21,122,577,1007,59,233
565,59,18,182,192,1016,106,158,28,145,611,1048,59,234
535,52,4,221,153,965,99,160,15,137,582,993,59,235
412,68,5,180,171,836,119,173,32,142,484,950,59,236
80,61,7,192,111,451,55,138,31,114,122,460,59,237
50,1537,108,142,118,1955,36,962,57,196,851,2102,59,238
512,31,3,191,156,893,108,155,8,131,517,919,59,239
648,48,2,212,141,1051,121,170,7,134,629,1061,59,240
629,40,12,177,150,1008,102,173,17,141,589,1022,59,241
608,56,8,214,132,1018,117,159,19,136,551,982,59,242
423,58,11,197,153,842,94,165,46,179,357,841,59,243
83,54,7,158,81,383,56,138,32,103,115,444,59,244
46,49,2,160,57,314,30,110,16,68,104,328,59,245
55,41,7,131,70,304,29,114,14,69,106,332,59,246
643,46,4,235,139,1067,102,169,8,177,627,1083,59,247
644,48,3,167,150,1012,120,158,13,121,633,1045,59,248
618,64,4,220,156,1062,108,192,16,178,601,1095,59,249
440,46,6,203,171,866,136,150,28,173,439,926,59,250
77,34,7,194,99,411,40,124,29,104,104,401,59,251
62,38,4,118,60,282,29,99,12,88,78,306,59,252
567,40,4,229,190,1030,107,170,12,181,577,1047,59,253
702,56,2,207,136,1103,106,198,8,153,670,1135,59,254
674,61,2,222,160,1119,116,220,12,125,622,1095,59,255
641,64,35,209,159,1108,108,204,33,142,578,1065,59,256
465,60,4,199,168,896,127,179,24,136,448,914,59,257
72,77,8,209,126,492,59,141,33,126,129,488,59,258
62,53,2,323,3737,4177,296,103,8,3325,165,3897,59,259
569,69,5,196,152,991,116,242,9,128,558,1053,59,260
690,45,7,227,136,1105,115,167,15,155,662,1114,59,261
638,30,1,208,150,1027,90,163,6,155,617,1031,59,262
589,54,5,221,176,1045,105,227,12,152,573,1069,59,263
461,70,7,225,151,914,101,196,39,152,424,912,59,264
73,49,8,184,85,399,45,92,23,74,96,330,59,265
33,28,6,84,47,198,14,55,15,36,54,174,59,266
548,58,10,188,137,941,90,183,20,143,539,975,59,267
692,43,3,187,113,1038,103,178,10,131,633,1055,59,268
670,46,5,228,125,1074,100,164,15,145,628,1052,59,269
625,52,8,194,140,1019,108,170,23,153,595,1049,59,270
427,52,4,185,138,806,116,159,36,166,418,895,59,271
86,75,13,219,114,507,41,149,41,110,140,481,59,272
45,43,4,131,54,277,30,105,19,66,96,316,59,273
579,56,2,170,188,995,113,155,15,121,609,1013,59,274
680,40,4,190,145,1059,122,168,11,160,633,1094,59,275
707,34,7,200,177,1125,128,199,17,143,644,1131,59,276
623,43,5,222,190,1083,155,178,19,155,576,1083,59,277
473,65,15,197,225,975,121,168,59,155,473,976,59,278
56,61,7,188,106,418,57,111,26,119,142,455,59,279
56,64,7,279,4808,5214,234,108,17,4178,204,4741,59,280
616,52,13,197,155,1033,113,184,25,137,583,1042,59,281
741,42,2,212,193,1190,122,188,9,178,741,1238,59,282
732,38,9,217,170,1166,123,179,17,181,698,1198,59,283
654,60,8,243,194,1159,159,179,16,181,624,1159,59,284
408,51,8,229,206,902,110,180,34,172,434,930,59,285
100,50,4,200,117,471,62,156,26,121,132,497,59,286
59,35,2,140,67,303,33,126,19,75,88,341,59,287
236,51,5,177,134,603,89,142,12,110,294,647,59,288
689,46,10,241,164,1150,134,195,17,165,658,1169,59,289
726,37,4,194,155,1116,127,183,13,136,653,1112,59,290
616,51,4,189,189,1049,111,172,18,153,608,1062,59,291
465,73,6,199,197,940,122,170,35,182,489,998,59,292
87,66,5,209,131,498,53,183,37,137,142,552,59,293
64,3779,4,176,1240,5263,72,163,13,2506,2319,5073,59,294
579,49,6,224,185,1043,119,171,14,182,590,1076,59,295
738,48,3,197,179,1165,131,186,11,147,699,1174,59,296
693,40,4,173,191,1101,134,175,24,142,667,1142,59,297
627,69,2,224,173,1095,125,195,14,190,601,1125,59,298
477,60,8,195,201,941,127,156,21,163,476,943,59,299
99,57,4,191,116,467,63,125,31,124,146,489,59,300
65,5256,9,182,250,5762,104,165,12,2623,2688,5592,59,301
582,39,5,213,154,993,125,158,19,155,581,1038,59,302
673,63,52,215,239,1242,110,227,62,161,791,1351,59,303
671,44,8,196,143,1062,110,190,17,142,620,1079,59,304
590,63,14,224,131,1022,104,185,29,162,547,1027,59,305
460,66,7,213,142,888,112,140,25,183,433,893,59,306
80,61,3,170,93,407,47,113,26,106,125,417,59,307
55,48,5,108,71,287,38,103,13,82,88,324,59,308
551,37,5,191,193,977,103,152,13,161,575,1004,59,309
525,39,12,211,173,960,124,119,24,206,511,984,59,310
601,48,13,174,138,974,119,153,18,134,576,1000,59,311
633,48,9,186,175,1051,129,146,22,173,615,1085,59,312
432,55,2,203,210,902,111,165,23,175,484,958,59,313
80,54,8,194,116,452,52,100,24,129,155,460,59,314
61,68,3,274,5289,5695,316,94,15,4481,250,5156,59,315
236,46,2,143,147,574,89,104,17,110,286,606,59,316
703,45,4,196,159,1107,101,159,15,181,665,1121,59,317
700,48,9,226,139,1122,107,159,17,165,641,1089,59,318
607,32,3,197,151,990,100,135,18,152,606,1011,59,319
501,47,7,172,153,880,103,128,27,171,481,910,59,320
83,53,5,161,87,389,39,93,21,93,131,377,59,321
59,26,3,117,77,282,33,91,13,79,88,304,59,322
594,53,6,171,162,986,121,161,20,137,586,1025,59,323
746,43,5,205,165,1164,137,160,13,156,708,1174,59,324
676,41,5,178,183,1083,128,161,14,140,673,1116,59,325
606,44,14,179,176,1019,118,165,16,153,570,1022,59,326
451,54,4,169,151,829,126,131,21,143,421,842,59,327
72,45,9,173,92,391,52,112,21,118,117,420,59,328
73,56,2,285,3960,4376,300,90,11,3403,190,3994,59,329
533,49,6,176,190,954,130,132,30,148,525,965,59,330
584,46,2,191,176,999,134,134,10,177,543,998,59,331
360,32,1,172,148,713,111,124,10,193,299,737,59,332
25,47,2,51,26,151,17,43,11,67,89,227,59,333
168,35,4,148,109,464,85,83,17,100,180,465,59,334
55,45,3,136,93,332,44,111,11,113,117,396,59,335
63,49,9,245,3655,4021,259,97,11,3237,136,3740,59,336
518,51,5,173,129,876,116,132,9,143,525,925,59,337
686,44,26,206,151,1113,109,152,25,145,631,1062,59,338
666,33,20,182,127,1028,103,158,25,136,613,1035,59,339
570,39,10,177,129,925,95,167,14,125,543,944,59,340
465,45,11,191,129,841,96,159,22,142,434,853,59,341
66,28,13,113,83,303,29,72,25,72,72,270,59,342
29,26,4,98,49,206,24,53,11,53,50,191,59,343
535,38,2,174,144,893,104,139,11,123,545,922,59,344
701,35,14,185,127,1062,133,166,14,147,547,1007,59,345
660,45,20,192,129,1046,112,141,26,157,616,1052,59,346
593,61,13,179,134,980,119,170,20,143,564,1016,59,347
476,47,12,218,161,914,121,163,19,167,471,941,59,348
83,4783,6,352,2743,7967,718,168,23,5242,232,6383,59,349
51,33,3,108,64,259,26,88,8,69,89,280,59,350
540,40,4,168,147,899,108,135,15,142,561,961,59,351
694,49,30,193,178,1144,122,191,26,132,641,1112,59,352
679,47,20,195,170,1111,112,176,26,150,654,1118,59,353
560,74,14,190,161,999,115,181,17,149,552,1014,59,354
358,46,7,172,148,731,121,142,27,130,317,737,59,355
53,45,10,149,96,353,53,88,18,79,85,323,59,356
51,51,0,188,3548,3838,215,85,8,2893,142,3343,59,357
291,43,11,166,119,630,88,126,21,141,288,664,59,358
170,30,2,116,72,390,83,61,10,110,146,410,59,359
18,14,2,33,28,95,7,24,6,38,48,123,59,360
189,38,3,147,112,489,78,115,15,100,201,509,59,361
171,38,7,147,132,495,94,93,17,91,193,488,59,362
53,45,7,152,88,345,48,98,14,83,105,348,59,363
35,781,2122,124,98,3160,27,1341,42,191,1497,3098,59,364
259,45,4,168,109,585,76,116,9,119,314,634,59,365
276,52,11,212,138,689,88,79,36,167,294,664,59,366
89,238,5,515,416,1263,112,242,7,422,445,1228,60,1
478,396,13,584,826,2297,545,366,12,613,938,2474,60,2
670,441,10,617,974,2712,748,411,9,696,1112,2976,60,3
695,526,9,579,1045,2854,803,409,8,702,1203,3125,60,4
546,579,68,607,998,2798,635,553,55,625,1073,2941,60,5
112,490,50,769,617,2038,246,421,41,875,772,2355,60,6
113,598,11,867,860,2449,420,337,11,1246,889,2903,60,7
632,730,22,810,1780,3974,1572,414,14,1178,1171,4349,60,8
773,715,14,1042,1952,4496,1725,402,14,1263,1231,4635,60,9
842,644,17,1317,1678,4498,1457,524,14,1140,1356,4491,60,10
845,587,16,1051,1300,3799,1060,503,22,843,1274,3702,60,11
607,583,64,646,1047,2947,713,526,42,761,1135,3177,60,12
160,652,71,899,926,2708,269,594,45,1064,1008,2980,60,13
122,465,4,910,711,2212,182,383,6,840,786,2197,60,14
173,459,4,773,613,2022,285,444,5,768,653,2155,60,15
365,466,30,461,733,2055,506,410,36,539,706,2197,60,16
748,608,45,593,1223,3217,839,528,52,869,1299,3587,60,17
873,1008,14,700,1439,4034,949,655,14,963,1606,4187,60,18
504,940,69,718,970,3201,462,641,36,909,1254,3302,60,19
199,1003,77,1771,2091,5141,279,615,49,3136,1391,5470,60,20
94,443,13,1568,1727,3845,197,305,16,2687,950,4155,60,21
727,581,11,880,1441,3640,719,462,14,1177,1419,3791,60,22
880,743,13,1079,1743,4458,1026,496,13,1382,1660,4577,60,23
894,813,24,817,1726,4274,1037,566,26,1316,1458,4403,60,24
884,877,9,778,1650,4198,1043,612,9,1201,1469,4334,60,25
579,1252,100,952,1786,4669,618,857,43,1658,1917,5093,60,26
175,1389,78,1954,2839,6435,299,596,54,4270,1970,7189,60,27
119,414,3,1379,1540,3455,228,334,4,2384,867,3817,60,28
736,439,24,525,1043,2767,801,431,27,582,1117,2958,60,29
929,599,1,606,1238,3373,966,499,2,667,1398,3532,60,30
884,629,9,629,1199,3350,893,560,7,679,1255,3394,60,31
888,694,12,674,1278,3546,919,554,15,763,1369,3620,60,32
607,717,78,674,1119,3195,627,679,49,783,1253,3391,60,33
175,575,69,854,765,2438,219,529,59,913,958,2678,60,34
139,365,14,847,720,2085,194,340,13,882,806,2235,60,35
733,497,7,549,1086,2872,732,485,8,787,1100,3112,60,36
942,571,18,561,1278,3370,947,548,25,633,1453,3606,60,37
974,654,18,609,1241,3496,948,582,11,763,1390,3694,60,38
874,773,8,602,1289,3546,1042,633,7,771,1323,3776,60,39
621,777,56,859,1213,3526,777,687,50,828,1184,3526,60,40
172,781,105,908,1030,2996,282,738,59,1053,1083,3215,60,41
160,482,16,946,984,2588,211,401,25,900,790,2327,60,42
678,524,13,629,1374,3218,1037,485,14,846,1127,3509,60,43
876,917,34,778,2351,4956,2096,511,27,1156,1370,5160,60,44
935,820,58,1039,2070,4922,1803,580,56,1363,1520,5322,60,45
937,704,7,717,1243,3608,1015,559,6,708,1285,3573,60,46
520,767,71,658,955,2971,555,704,36,786,1329,3410,60,47
135,2223,82,1513,1427,5380,976,569,44,2474,1242,5305,60,48
119,2059,23,1374,1253,4828,947,481,18,2325,1021,4792,60,49
308,451,13,1954,1498,4224,1451,392,11,1568,807,4229,60,50
868,599,31,640,1197,3335,896,513,28,718,1311,3466,60,51
860,575,34,640,1294,3403,996,541,21,788,1317,3663,60,52
902,761,14,709,1298,3684,1028,630,14,843,1357,3872,60,53
620,739,63,726,1229,3377,900,590,47,840,1189,3566,60,54
139,979,74,1278,1530,4000,358,796,117,1881,1298,4450,60,55
110,463,16,1143,1075,2807,227,376,19,1568,841,3031,60,56
789,435,17,627,1165,3033,838,484,17,707,1078,3124,60,57
962,666,18,535,1260,3441,964,520,12,604,1438,3538,60,58
953,575,25,597,1232,3382,880,572,20,723,1394,3589,60,59
932,726,6,572,1219,3455,941,638,9,733,1359,3680,60,60
681,814,63,737,1228,3523,752,724,42,901,1294,3713,60,61
133,892,93,1045,1052,3215,449,644,38,1225,1023,3379,60,62
139,468,20,890,815,2332,217,426,18,1027,738,2426,60,63
707,509,10,602,1158,2986,875,494,9,684,1088,3150,60,64
920,691,16,647,1237,3511,998,543,14,721,1339,3615,60,65
959,688,12,811,1236,3706,1018,545,10,812,1400,3785,60,66
873,848,12,692,1339,3764,988,631,12,822,1449,3902,60,67
629,2080,60,786,1983,5538,776,817,50,2352,1793,5788,60,68
177,2857,68,1492,3691,8285,827,613,33,5831,1258,8562,60,69
143,572,20,1490,2587,4812,431,507,28,3006,949,4921,60,70
775,599,3,672,1179,3228,821,583,7,699,1224,3334,60,71
927,729,8,734,1464,3862,1023,664,12,799,1501,3999,60,72
966,835,13,1005,1863,4682,1588,675,14,1016,1679,4972,60,73
860,1070,15,1027,2015,4987,931,713,40,1316,2258,5258,60,74
520,891,85,1500,2187,5183,776,683,68,1735,2294,5556,60,75
266,903,91,1593,1126,3979,473,880,52,1579,1323,4307,60,76
206,590,18,1144,901,2859,284,480,15,998,842,2619,60,77
751,579,12,738,1326,3406,977,528,7,913,1288,3713,60,78
965,750,15,802,1784,4316,1410,568,21,1173,1390,4562,60,79
955,780,10,912,1903,4560,1459,717,8,1263,1430,4877,60,80
936,860,13,1032,1479,4320,1207,767,19,1001,1503,4497,60,81
688,943,76,931,1339,3977,932,864,55,1117,1525,4493,60,82
135,847,57,1128,1235,3402,346,830,44,1136,1135,3491,60,83
154,582,5,1227,1028,2996,311,649,6,1134,1166,3266,60,84
811,619,13,995,1296,3734,863,660,16,822,1340,3701,60,85
972,788,8,845,1427,4040,1040,695,10,970,1612,4327,60,86
893,711,14,946,1417,3981,1018,648,11,1039,1520,4236,60,87
867,874,16,1044,1594,4395,1012,759,10,1024,1694,4499,60,88
718,773,85,1090,1374,4040,747,918,38,1051,1528,4282,60,89
213,855,67,1438,1145,3718,248,926,43,1189,1399,3805,60,90
167,432,8,1124,685,2416,234,439,10,1006,853,2542,60,91
720,479,13,825,1363,3400,825,675,17,789,1254,3560,60,92
946,790,4,768,1484,3992,1143,569,7,918,1574,4211,60,93
898,732,22,860,1657,4169,1302,681,12,958,1424,4377,60,94
864,825,18,1022,1919,4648,1316,806,15,986,1569,4692,60,95
659,896,56,917,1507,4035,892,1133,49,979,1344,4397,60,96
272,900,102,1457,1224,3955,303,1185,71,1252,1434,4245,60,97
310,527,17,1377,912,3143,291,541,17,1237,1037,3123,60,98
773,522,11,704,1107,3117,894,482,10,651,1170,3207,60,99
889,749,10,738,1403,3789,1090,634,10,770,1431,3935,60,100
926,776,5,1081,1771,4559,1703,603,3,1130,1448,4887,60,101
916,823,8,772,1396,3915,1136,594,3,890,1416,4039,60,102
699,882,76,859,1088,3604,813,847,68,841,1389,3958,60,103
260,807,57,1163,1062,3349,261,890,65,1166,1246,3628,60,104
152,522,2,987,793,2456,246,500,4,958,968,2676,60,105
690,598,11,780,1045,3124,731,561,5,799,1170,3266,60,106
791,754,8,709,1247,3509,969,611,5,777,1342,3704,60,107
833,812,5,738,1228,3616,964,621,3,863,1168,3619,60,108
855,802,8,815,1343,3823,958,740,8,845,1449,4000,60,109
577,774,56,838,1346,3591,587,1026,73,854,1299,3839,60,110
221,907,71,1393,1149,3741,267,1161,57,1120,1471,4076,60,111
190,424,2,1063,626,2305,199,397,4,897,976,2473,60,112
731,534,3,655,1126,3049,848,489,5,726,1151,3219,60,113
948,749,1,666,1631,3995,1011,938,2,763,1426,4140,60,114
899,817,11,807,1543,4077,963,919,14,1070,1416,4382,60,115
867,838,5,786,1524,4020,1128,823,6,898,1371,4226,60,116
597,1062,50,767,1442,3918,855,926,48,875,1440,4144,60,117
219,827,74,1176,1066,3362,369,831,137,1139,997,3473,60,118
165,506,14,1119,834,2638,277,514,35,1007,913,2746,60,119
710,611,3,670,1202,3196,886,564,7,756,1291,3504,60,120
980,664,8,1063,1703,4418,1391,619,7,1066,1438,4521,60,121
991,740,5,1087,1712,4535,1444,708,6,1090,1390,4638,60,122
908,842,9,1126,1539,4424,1276,681,11,1011,1554,4533,60,123
655,900,61,876,1543,4035,927,1015,73,918,1339,4272,60,124
174,680,47,1117,976,2994,357,799,31,989,968,3144,60,125
154,507,8,1198,993,2860,261,510,6,1248,910,2935,60,126
737,588,8,681,1226,3240,989,511,6,806,1172,3484,60,127
912,773,10,1082,2221,4998,1545,871,8,1241,1524,5189,60,128
892,798,8,1104,2156,4958,1432,1002,14,1370,1435,5253,60,129
885,789,19,733,1364,3790,998,655,15,820,1424,3912,60,130
650,761,53,853,1233,3550,687,777,41,899,1402,3806,60,131
219,719,55,1196,934,3123,447,670,49,1025,1147,3338,60,132
124,424,13,990,680,2231,225,464,16,930,846,2481,60,133
752,591,7,659,1173,3182,835,586,8,775,1297,3501,60,134
999,834,16,724,1405,3978,950,722,15,872,1632,4191,60,135
1022,816,10,798,1452,4098,1019,727,23,809,1465,4043,60,136
950,917,16,815,1512,4210,1129,768,11,876,1477,4261,60,137
669,857,62,902,1420,3910,888,740,37,984,1421,4070,60,138
187,810,85,1151,1289,3522,509,716,66,1243,1051,3585,60,139
146,578,9,1057,1110,2900,500,457,6,1256,904,3123,60,140
751,606,14,865,1750,3986,1157,719,13,994,1325,4208,60,141
966,815,6,1039,1890,4716,1335,873,3,1002,1566,4779,60,142
984,761,6,886,1462,4099,1047,685,9,897,1629,4267,60,143
914,708,13,832,1394,3861,1055,687,8,865,1351,3966,60,144
612,737,91,925,1410,3775,736,990,49,920,1278,3973,60,145
193,788,74,1167,1210,3432,270,1030,48,1169,1097,3614,60,146
158,603,15,1167,835,2778,242,576,15,1062,1100,2995,60,147
150,304,1,860,539,1854,195,413,4,730,757,2099,60,148
805,591,15,651,1212,3274,851,550,15,726,1412,3554,60,149
917,604,11,775,1320,3627,946,637,12,853,1393,3841,60,150
838,841,4,774,1530,3987,1050,723,6,826,1487,4092,60,151
688,779,89,894,1494,3944,941,871,65,911,1263,4051,60,152
235,713,60,1080,913,3001,319,798,60,1096,1048,3321,60,153
202,435,9,998,730,2374,250,464,10,899,878,2501,60,154
855,599,9,765,1393,3621,903,746,9,841,1305,3804,60,155
928,696,12,744,1607,3987,1060,837,12,917,1529,4355,60,156
1097,805,20,1047,1723,4692,1489,658,16,1212,1584,4959,60,157
897,1008,12,989,2444,5350,1589,1170,13,1366,1561,5699,60,158
592,1072,65,1155,2514,5398,1885,1403,111,1510,1542,6451,60,159
242,1365,87,1802,1625,5121,558,1411,90,1783,1958,5800,60,160
201,560,19,1338,933,3051,224,650,25,1182,1125,3206,60,161
810,563,7,770,1150,3300,821,591,6,774,1252,3444,60,162
1022,793,14,851,1466,4146,1054,774,13,895,1553,4289,60,163
1038,795,9,1034,1737,4613,1233,1129,19,975,1398,4754,60,164
948,853,9,878,1428,4116,1020,755,4,998,1499,4276,60,165
642,867,47,980,1481,4017,746,1171,57,872,1286,4132,60,166
262,777,63,1198,1076,3376,299,984,43,1054,1212,3592,60,167
192,528,10,1138,763,2631,253,528,7,1052,958,2798,60,168
758,637,34,705,1165,3299,827,536,35,881,1321,3600,60,169
840,830,14,826,1695,4205,1102,934,26,990,1364,4416,60,170
379,716,5,1095,1413,3608,710,707,10,1120,1077,3624,60,171
770,754,2,953,1404,3883,1017,727,5,864,1389,4002,60,172
628,817,36,925,1143,3549,749,818,46,871,1263,3747,60,173
245,943,65,1015,1015,3283,285,1123,58,1063,1022,3551,60,174
198,498,5,964,772,2437,278,472,7,1010,845,2612,60,175
750,640,5,767,1161,3323,794,557,14,837,1174,3376,60,176
903,711,8,852,1439,3913,1036,667,8,1001,1481,4193,60,177
896,975,26,1485,2663,6045,2356,661,19,1802,1534,6372,60,178
878,930,9,1554,2198,5569,1951,893,5,1829,1848,6526,60,179
792,811,62,1006,1282,3953,705,866,55,1103,1445,4174,60,180
303,807,90,1259,1124,3583,300,1076,79,1155,1187,3797,60,181
241,494,17,1495,813,3060,277,701,15,958,1117,3068,60,182
789,663,11,1324,1406,4193,734,891,9,789,1358,3781,60,183
1035,689,12,872,1344,3952,841,815,11,919,1437,4023,60,184
739,802,15,966,1462,3984,796,1021,18,1019,1411,4265,60,185
264,1288,18,1408,984,3962,256,1190,31,1325,1328,4130,60,186
452,785,87,1144,1176,3644,497,922,77,925,1160,3581,60,187
235,702,49,1081,824,2891,301,708,28,950,925,2912,60,188
198,469,12,998,639,2316,260,419,10,822,853,2364,60,189
605,483,7,683,1047,2825,702,560,11,656,1108,3037,60,190
600,5,1,195,6,807,658,5,1,235,6,905,60,191
5,7,8,18,6,44,5,7,7,18,6,43,60,192
4,9,3,16,13,45,4,9,3,25,11,52,60,193
382,890,52,632,1020,2976,559,780,38,770,1130,3277,60,194
195,788,48,1115,1042,3188,310,953,42,1067,1090,3462,60,195
174,540,27,1074,828,2643,259,506,27,1006,932,2730,60,196
699,554,6,699,1074,3032,801,502,18,694,1078,3093,60,197
856,610,26,747,1366,3605,927,778,24,812,1327,3868,60,198
948,599,38,901,1277,3763,918,556,34,876,1464,3848,60,199
816,709,4,870,1318,3717,862,718,6,850,1393,3829,60,200
584,893,72,808,1719,4076,634,1217,265,942,1169,4227,60,201
218,780,70,1108,1227,3403,311,1051,49,1224,1120,3755,60,202
167,615,15,1100,778,2675,247,529,7,1085,1082,2950,60,203
700,512,4,727,1051,2994,737,534,3,795,1098,3167,60,204
852,760,5,832,1510,3959,1012,873,4,854,1427,4170,60,205
838,721,27,837,1584,4007,963,939,28,887,1579,4396,60,206
809,741,27,927,1198,3702,877,765,25,899,1433,3999,60,207
614,956,53,869,1291,3783,673,843,68,1006,1311,3901,60,208
258,953,92,1100,922,3325,302,831,96,1276,1102,3607,60,209
243,488,7,1123,756,2617,212,573,22,1093,891,2791,60,210
665,569,14,796,1209,3253,648,841,26,804,1258,3577,60,211
844,632,22,740,1173,3411,852,596,15,763,1329,3555,60,212
849,743,27,719,1297,3635,891,614,22,782,1420,3729,60,213
782,1097,39,902,1736,4556,917,995,30,1180,2159,5281,60,214
521,3579,208,960,2763,8031,1490,1158,54,4075,1907,8684,60,215
197,3703,433,1457,3692,9482,1140,878,46,6198,1773,10035,60,216
157,556,3,2643,2752,6111,762,414,4,3785,902,5867,60,217
610,480,11,877,1082,3060,718,619,16,752,1071,3176,60,218
768,649,5,676,1389,3487,901,715,4,781,1319,3720,60,219
754,620,29,805,1403,3611,1007,689,28,812,1284,3820,60,220
713,647,5,778,1294,3437,968,537,5,795,1233,3538,60,221
419,804,42,843,1101,3209,656,779,51,720,1022,3228,60,222
184,699,56,998,1046,2983,266,996,39,1009,954,3264,60,223
162,408,8,1026,620,2224,211,446,3,876,829,2365,60,224
615,548,15,655,1042,2875,708,523,8,741,1038,3018,60,225
743,712,14,660,1237,3366,906,601,15,810,1317,3649,60,226
784,729,23,804,1267,3607,895,682,23,813,1341,3754,60,227
693,708,9,792,1318,3520,858,708,15,960,1345,3886,60,228
463,797,61,878,1198,3397,634,774,34,825,1236,3503,60,229
166,724,62,1084,975,3011,272,692,54,1201,1025,3244,60,230
163,414,15,1007,895,2494,201,432,17,1079,938,2667,60,231
762,478,14,636,964,2854,619,487,14,762,1153,3035,60,232
775,611,28,635,1224,3273,871,715,26,759,1214,3585,60,233
733,740,18,721,1367,3579,803,794,26,804,1299,3726,60,234
722,679,6,775,1293,3475,816,618,8,751,1374,3567,60,235
273,714,59,1003,1224,3273,290,783,43,958,1264,3338,60,236
215,2184,86,2928,5326,10739,1832,890,48,7090,2301,12161,60,237
189,458,11,1013,700,2371,182,498,20,969,911,2580,60,238
789,437,0,638,1304,3168,816,748,3,720,1177,3464,60,239
933,630,6,720,1648,3937,970,859,4,846,1405,4084,60,240
952,780,2,901,1632,4267,1008,1033,5,1085,1432,4563,60,241
840,1106,23,896,1575,4440,1108,617,22,1401,1709,4857,60,242
564,1501,121,983,1589,4758,862,975,75,1609,1638,5159,60,243
195,1405,146,1192,1058,3996,340,919,45,1766,1246,4316,60,244
182,596,9,1492,878,3157,298,569,9,1194,1087,3157,60,245
122,345,4,855,571,1897,156,433,3,883,786,2261,60,246
845,550,11,634,1181,3221,902,601,4,808,1393,3708,60,247
910,547,10,798,1359,3624,1198,641,4,799,1342,3984,60,248
877,663,22,790,1470,3822,1100,629,7,706,1365,3807,60,249
660,882,93,824,1226,3685,772,780,65,809,1458,3884,60,250
159,879,104,1223,1130,3495,274,1098,85,1282,1238,3977,60,251
175,461,6,1040,755,2437,230,472,6,1057,763,2528,60,252
865,567,11,638,1251,3332,839,574,10,953,1331,3707,60,253
1022,804,9,703,1529,4067,1065,797,8,857,1349,4076,60,254
1002,924,5,913,1938,4782,1287,839,5,1379,1474,4984,60,255
959,1011,17,909,2210,5106,1306,882,15,1402,1627,5232,60,256
687,952,98,946,1918,4601,1086,1041,54,1262,1480,4923,60,257
216,925,114,1280,1119,3654,314,1018,60,1222,1232,3846,60,258
170,463,7,1086,719,2445,250,444,10,1069,994,2767,60,259
833,593,10,695,1244,3375,928,594,9,811,1238,3580,60,260
1026,729,5,695,1605,4060,1125,725,7,810,1667,4334,60,261
1076,841,16,757,1544,4234,1212,760,9,1007,1494,4482,60,262
1001,1181,11,839,1711,4743,1442,742,5,1122,1632,4943,60,263
738,893,100,1038,1647,4416,1136,915,76,1173,1453,4753,60,264
228,816,84,1316,1045,3489,295,1052,78,1216,1203,3844,60,265
148,457,11,950,773,2339,212,463,11,967,755,2408,60,266
818,527,9,672,1216,3242,905,555,8,744,1236,3448,60,267
1023,633,21,650,1460,3787,1112,673,14,767,1523,4089,60,268
1026,699,26,753,1509,4013,1102,804,16,878,1519,4319,60,269
943,715,14,879,1367,3918,1056,661,18,901,1525,4161,60,270
723,810,82,747,1448,3810,860,968,52,905,1391,4176,60,271
232,965,127,1216,1110,3650,309,1300,63,1192,1315,4179,60,272
149,516,9,1168,926,2768,358,499,6,1238,933,3034,60,273
820,688,8,729,1346,3591,1001,555,11,902,1338,3807,60,274
1077,712,13,771,1572,4145,1170,657,7,862,1502,4198,60,275
1058,743,20,924,1417,4162,1188,620,13,875,1493,4189,60,276
909,721,23,772,1408,3833,1060,668,18,856,1444,4046,60,277
655,881,73,818,1164,3591,837,855,56,961,1438,4147,60,278
233,807,73,1425,1224,3762,326,853,62,1710,1389,4340,60,279
149,511,7,1107,1067,2841,395,429,7,1293,1046,3170,60,280
838,672,4,752,1663,3929,1221,623,7,1038,1375,4264,60,281
1035,784,12,951,1802,4584,1379,652,8,1189,1562,4790,60,282
1112,830,8,1174,1580,4704,1294,725,4,942,1488,4453,60,283
865,809,5,852,1510,4041,1042,840,5,960,1543,4390,60,284
586,928,58,1145,1441,4158,887,883,66,1157,1412,4405,60,285
273,877,69,1334,1175,3728,448,926,33,1316,1420,4143,60,286
405,769,9,1407,1213,3803,370,600,6,1915,1265,4156,60,287
405,840,10,1618,3338,6211,2700,524,9,2273,1181,6687,60,288
989,1151,4,2380,4595,9119,4178,676,4,2989,1775,9622,60,289
1069,1104,16,2681,3258,8128,3333,728,15,2453,1948,8477,60,290
955,927,22,934,1575,4413,1159,745,31,997,1628,4560,60,291
705,937,150,956,1435,4183,877,958,347,957,1734,4873,60,292
240,956,132,1578,983,3889,307,1270,114,1181,1288,4160,60,293
183,511,9,1095,848,2646,233,669,6,1145,879,2932,60,294
876,596,11,700,1291,3474,904,623,6,768,1394,3695,60,295
1145,731,5,770,1538,4189,1089,678,5,926,1620,4318,60,296
1092,823,5,833,1277,4030,1139,772,8,1000,1296,4215,60,297
1020,886,4,826,1513,4249,1160,745,5,863,1694,4467,60,298
775,944,67,1029,1380,4195,910,946,51,914,1522,4343,60,299
234,887,82,1406,1094,3703,330,826,80,1349,1277,3862,60,300
543,514,3,1283,977,3320,375,574,8,1328,1013,3298,60,301
870,583,5,781,1400,3639,1083,520,8,838,1309,3758,60,302
961,741,9,772,1633,4116,1182,735,11,884,1472,4284,60,303
1033,796,6,839,1649,4323,1171,684,10,999,1603,4467,60,304
911,666,17,803,1513,3910,1052,756,16,885,1505,4214,60,305
643,839,86,817,1182,3567,727,905,61,916,1385,3994,60,306
232,777,104,1237,950,3300,317,829,48,1065,1155,3414,60,307
205,413,2,1153,740,2513,267,410,7,1070,947,2701,60,308
790,478,7,843,1087,3205,819,501,7,828,1248,3403,60,309
825,664,25,750,1093,3357,786,616,43,903,1354,3702,60,310
885,641,6,893,1384,3809,1066,562,7,963,1475,4073,60,311
926,709,12,849,1445,3941,1083,638,14,837,1503,4075,60,312
671,746,55,801,1206,3479,768,754,73,913,1421,3929,60,313
236,725,68,1163,867,3059,290,716,62,1157,1084,3309,60,314
195,502,12,1213,746,2668,238,423,10,1097,1264,3032,60,315
377,442,29,770,830,2448,512,511,33,764,1000,2820,60,316
1067,585,73,729,1500,3954,1169,656,76,838,1624,4363,60,317
1138,696,3,790,1460,4087,1134,672,19,880,1717,4422,60,318
1069,764,28,834,1634,4329,1177,731,19,948,1638,4513,60,319
767,920,72,923,1484,4166,968,748,47,1007,1495,4265,60,320
203,858,113,1384,1254,3812,506,770,71,1262,1397,4006,60,321
165,533,17,1207,1012,2934,389,437,14,1228,987,3055,60,322
859,634,2,827,1530,3852,1139,583,9,946,1381,4058,60,323
1125,618,2,911,1513,4169,1217,629,6,885,1601,4338,60,324
1051,766,9,772,1368,3966,1052,720,10,844,1617,4243,60,325
1050,762,19,792,1472,4095,1034,732,12,1032,1674,4484,60,326
735,712,84,815,1286,3632,804,768,36,977,1421,4006,60,327
229,813,75,1143,950,3210,260,669,55,1242,1205,3431,60,328
206,417,9,1083,842,2557,218,375,12,1136,840,2581,60,329
768,419,7,720,1095,3009,714,471,8,688,1105,2986,60,330
716,543,11,814,1188,3272,735,473,8,721,1301,3238,60,331
504,426,1,1168,887,2986,605,365,4,1072,890,2936,60,332
107,220,2,567,318,1214,119,211,3,378,432,1143,60,333
228,445,31,753,596,2053,234,491,28,726,763,2242,60,334
145,488,42,699,578,1952,203,466,29,835,818,2351,60,335
126,344,2,716,537,1725,168,515,2,859,800,2344,60,336
745,437,10,619,1093,2904,807,561,11,728,1240,3347,60,337
962,686,48,623,1403,3722,1046,743,40,931,1667,4427,60,338
1025,696,19,779,1475,3994,1204,625,17,992,1513,4351,60,339
948,739,9,840,1591,4127,1080,722,7,949,1619,4377,60,340
717,872,64,829,1219,3701,783,796,66,914,1370,3929,60,341
177,949,122,1073,1103,3424,272,1076,70,1195,1260,3873,60,342
204,691,11,1078,1354,3338,343,661,8,1826,1644,4482,60,343
848,1244,6,1195,3504,6797,3269,659,5,2432,1673,8038,60,344
1033,1465,30,1435,3831,7794,3419,739,22,2874,2064,9118,60,345
1040,1504,20,1911,4076,8551,3518,831,13,3314,2015,9691,60,346
1026,1629,9,2070,3824,8558,3231,997,12,3254,2167,9661,60,347
749,1244,107,2556,3686,8342,2613,1057,69,2622,1868,8229,60,348
298,959,100,1442,1015,3814,295,1021,72,1219,1388,3995,60,349
194,503,20,1103,818,2638,200,466,25,1134,865,2690,60,350
782,519,11,700,1080,3092,806,525,9,716,1285,3341,60,351
967,641,14,809,1312,3743,963,605,12,852,1466,3898,60,352
986,710,12,889,1223,3820,904,619,6,864,1463,3856,60,353
821,674,38,766,1228,3527,854,626,41,765,1364,3650,60,354
553,700,57,841,1035,3186,606,650,43,838,1222,3359,60,355
192,493,46,1122,716,2569,214,500,32,989,832,2567,60,356
177,343,9,917,571,2017,144,365,9,735,745,1998,60,357
372,396,21,792,831,2412,345,336,9,658,808,2156,60,358
258,279,8,691,493,1729,238,228,7,588,570,1631,60,359
81,122,2,284,237,726,62,199,3,286,340,890,60,360
211,369,28,649,618,1875,335,457,14,658,806,2270,60,361
290,470,34,749,753,2296,382,496,28,727,910,2543,60,362
165,453,53,795,541,2007,173,487,32,774,756,2222,60,363
138,338,16,896,592,1980,193,380,15,808,762,2158,60,364
398,462,23,956,816,2655,400,492,17,791,1119,2819,60,365
322,640,358,971,666,2957,355,733,287,838,959,3172,60,366
91,309,2,741,563,1706,154,305,3,555,666,1683,61,1
1064,434,5,909,1911,4323,1516,506,7,813,1549,4391,61,2
1472,554,9,956,2515,5506,1977,712,16,983,2006,5694,61,3
1471,567,5,992,2162,5197,1697,586,6,927,2043,5259,61,4
973,695,50,1053,1798,4569,1085,826,40,913,1622,4486,61,5
149,500,44,1032,708,2433,223,641,46,910,813,2633,61,6
170,394,1,1420,910,2895,194,515,5,1170,1048,2932,61,7
1492,526,3,1023,2152,5196,1680,727,5,915,1893,5220,61,8
1816,345,5,1382,1746,5294,1878,379,3,1014,2024,5298,61,9
1977,771,16,1344,2738,6846,2132,922,14,1375,2272,6715,61,10
1751,757,6,1268,2798,6580,2061,962,14,1184,2141,6362,61,11
1015,715,48,1097,1557,4432,1132,744,61,1011,1503,4451,61,12
196,821,56,1779,1197,4049,233,905,86,1203,1633,4060,61,13
152,524,4,1227,824,2731,198,501,8,1011,1070,2788,61,14
223,446,11,1182,757,2619,297,519,11,880,960,2667,61,15
756,418,6,684,1019,2883,681,569,8,649,991,2898,61,16
1704,561,14,1070,2202,5551,1771,739,11,1021,2098,5640,61,17
1813,838,17,1136,2703,6507,2016,1162,25,1073,2273,6549,61,18
750,842,72,925,1273,3862,715,907,91,842,1282,3837,61,19
205,891,91,1590,1198,3975,264,951,97,1248,1291,3851,61,20
186,433,7,1333,895,2854,189,513,6,1092,1059,2859,61,21
1448,503,1,954,2024,4930,1621,638,0,895,1850,5004,61,22
2100,774,7,1183,2975,7039,2324,1023,9,1118,2503,6977,61,23
2129,887,7,1312,3199,7534,2492,1141,9,1264,2406,7312,61,24
1975,1056,8,1281,3018,7338,2240,1207,17,1281,2395,7140,61,25
1148,1224,128,1330,2290,6120,1341,1223,141,1222,1991,5918,61,26
292,1054,64,1834,1616,4860,315,1071,82,1573,1710,4751,61,27
208,607,5,1505,1078,3403,248,514,13,1315,1233,3323,61,28
1619,661,12,1118,2265,5675,1715,746,17,1105,2103,5686,61,29
2118,920,10,1231,2987,7266,2512,929,15,1086,2727,7269,61,30
2080,883,10,1410,3238,7621,2541,1040,15,1303,2441,7340,61,31
1973,942,9,1315,2884,7123,2107,1003,15,1213,2367,6705,61,32
1188,1112,110,1256,2348,6014,1339,1159,115,1066,1962,5641,61,33
239,1113,80,1529,1375,4336,297,880,62,1160,1511,3910,61,34
199,492,3,1351,963,3008,231,482,8,1109,991,2821,61,35
1603,748,8,1153,2298,5810,1774,724,8,1029,2054,5589,61,36
2129,863,31,1228,3224,7475,2512,1011,30,1196,2450,7199,61,37
2059,906,41,1341,3290,7637,2480,1061,39,1323,2416,7319,61,38
1909,1061,39,1284,2816,7109,2213,1024,28,1133,2374,6772,61,39
1264,1242,87,1301,2189,6083,1333,1116,89,1252,2044,5834,61,40
304,1289,90,1664,1674,5021,310,1273,91,1507,1618,4799,61,41
226,1165,19,1342,1159,3911,235,625,37,1121,1754,3772,61,42
1483,644,30,1033,2243,5433,1716,688,35,1038,1940,5417,61,43
2044,933,38,1233,2832,7080,2254,1025,31,1147,2480,6937,61,44
1983,1052,9,1321,3272,7637,2385,1121,12,1344,2640,7502,61,45
1888,954,22,1341,2850,7055,2142,1037,44,1229,2348,6800,61,46
1099,1045,73,1554,2036,5807,1267,1109,62,1347,1813,5598,61,47
426,937,74,1845,1355,4637,296,1131,88,1383,1534,4432,61,48
364,639,8,1928,1219,4158,264,878,27,1395,1416,3980,61,49
813,565,19,1467,1164,4028,550,612,23,1244,1364,3793,61,50
2095,782,34,1287,3202,7400,2405,1149,48,1247,2478,7327,61,51
2092,913,32,1392,3222,7651,2628,998,31,1272,2580,7509,61,52
1991,1057,28,1360,2995,7431,2232,1192,31,1266,2501,7222,61,53
1305,1179,80,1438,2151,6153,1409,1053,109,1252,1941,5764,61,54
351,4220,178,1606,1668,8023,306,1979,136,1706,3578,7705,61,55
255,460,18,1366,1049,3148,268,625,26,1144,1083,3146,61,56
1651,692,24,1167,2647,6181,1811,964,25,1021,2129,5950,61,57
2132,857,35,1228,3008,7260,2567,945,56,1185,2521,7274,61,58
2154,869,51,1240,3077,7391,2656,957,56,1203,2310,7182,61,59
2094,974,35,1326,2530,6959,2028,1053,42,1177,2356,6656,61,60
1249,1067,73,1352,2276,6017,1362,1219,72,1273,2002,5928,61,61
213,1074,101,1601,1375,4364,315,1041,108,1220,1437,4121,61,62
208,533,34,1745,1213,3733,282,525,52,1424,1328,3611,61,63
1588,636,4,1136,2451,5815,1830,780,4,1057,2015,5686,61,64
2128,891,30,1273,3184,7506,2620,962,23,1146,2520,7271,61,65
2054,854,14,1331,3343,7596,2618,1056,23,1337,2425,7459,61,66
1915,1059,8,1350,3224,7556,2482,1187,27,1276,2371,7343,61,67
1259,1202,138,1384,2392,6375,1425,1277,135,1232,2054,6123,61,68
347,947,81,1721,1319,4415,357,1055,93,1423,1543,4471,61,69
232,620,30,1525,1098,3505,269,761,36,1158,1373,3597,61,70
1550,1171,4,1217,2433,6375,1858,874,4,1140,2430,6306,61,71
2116,997,33,1485,3254,7885,2565,1173,42,1414,2608,7802,61,72
2070,1165,20,1660,3464,8379,2565,1355,22,1575,2646,8163,61,73
1821,1405,26,1625,3444,8321,2366,1406,105,1495,2730,8102,61,74
1199,1281,87,1613,2431,6611,1360,1189,164,1343,2350,6406,61,75
645,1973,156,2485,5588,10847,441,1613,166,5272,2198,9690,61,76
348,697,20,1539,1399,4003,271,946,32,1326,1330,3905,61,77
1620,701,5,1274,2578,6178,1939,826,9,1124,2173,6071,61,78
2155,910,12,1400,3386,7863,2744,1068,13,1233,2578,7636,61,79
2102,1552,4,1460,3528,8646,2638,1359,10,1497,2912,8416,61,80
1937,1143,13,1442,3418,7953,2455,1337,23,1484,2504,7803,61,81
1231,1349,112,1536,2738,6966,1471,1557,121,1442,2341,6932,61,82
200,3886,122,1702,1619,7529,321,1873,110,1339,3705,7348,61,83
292,720,3,2101,1392,4508,284,844,6,1495,1811,4440,61,84
1696,880,3,1423,2822,6824,1814,1345,21,1288,2389,6857,61,85
2183,985,28,2136,3936,9268,2752,1395,21,2095,2881,9144,61,86
2091,870,5,1770,3161,7897,2548,1118,16,1398,2597,7677,61,87
1835,1164,29,1707,3172,7907,2197,1318,44,1396,2720,7675,61,88
1254,1479,117,1817,2624,7291,1384,1457,119,1540,2412,6912,61,89
358,4787,132,2296,1927,9500,343,2297,64,1848,4571,9123,61,90
280,653,3,1684,3069,5689,357,784,8,2923,1378,5450,61,91
1511,9218,15,1534,7660,19938,1834,1046,16,7597,9623,20116,61,92
2181,893,8,1696,3368,8146,2639,1198,11,1399,2819,8066,61,93
2218,4462,11,1543,3220,11454,2593,1548,11,1557,5589,11298,61,94
2075,3638,11,1769,4188,11681,2379,1391,21,2423,5041,11255,61,95
1183,8221,203,1770,2554,13931,1460,2343,114,1809,8505,14231,61,96
523,8832,163,2596,10364,22478,407,2113,92,7317,12310,22239,61,97
562,3393,5,2011,9179,15150,538,877,7,10490,2875,14787,61,98
1545,825,17,1408,2410,6205,1761,874,25,1237,2167,6064,61,99
2106,1117,6,1466,3330,8025,2631,1130,19,1366,2748,7894,61,100
2107,1148,19,1467,3446,8187,2621,1150,21,1437,2810,8039,61,101
1987,1088,7,1404,3234,7720,2591,1170,10,1286,2508,7565,61,102
1250,1219,90,1548,2469,6576,1510,1288,92,1367,2049,6306,61,103
358,6674,289,2337,3075,12733,402,2536,95,3357,6172,12562,61,104
287,815,12,1803,1286,4203,286,760,16,1565,1420,4047,61,105
1441,873,15,1399,2618,6346,1791,1083,16,1293,2055,6238,61,106
1923,1267,16,1382,2891,7479,2337,1111,15,1188,2676,7327,61,107
1963,1000,13,1537,2950,7463,2615,1104,16,1446,2369,7550,61,108
1837,1245,28,1627,3180,7917,2469,1337,31,1429,2465,7731,61,109
1160,8947,285,1557,2327,14276,1449,2986,88,1672,9134,15329,61,110
312,10446,196,1948,9508,22410,442,1561,128,9920,10569,22620,61,111
197,729,3,1598,6891,9418,430,668,7,6855,1203,9163,61,112
1541,788,36,1205,2453,6023,1816,844,36,1092,2079,5867,61,113
2047,9846,23,1326,3221,16463,2597,1799,28,1525,10871,16820,61,114
2049,9746,31,1466,3273,16565,2652,2103,32,1635,10522,16944,61,115
2038,4970,21,1737,6906,15672,2532,1269,27,3562,8165,15555,61,116
1291,4319,170,1478,2573,9831,1530,2322,107,1406,4168,9533,61,117
322,4612,197,2005,1397,8533,445,2002,111,1681,3862,8101,61,118
285,991,8,2441,3646,7371,548,1054,23,4007,1409,7041,61,119
1576,887,9,1282,2573,6327,1983,861,12,1221,2174,6251,61,120
2119,1046,8,1303,3235,7711,2697,1051,10,1361,2550,7669,61,121
2005,1104,7,1491,3514,8121,2727,1125,19,1435,2690,7996,61,122
1917,1118,11,1488,3160,7694,2443,1167,16,1390,2496,7512,61,123
1242,8938,282,1493,2416,14371,1474,2689,111,1749,8777,14800,61,124
330,7244,171,1913,3719,13377,383,1837,84,3906,6879,13089,61,125
241,2603,7,1844,5289,9984,432,685,11,6205,2200,9533,61,126
1534,834,7,1168,2570,6113,1915,832,10,1130,2158,6045,61,127
2123,10646,38,1388,3242,17437,2750,2490,45,1687,11483,18455,61,128
2093,12264,29,1483,3398,19267,2737,2551,35,1771,13062,20156,61,129
1920,1144,5,1449,3282,7800,2454,1157,8,1449,2528,7596,61,130
1284,1334,103,1487,2230,6438,1528,1131,89,1348,2332,6428,61,131
361,1378,88,1908,1598,5333,417,1118,70,1548,2182,5335,61,132
243,721,6,1941,2213,5124,417,689,12,2464,1214,4796,61,133
1510,904,7,1183,2589,6193,1913,979,18,1169,2143,6222,61,134
2046,923,4,1405,3403,7781,2780,1030,14,1392,2596,7812,61,135
2094,3469,7,1362,3363,10295,2647,1781,15,1454,4257,10154,61,136
1889,1381,10,1426,3245,7951,2445,1346,24,1468,2554,7837,61,137
1245,1309,113,1594,2299,6560,1522,1173,108,1452,2224,6479,61,138
275,3496,166,1818,1340,7095,353,1674,98,1524,3397,7046,61,139
319,918,25,1857,1336,4455,380,839,21,1587,1576,4403,61,140
1702,5815,11,1221,2709,11458,1973,1568,13,1475,6501,11530,61,141
2238,7481,11,1383,3350,14463,2758,2044,12,1615,8183,14612,61,142
2091,1353,16,1996,8590,14046,2918,1158,21,6544,2710,13351,61,143
1862,1163,4,1431,3107,7567,2414,1037,16,1459,2353,7279,61,144
1076,11199,294,1693,2016,16278,1431,3055,90,1851,10270,16697,61,145
356,9176,162,1868,7577,19139,476,2272,81,5876,10832,19537,61,146
308,1518,13,1885,9171,12895,479,1032,17,9602,1646,12776,61,147
221,627,10,1299,910,3067,262,591,16,1077,1127,3073,61,148
1870,906,6,1300,3101,7183,2459,878,14,1272,2487,7110,61,149
2024,1037,9,1364,3223,7657,2673,976,12,1452,2545,7658,61,150
1974,1253,9,1423,3285,7944,2491,1128,16,1600,2509,7744,61,151
1258,1622,134,1414,2459,6887,1490,1428,135,1453,2373,6879,61,152
339,4662,169,1767,1698,8635,374,2114,131,1955,3994,8568,61,153
274,987,5,1798,3173,6237,437,690,7,3344,1538,6016,61,154
1644,6620,4,1257,2813,12338,2258,1555,7,1405,7288,12513,61,155
2152,7654,4,1413,3629,14852,2948,1894,11,1655,8497,15005,61,156
2183,4108,4,1428,4103,11826,2918,1081,7,2518,5263,11787,61,157
2059,11028,8,1450,3418,17963,2590,2593,19,1736,11361,18299,61,158
1381,15788,845,1640,2580,22234,1475,6081,107,1832,13998,23493,61,159
412,7771,207,2432,8104,18926,380,2420,194,6012,10500,19506,61,160
365,1097,8,1896,9646,13012,471,950,14,9717,1533,12685,61,161
1645,960,6,1301,2700,6612,2006,948,10,1240,2248,6452,61,162
2144,1295,4,1455,3463,8361,2901,1166,9,1420,2738,8234,61,163
2071,9527,10,1493,3598,16699,2846,2807,10,1868,7835,15366,61,164
1896,1581,24,1496,3359,8356,2610,1381,23,1422,2747,8183,61,165
1236,9027,239,1632,2485,14619,1570,2745,111,1915,8908,15249,61,166
338,8879,260,1821,7383,18681,404,2471,110,4541,11110,18636,61,167
308,869,12,1867,7681,10737,535,801,24,7766,1319,10445,61,168
1516,1030,5,1214,2705,6470,2087,1009,12,1238,2221,6567,61,169
2015,9698,16,1761,2965,16455,2627,2426,28,1832,10485,17398,61,170
683,5664,7,1743,2560,10657,689,1842,10,3290,6333,12164,61,171
1794,1619,3,1990,8258,13664,2592,1327,9,6653,2522,13103,61,172
1129,1681,150,1585,2361,6906,1534,1641,145,1341,2253,6914,61,173
293,4476,194,1726,1517,8206,367,2192,151,1716,3563,7989,61,174
256,801,16,1505,1140,3718,298,698,24,1405,1294,3719,61,175
1569,994,9,1321,2589,6482,2069,942,13,1285,2199,6508,61,176
2091,1358,16,1496,3509,8470,2944,1233,20,1388,2882,8467,61,177
2102,1247,25,1622,3474,8470,2769,1220,25,1529,2743,8286,61,178
1891,1619,38,1627,3366,8541,2574,1437,42,1567,2648,8268,61,179
1183,1766,140,1680,2613,7382,1570,1546,108,1630,2381,7235,61,180
301,5342,240,1821,1566,9270,359,2062,106,1800,4877,9204,61,181
217,760,17,1443,1161,3598,319,634,21,1301,1277,3552,61,182
1532,9175,10,1399,2640,14756,2019,1713,18,1597,9630,14977,61,183
1853,7289,7,1613,3339,14101,2606,1811,11,1781,8089,14298,61,184
1516,13359,9,2077,2423,19384,1977,4037,22,1917,13679,21632,61,185
368,2887,30,11827,3638,18750,1160,2793,54,13586,2394,19987,61,186
721,9037,215,1911,1740,13624,978,2132,83,1771,8699,13663,61,187
323,5898,117,1781,3254,11373,389,1167,101,3563,6122,11342,61,188
296,733,25,1610,5687,8351,463,752,33,5644,1324,8216,61,189
1568,1920,14,1339,5828,10669,1966,896,19,2481,5238,10600,61,190
2109,1103,4,1552,2980,7748,2439,1121,5,1470,2569,7604,61,191
2027,1200,16,1433,3102,7778,2385,1101,15,1400,2903,7804,61,192
1821,1438,15,1537,3023,7834,2260,1202,15,1496,2694,7667,61,193
1182,4462,125,1591,2471,9831,1527,1251,86,1639,5033,9536,61,194
333,15085,233,1845,1641,19137,360,2522,123,3292,13602,19899,61,195
308,819,14,1602,1307,4050,294,771,20,1539,1274,3898,61,196
1565,913,6,1180,2548,6212,2004,884,5,1192,2084,6169,61,197
2020,5277,9,1365,3204,11875,2727,1679,9,1481,5825,11721,61,198
2012,1063,12,1482,3351,7920,2651,827,12,1406,2921,7817,61,199
1810,1971,15,1474,3171,8441,2365,1608,11,1540,3000,8524,61,200
1162,16222,1176,1450,2363,22373,1410,6169,95,1659,14150,23483,61,201
369,14450,433,1920,1592,18764,355,3216,116,2119,13588,19394,61,202
301,836,15,1875,7331,10358,453,812,16,7437,1403,10121,61,203
1546,793,10,1232,2476,6057,1867,761,11,1132,2065,5836,61,204
1961,7586,13,1420,3385,14365,2656,1728,15,1649,8542,14590,61,205
1928,9129,23,1644,3421,16145,2481,2036,26,1826,10127,16496,61,206
1814,1401,45,2425,7337,13022,2811,1251,59,5678,2609,12408,61,207
1165,1703,126,1552,2423,6969,1400,1475,153,1503,2366,6897,61,208
247,4375,533,1798,1739,8692,360,1757,189,2469,2827,7602,61,209
281,3373,34,1671,1367,6726,368,953,35,2093,2590,6039,61,210
1513,12504,34,1365,2710,18126,2018,2205,28,2063,12939,19253,61,211
2061,1133,20,1476,3415,8105,2730,958,25,1341,2692,7746,61,212
1978,1159,4,1393,3368,7902,2563,1071,10,1479,2731,7854,61,213
1760,1327,12,1569,3199,7867,2418,1217,10,1477,2567,7689,61,214
1219,7826,239,1595,2385,13264,1424,2597,86,1757,7477,13341,61,215
362,2991,98,1892,9886,15229,410,945,81,6893,6657,14986,61,216
295,706,10,1726,5307,8044,504,731,20,5299,1275,7829,61,217
1462,4516,10,1266,2497,9751,1837,1256,8,1470,5181,9752,61,218
1947,6079,4,1415,3259,12704,2578,1516,6,1562,7056,12718,61,219
1894,4455,13,1481,3390,11233,2549,1457,18,1654,5412,11090,61,220
1665,973,7,1703,4266,8614,2556,1013,8,2539,2184,8300,61,221
1000,7420,379,1225,1872,11896,1190,3161,100,1359,6188,11998,61,222
313,8356,331,2054,1685,12739,383,2090,89,2318,7710,12590,61,223
262,688,8,5440,3648,10046,752,718,15,7065,1165,9715,61,224
1392,842,10,1210,2367,5821,1790,888,9,1122,1941,5750,61,225
1831,1465,18,1346,3120,7780,2503,1280,24,1303,2561,7671,61,226
1822,1166,14,1474,3249,7725,2476,1073,14,1431,2593,7587,61,227
1660,1180,17,1423,3024,7304,2167,1148,23,1344,2312,6994,61,228
1056,1579,120,1426,2202,6383,1415,1400,85,1351,2013,6264,61,229
280,1437,146,1796,1432,5091,363,1240,131,1488,1802,5024,61,230
210,688,3,1452,4178,6531,277,635,5,4172,1138,6227,61,231
1373,750,3,1229,2297,5652,1700,731,4,1095,1922,5452,61,232
1891,5796,12,1384,3130,12213,2477,1665,13,1504,6622,12281,61,233
1801,5571,13,1355,3128,11868,2292,1591,17,1561,6495,11956,61,234
1701,1160,4,1601,6230,10696,2219,1106,7,4550,2418,10300,61,235
1099,1417,97,1483,2311,6407,1302,1311,100,1317,2195,6225,61,236
388,6708,265,1960,1708,11029,330,2294,136,1874,5995,10629,61,237
214,1067,10,2144,3689,7124,411,648,19,4083,1535,6696,61,238
1680,10151,17,1326,2441,15615,1813,1539,19,1519,11302,16192,61,239
2066,11073,6,1456,3073,17674,2501,1885,16,1696,12860,18958,61,240
2055,9612,13,1495,3159,16334,2441,1896,13,1640,10702,16692,61,241
1962,966,22,1554,2934,7438,2204,1048,26,1336,2457,7071,61,242
1111,9608,556,1617,1887,14779,1155,3043,106,1512,9368,15184,61,243
326,6325,76,1809,5687,14223,368,1105,88,4727,8133,14421,61,244
295,1131,6,1922,10050,13404,470,893,11,9984,1585,12943,61,245
244,793,2,1359,1115,3513,331,739,2,1200,1195,3467,61,246
1988,840,2,1240,2967,7037,2348,923,7,1280,2497,7055,61,247
2100,958,16,1402,3265,7741,2499,1072,13,1472,2518,7574,61,248
2009,1041,21,1364,2960,7395,2325,1125,35,1287,2392,7164,61,249
1316,1489,144,1377,2362,6688,1461,1328,115,1412,2194,6510,61,250
316,12436,818,2870,4128,20568,457,3952,115,5209,10825,20558,61,251
276,901,6,1786,1565,4534,319,688,14,1604,1656,4281,61,252
1755,923,6,1204,2375,6263,1909,1008,9,1006,2262,6194,61,253
2292,6173,15,1441,3151,13072,2515,1892,25,1522,7288,13242,61,254
2275,5712,6,1537,3288,12818,2617,1739,9,1557,6720,12642,61,255
2140,4983,17,1524,3291,11955,2476,1947,11,1569,5854,11857,61,256
1403,8177,295,1599,2669,14143,1525,2904,129,1741,8144,14443,61,257
343,8509,335,2064,7307,18558,405,2576,151,4805,10551,18488,61,258
305,877,5,1866,8414,11467,514,671,14,8429,1516,11144,61,259
1763,846,14,1195,2536,6354,1934,1000,22,1235,2361,6552,61,260
2375,964,20,1474,3458,8291,2815,1131,21,1275,2987,8229,61,261
2412,1272,10,1348,3305,8347,2688,1287,17,1388,2956,8336,61,262
2369,1435,23,1565,3308,8700,2565,1646,35,1498,2762,8506,61,263
1404,1489,147,1561,2517,7118,1532,1569,121,1533,2215,6970,61,264
361,9732,273,2014,2415,14795,625,1709,161,6794,4352,13641,61,265
253,992,6,1696,1232,4179,298,791,7,1496,1410,4002,61,266
1735,783,13,1298,2550,6379,1973,940,16,1241,2290,6460,61,267
2293,4606,8,1439,3446,11792,2747,1732,11,1488,6173,12151,61,268
2385,5425,12,1400,3428,12650,2691,1831,20,1520,6667,12729,61,269
2185,1291,5,1809,6926,12216,2705,1301,8,5048,2702,11764,61,270
1462,9699,314,1574,2324,15373,1461,3075,129,1633,9023,15321,61,271
378,12648,250,1982,7492,22750,390,2761,179,7103,13435,23868,61,272
276,1495,11,1729,7901,11412,321,713,11,7140,3266,11451,61,273
1823,774,8,1299,2593,6497,1960,955,10,1228,2328,6481,61,274
2466,1173,20,1419,3295,8373,2803,1215,27,1349,2936,8330,61,275
2255,961,10,1530,3409,8165,2611,1129,12,1495,2719,7966,61,276
1983,995,8,1543,3131,7660,2248,1280,18,1405,2574,7525,61,277
1447,1327,79,1551,2401,6805,1408,1374,88,1475,2328,6673,61,278
352,2015,183,1958,2167,6675,306,1575,95,1881,2580,6437,61,279
290,926,15,1704,1332,4267,304,767,17,1328,1727,4143,61,280
1897,831,7,1285,2684,6704,1955,1021,13,1185,2434,6608,61,281
2445,959,7,1499,3471,8381,2799,1163,9,1367,3047,8385,61,282
2371,1016,11,1600,3613,8611,2736,1272,18,1556,2773,8355,61,283
2101,1152,6,1654,3283,8196,2376,1403,11,1426,2753,7969,61,284
1252,1379,92,1976,2450,7149,1435,1458,115,1572,2230,6810,61,285
500,2918,156,2112,2004,7690,300,1827,117,1902,3364,7510,61,286
498,3508,10,1871,1667,7554,308,1003,16,2208,3775,7310,61,287
954,730,11,1485,1489,4669,679,989,13,1243,1970,4894,61,288
2543,997,18,1570,3580,8708,2514,1406,22,1554,3173,8669,61,289
2520,1112,23,1653,3491,8799,2677,1302,60,1538,2985,8562,61,290
2174,1190,11,1651,3589,8615,2440,1517,23,1428,2902,8310,61,291
1392,1520,128,1700,2653,7393,1471,1692,110,1529,2287,7089,61,292
336,5535,156,2244,2136,10407,354,1711,169,2177,5353,9764,61,293
244,4272,10,1700,1857,8083,305,819,13,2058,4404,7599,61,294
1769,816,4,1227,2803,6619,1915,1042,13,1264,2417,6651,61,295
2461,998,13,1497,3462,8431,2742,1252,20,1417,2898,8329,61,296
2448,1230,15,1451,3812,8956,2669,1571,14,1520,3070,8844,61,297
2253,1090,4,1581,3610,8538,2435,1517,13,1499,2845,8309,61,298
1608,1443,140,1615,2552,7358,1455,1644,169,1578,2372,7218,61,299
314,2014,138,2029,2200,6695,360,1882,187,2160,2214,6803,61,300
848,686,5,1967,1425,4931,335,948,10,1958,1658,4909,61,301
1892,760,4,1392,2592,6640,1999,1003,10,1239,2345,6596,61,302
2351,1092,7,1618,3960,9028,2626,2006,9,1512,2742,8895,61,303
2498,1246,15,1610,3459,8828,2650,1406,22,1539,2864,8481,61,304
2102,1348,6,1520,3109,8085,2186,1605,13,1342,2739,7885,61,305
1305,1216,87,1542,2384,6534,1335,1267,117,1414,2195,6328,61,306
315,2341,187,2113,2752,7708,323,1858,142,2665,2905,7893,61,307
326,580,4,1585,1266,3761,313,636,6,1510,1168,3633,61,308
1752,676,2,1285,2658,6373,2008,900,11,1169,2326,6414,61,309
1812,952,9,1566,2675,7014,2032,890,78,1538,2371,6909,61,310
1849,738,12,1363,3106,7068,2100,1103,15,1333,2455,7006,61,311
2065,927,17,1383,3123,7515,2343,1131,22,1421,2521,7438,61,312
1395,1362,126,1505,2367,6755,1353,1430,124,1416,2387,6710,61,313
315,1277,80,1938,1627,5237,309,1124,141,1595,1856,5025,61,314
281,685,6,1888,7969,10829,410,659,12,7129,1664,9874,61,315
850,581,12,1406,1427,4276,638,847,12,1107,1681,4285,61,316
2410,807,7,1435,3259,7918,2549,1028,18,1447,2885,7927,61,317
2360,1002,5,1531,3510,8408,2629,1288,6,1487,2819,8229,61,318
2350,1043,7,1512,3200,8112,2522,1219,13,1422,2930,8106,61,319
1398,1116,104,1547,2547,6712,1393,1198,91,1393,2347,6422,61,320
316,1254,105,2021,6875,10571,463,1197,137,5837,1888,9522,61,321
242,573,7,1476,1216,3514,279,729,9,1261,1320,3598,61,322
1897,759,5,1250,2643,6554,2003,937,9,1087,2450,6486,61,323
2424,837,9,1524,3357,8151,2694,1068,10,1433,2831,8036,61,324
2326,963,8,1457,3638,8392,2671,1182,20,1537,2913,8323,61,325
2202,915,4,1587,3392,8100,2417,1449,16,1369,2590,7841,61,326
1518,966,64,1471,2415,6434,1419,1200,109,1389,2028,6145,61,327
343,1086,65,1908,1642,5044,318,1325,105,1417,1789,4954,61,328
271,476,7,1632,1068,3454,240,579,11,1211,1188,3229,61,329
1470,788,8,1234,2320,5820,1630,708,22,1131,2171,5662,61,330
1479,694,11,1397,2582,6163,1808,869,13,1171,1971,5832,61,331
866,542,6,1745,1423,4582,1061,625,14,1148,1257,4105,61,332
206,172,4,733,381,1496,138,299,2,451,491,1381,61,333
348,533,21,1267,931,3100,473,653,40,904,1188,3258,61,334
196,635,42,1270,1139,3282,267,817,51,1071,1285,3491,61,335
173,485,5,1187,969,2819,236,788,6,1140,1132,3302,61,336
1655,508,9,1128,2347,5647,1840,777,13,1079,2147,5856,61,337
2327,880,11,1330,3557,8105,2742,1322,22,1356,2780,8222,61,338
2251,1110,9,1440,3566,8376,2634,1212,12,1382,3101,8341,61,339
2126,1099,13,1516,3789,8543,2595,1348,22,1542,2841,8348,61,340
1485,1133,88,1426,2424,6556,1428,1330,105,1298,2222,6383,61,341
269,1241,160,2166,2028,5864,301,1877,158,1555,1859,5750,61,342
205,642,10,1726,1338,3921,214,948,15,1267,1512,3956,61,343
1774,787,12,1194,2451,6218,1783,1036,12,1134,2447,6412,61,344
2397,1138,9,1524,3577,8645,2687,1276,16,1573,3021,8573,61,345
2333,1187,3,1445,3659,8627,2693,1287,8,1467,3052,8507,61,346
2339,1827,17,1731,3660,9574,2549,1971,32,1689,3288,9529,61,347
1556,1810,131,1889,2923,8309,1397,1932,135,1752,2947,8163,61,348
421,1450,128,2236,1989,6224,311,1770,130,1806,2133,6150,61,349
260,537,6,1761,1256,3820,243,902,6,1441,1211,3803,61,350
1716,729,6,1278,2644,6373,1867,868,16,1167,2443,6361,61,351
2240,999,5,1548,3472,8264,2677,1172,17,1430,2733,8029,61,352
1995,998,5,1402,3176,7576,2376,1108,17,1338,2552,7391,61,353
1815,1011,6,1315,2912,7059,2096,1140,15,1236,2315,6802,61,354
1147,873,71,1324,2196,5611,1195,1151,90,1163,1778,5377,61,355
271,704,59,1495,1124,3653,276,719,89,1048,1258,3390,61,356
212,414,2,1186,941,2755,214,517,5,798,966,2500,61,357
618,503,7,1198,1556,3882,919,579,6,929,1258,3691,61,358
394,311,2,1029,656,2392,484,305,9,692,688,2178,61,359
128,144,3,369,301,945,95,218,3,262,350,928,61,360
362,456,4,960,1157,2939,669,547,8,822,1096,3142,61,361
484,665,34,1209,1247,3639,724,667,48,930,1389,3758,61,362
201,580,42,1203,921,2947,244,792,46,881,1070,3033,61,363
232,429,2,1316,882,2861,230,583,5,1025,1123,2966,61,364
755,629,3,1400,1730,4517,1016,876,8,1166,1599,4665,61,365
700,925,608,1948,1226,5407,933,1143,499,1546,1506,5627,61,366
104,105,5,203,123,540,49,150,11,150,201,561,62,1
643,141,3,355,230,1372,119,289,10,266,639,1323,62,2
835,130,4,345,273,1587,160,286,20,279,760,1505,62,3
817,136,4,351,251,1559,170,289,9,269,715,1452,62,4
708,160,15,361,287,1531,149,318,32,286,671,1456,62,5
152,103,10,220,142,627,88,170,21,176,188,643,62,6
97,111,1,242,143,594,52,167,4,170,206,599,62,7
814,150,2,344,257,1567,157,321,14,267,760,1519,62,8
847,105,3,311,173,1439,156,244,11,283,626,1320,62,9
854,151,7,368,256,1636,155,315,23,286,792,1571,62,10
854,138,4,366,270,1632,154,331,8,267,735,1495,62,11
772,148,8,372,250,1550,179,268,26,295,639,1407,62,12
174,158,11,293,200,836,75,215,37,216,287,830,62,13
94,100,9,192,120,515,39,161,16,152,170,538,62,14
224,147,5,272,154,802,85,208,11,176,273,753,62,15
301,115,18,277,162,873,116,232,27,171,260,806,62,16
726,118,4,392,226,1466,116,269,12,252,711,1360,62,17
823,126,4,340,227,1520,159,281,15,233,764,1452,62,18
353,124,11,269,186,943,103,256,24,225,330,938,62,19
168,129,12,283,161,753,66,212,23,189,230,720,62,20
86,94,2,215,139,536,38,165,10,133,186,532,62,21
774,150,3,312,223,1462,140,322,12,260,728,1462,62,22
891,160,8,344,259,1662,154,373,17,279,821,1644,62,23
878,137,3,362,252,1632,149,344,13,257,805,1568,62,24
853,138,14,361,233,1599,150,366,20,278,717,1531,62,25
703,163,12,410,284,1572,176,335,42,303,628,1484,62,26
169,162,17,332,222,902,79,270,40,213,317,919,62,27
100,112,4,236,133,585,47,199,9,158,199,612,62,28
819,130,6,319,262,1536,155,295,19,271,712,1452,62,29
924,143,12,330,252,1661,177,321,15,291,819,1623,62,30
925,146,5,368,245,1689,167,322,16,281,773,1559,62,31
912,139,4,323,221,1599,151,334,6,246,777,1514,62,32
780,165,10,401,283,1639,165,333,36,309,703,1546,62,33
132,151,21,295,240,839,73,233,39,223,261,829,62,34
102,107,5,247,144,605,54,176,11,153,213,607,62,35
838,151,1,364,264,1618,157,329,9,281,781,1557,62,36
929,165,4,363,246,1707,176,339,14,278,838,1645,62,37
949,151,2,401,230,1733,170,342,11,280,805,1608,62,38
863,139,2,372,240,1616,185,327,7,249,792,1560,62,39
773,187,8,407,268,1643,160,335,28,302,673,1498,62,40
168,180,17,338,239,942,74,263,29,224,318,908,62,41
98,113,2,243,144,600,62,202,13,141,208,626,62,42
827,157,2,348,250,1584,162,301,7,241,742,1453,62,43
841,135,6,332,215,1529,169,367,20,230,715,1501,62,44
912,164,6,363,290,1735,161,340,21,274,868,1664,62,45
835,155,5,380,275,1650,160,349,14,264,833,1620,62,46
669,154,14,411,299,1547,151,320,30,323,657,1481,62,47
144,137,14,293,201,789,71,237,37,167,230,742,62,48
102,107,6,259,149,623,50,180,18,145,202,595,62,49
253,197,10,292,217,969,95,276,21,223,375,990,62,50
811,165,3,345,247,1571,152,343,14,277,783,1569,62,51
909,154,6,370,253,1692,185,351,13,288,834,1671,62,52
845,135,2,366,269,1617,167,324,10,272,786,1559,62,53
709,169,7,383,267,1535,170,301,33,287,674,1465,62,54
145,113,6,329,198,791,64,140,38,216,272,730,62,55
93,110,1,231,148,583,45,203,8,144,201,601,62,56
807,157,3,339,235,1541,156,354,11,262,796,1579,62,57
915,133,5,371,217,1641,149,359,15,306,783,1612,62,58
928,128,8,317,199,1580,184,322,13,244,783,1546,62,59
853,131,3,353,254,1594,162,328,10,262,822,1584,62,60
779,149,11,396,299,1634,165,314,33,307,785,1604,62,61
130,172,8,285,174,769,72,234,28,207,237,778,62,62
78,91,7,278,161,615,57,194,11,175,229,666,62,63
805,138,4,357,246,1550,172,305,10,269,802,1558,62,64
897,103,8,327,222,1557,143,313,9,253,854,1572,62,65
902,135,6,366,211,1620,184,303,11,269,800,1567,62,66
871,152,4,370,257,1654,176,344,11,277,794,1602,62,67
717,185,9,366,299,1576,167,316,36,308,732,1559,62,68
157,126,11,288,179,761,68,219,35,204,224,750,62,69
79,95,3,223,132,532,39,186,17,141,173,556,62,70
753,165,6,326,228,1478,149,300,11,225,746,1431,62,71
887,167,7,341,221,1623,173,385,11,266,872,1707,62,72
956,143,3,414,238,1754,187,355,12,332,901,1787,62,73
801,184,3,432,263,1683,164,394,18,308,800,1684,62,74
708,182,10,423,237,1560,165,352,35,305,683,1540,62,75
168,188,13,370,218,957,74,269,38,250,375,1006,62,76
119,111,10,273,180,693,61,249,15,169,233,727,62,77
804,151,3,389,238,1585,151,353,8,274,800,1586,62,78
903,146,2,343,268,1662,169,367,6,244,900,1686,62,79
976,170,6,362,294,1808,176,379,16,292,894,1757,62,80
892,167,5,356,269,1689,176,375,15,240,832,1638,62,81
773,152,8,361,247,1541,194,304,34,280,751,1563,62,82
134,136,3,239,202,714,62,235,26,177,265,765,62,83
130,138,3,300,161,732,58,213,6,168,243,688,62,84
783,171,16,368,272,1610,145,386,13,257,791,1592,62,85
919,159,19,373,256,1726,179,395,18,258,875,1725,62,86
889,119,12,341,219,1580,153,319,11,251,785,1519,62,87
853,159,14,389,233,1648,128,367,27,269,790,1581,62,88
715,158,6,408,288,1575,160,372,25,335,721,1613,62,89
180,146,13,381,234,954,84,315,37,236,319,991,62,90
112,147,7,285,141,692,68,221,14,173,242,718,62,91
724,191,10,369,233,1527,128,358,16,282,749,1533,62,92
901,147,2,391,205,1646,158,380,11,269,794,1612,62,93
899,134,7,347,194,1581,169,367,17,265,788,1606,62,94
865,170,3,444,245,1727,160,409,20,263,847,1699,62,95
687,183,9,404,317,1600,171,394,36,310,687,1598,62,96
171,166,9,334,195,875,65,288,42,186,315,896,62,97
145,136,5,304,154,744,58,240,12,181,236,727,62,98
838,177,5,373,239,1632,168,360,16,293,824,1661,62,99
921,158,5,352,271,1707,167,391,16,277,847,1698,62,100
913,176,3,374,269,1735,164,368,16,297,912,1757,62,101
933,130,6,411,265,1745,187,347,13,314,860,1721,62,102
796,240,5,309,216,1566,154,420,34,245,599,1452,62,103
167,103,4,385,177,836,72,184,23,245,244,768,62,104
108,135,5,285,190,723,40,319,12,160,283,814,62,105
710,84,1,382,242,1419,159,228,10,242,668,1307,62,106
629,186,5,412,288,1520,110,373,13,259,757,1512,62,107
796,166,6,384,322,1674,151,383,27,267,700,1528,62,108
765,168,22,421,280,1656,176,385,28,290,746,1625,62,109
677,166,12,449,273,1577,168,308,53,300,649,1478,62,110
181,160,12,416,218,987,77,315,61,219,368,1040,62,111
132,128,3,241,126,630,54,201,16,138,215,624,62,112
791,176,6,383,246,1602,154,368,22,257,809,1610,62,113
898,212,6,407,299,1822,162,467,13,287,874,1803,62,114
932,153,8,424,283,1800,156,415,19,274,907,1771,62,115
968,173,10,427,309,1887,155,434,19,299,918,1825,62,116
821,176,27,400,287,1711,148,420,34,314,801,1717,62,117
195,129,9,330,203,866,70,254,48,218,285,875,62,118
133,111,5,291,197,737,55,241,18,169,262,745,62,119
830,164,6,386,241,1627,121,357,16,288,880,1662,62,120
928,178,1,375,227,1709,163,357,10,285,909,1724,62,121
956,158,5,412,294,1825,168,388,17,318,885,1776,62,122
898,174,7,349,241,1669,150,399,23,307,850,1729,62,123
779,181,16,419,288,1683,167,407,33,330,729,1666,62,124
171,149,27,288,176,811,66,271,51,173,272,833,62,125
121,116,4,221,152,614,50,192,15,147,212,616,62,126
890,165,5,391,241,1692,177,369,29,274,842,1691,62,127
997,167,2,408,259,1833,167,401,19,301,881,1769,62,128
1001,257,5,435,288,1986,166,992,11,286,931,2386,62,129
952,198,13,412,259,1834,181,385,26,262,857,1711,62,130
801,142,11,371,247,1572,156,330,37,252,775,1550,62,131
200,164,10,287,177,838,78,262,36,200,245,821,62,132
124,118,7,245,136,630,52,195,25,149,203,624,62,133
814,115,3,317,206,1455,147,282,10,225,778,1442,62,134
919,94,4,309,175,1501,123,255,26,213,849,1466,62,135
895,120,4,335,194,1548,155,287,21,207,825,1495,62,136
916,113,14,361,234,1638,193,329,32,198,827,1579,62,137
769,103,9,309,220,1410,147,289,35,217,733,1421,62,138
125,85,10,229,120,569,53,168,27,124,192,564,62,139
107,81,9,231,124,552,40,181,20,105,206,552,62,140
831,122,2,339,199,1493,127,361,11,227,774,1500,62,141
959,131,4,347,202,1643,171,329,14,210,878,1602,62,142
952,113,4,360,178,1607,158,336,12,255,844,1605,62,143
870,122,5,313,210,1520,153,316,14,200,774,1457,62,144
732,125,11,410,217,1495,154,296,30,276,594,1350,62,145
167,122,5,333,170,797,70,217,24,176,269,756,62,146
103,60,3,229,136,531,52,174,17,122,200,565,62,147
137,85,3,195,105,525,57,178,7,125,184,551,62,148
854,98,3,316,166,1437,124,311,12,205,757,1409,62,149
912,91,8,312,187,1510,165,259,20,238,789,1471,62,150
932,135,3,353,176,1599,176,331,17,224,804,1552,62,151
733,141,9,346,221,1450,162,349,32,218,661,1422,62,152
163,109,7,334,193,806,65,243,29,178,273,788,62,153
98,79,3,208,112,500,41,174,10,115,183,523,62,154
818,100,3,335,197,1453,123,320,15,203,760,1421,62,155
869,135,2,383,200,1589,157,331,20,264,783,1555,62,156
926,99,1,359,167,1552,152,318,10,233,811,1524,62,157
839,116,2,380,186,1523,132,383,13,265,738,1531,62,158
737,118,7,311,208,1381,108,346,36,240,613,1343,62,159
182,138,6,360,276,962,56,334,52,182,245,869,62,160
125,85,4,247,102,563,54,175,17,99,186,531,62,161
737,88,4,334,159,1322,130,286,16,238,696,1366,62,162
811,89,4,352,182,1438,130,307,19,223,773,1452,62,163
887,100,1,362,181,1531,130,341,13,231,773,1488,62,164
762,99,8,366,203,1438,131,305,20,224,718,1398,62,165
652,114,8,334,226,1334,135,329,50,277,539,1330,62,166
179,121,6,303,167,776,60,257,26,149,274,766,62,167
119,92,2,243,107,563,41,151,30,130,235,587,62,168
690,109,3,296,156,1254,92,294,14,204,594,1198,62,169
732,118,26,362,213,1451,109,293,40,268,669,1379,62,170
319,131,1,288,212,951,89,292,6,167,317,871,62,171
715,108,7,398,160,1388,129,296,25,261,657,1368,62,172
667,103,7,343,188,1308,111,287,38,257,572,1265,62,173
175,116,6,285,139,721,84,217,27,166,196,690,62,174
111,65,7,214,135,532,49,172,26,119,176,542,62,175
687,88,3,311,157,1246,103,246,14,200,696,1259,62,176
780,103,8,311,184,1386,122,275,14,192,745,1348,62,177
840,116,5,324,178,1463,134,274,9,236,711,1364,62,178
762,119,4,381,191,1457,137,314,22,273,693,1439,62,179
647,122,6,331,197,1303,129,284,35,221,571,1240,62,180
163,91,6,298,154,712,58,208,29,184,219,698,62,181
105,76,3,185,99,468,40,130,18,112,163,463,62,182
770,106,5,384,202,1467,124,299,17,273,641,1354,62,183
845,131,2,354,223,1555,131,369,14,259,698,1471,62,184
771,115,2,446,259,1593,135,359,13,351,649,1507,62,185
128,266,11,236,254,895,45,447,35,186,242,955,62,186
460,104,8,284,177,1033,88,268,27,174,407,964,62,187
144,132,8,262,135,681,71,212,26,153,210,672,62,188
107,90,3,199,128,527,49,163,11,125,203,551,62,189
719,100,2,353,165,1339,135,281,19,245,632,1312,62,190
805,123,2,328,178,1436,146,318,15,263,696,1438,62,191
773,97,3,338,198,1409,143,315,18,261,715,1452,62,192
790,97,2,391,195,1475,143,311,24,288,721,1487,62,193
599,108,4,276,180,1167,99,282,29,221,537,1168,62,194
156,105,4,257,162,684,54,255,18,164,210,701,62,195
120,86,5,201,103,515,58,170,12,123,158,521,62,196
735,83,11,328,192,1349,151,233,24,246,612,1266,62,197
769,97,7,299,172,1344,137,272,23,204,651,1287,62,198
778,83,9,258,165,1293,99,233,16,195,690,1233,62,199
748,101,43,370,201,1463,108,327,57,264,726,1482,62,200
619,104,23,358,187,1291,125,281,57,205,552,1220,62,201
163,110,9,289,171,742,74,213,36,172,217,712,62,202
112,89,4,233,119,557,46,191,9,104,210,560,62,203
694,95,3,288,165,1245,115,237,12,205,645,1214,62,204
778,123,2,368,199,1470,124,300,12,229,716,1381,62,205
787,125,3,290,246,1451,102,349,18,207,751,1427,62,206
733,100,4,317,199,1353,119,301,15,242,700,1377,62,207
644,112,11,289,236,1292,115,260,37,224,605,1241,62,208
181,113,6,275,179,754,90,252,29,185,248,804,62,209
116,95,2,198,117,528,50,193,21,118,178,560,62,210
711,105,6,367,187,1376,128,290,16,254,685,1373,62,211
767,103,1,304,181,1356,114,273,10,222,723,1342,62,212
797,90,2,326,164,1379,136,269,10,264,699,1378,62,213
753,114,3,363,165,1398,169,282,15,242,640,1348,62,214
606,115,9,316,200,1246,123,316,23,185,545,1192,62,215
163,67,6,301,118,655,56,185,32,176,219,668,62,216
109,86,4,223,74,496,40,171,8,111,194,524,62,217
664,114,2,285,161,1226,119,291,13,181,595,1199,62,218
738,101,1,307,179,1326,127,294,14,175,692,1302,62,219
705,87,2,310,172,1276,105,276,15,175,660,1231,62,220
701,79,3,298,121,1202,111,271,13,192,613,1200,62,221
527,99,14,235,169,1044,92,275,38,178,465,1048,62,222
179,105,11,266,153,714,82,191,21,174,200,668,62,223
109,57,3,218,115,502,38,143,13,124,168,486,62,224
672,114,6,286,183,1261,114,252,14,203,595,1178,62,225
696,93,2,316,179,1286,122,242,16,187,676,1243,62,226
770,92,3,275,195,1335,111,254,15,178,683,1241,62,227
693,104,3,337,193,1330,142,266,19,182,662,1271,62,228
616,84,5,326,186,1217,129,228,29,216,555,1157,62,229
177,74,6,267,137,661,65,165,23,167,208,628,62,230
93,55,4,192,83,427,35,128,15,107,165,450,62,231
716,89,2,307,164,1278,141,239,10,195,695,1280,62,232
713,94,16,330,210,1363,120,310,28,214,696,1368,62,233
785,81,5,327,199,1397,116,285,19,235,712,1367,62,234
786,116,5,369,192,1468,150,308,16,240,731,1445,62,235
639,126,9,312,210,1296,116,281,26,231,621,1275,62,236
160,95,4,265,159,683,60,229,39,175,235,738,62,237
95,69,4,177,107,452,34,163,19,94,165,475,62,238
797,78,2,311,191,1379,148,273,9,226,635,1291,62,239
903,119,3,301,208,1534,150,348,9,183,765,1455,62,240
921,73,2,334,155,1485,140,297,8,217,759,1421,62,241
822,84,2,320,133,1361,129,246,8,225,695,1303,62,242
657,96,4,322,204,1283,126,276,26,267,555,1250,62,243
141,145,7,295,158,746,65,262,32,180,255,794,62,244
115,73,3,217,84,492,54,161,15,110,156,496,62,245
144,85,2,181,99,511,54,167,9,111,167,508,62,246
924,100,2,313,160,1499,157,274,13,227,742,1413,62,247
943,97,2,338,187,1567,137,311,16,261,825,1550,62,248
963,94,4,320,194,1575,151,306,12,191,815,1475,62,249
794,101,11,308,183,1397,131,275,31,251,671,1359,62,250
159,98,8,266,151,682,44,221,35,177,242,719,62,251
111,77,2,176,95,461,39,153,6,134,162,494,62,252
862,107,2,303,192,1466,127,268,10,187,808,1400,62,253
936,121,3,314,215,1589,138,340,7,225,856,1566,62,254
947,90,3,326,196,1562,132,325,11,207,825,1500,62,255
909,95,2,344,200,1550,154,322,13,206,847,1542,62,256
810,165,7,345,224,1551,140,379,35,211,698,1463,62,257
160,101,10,292,177,740,65,242,41,197,297,842,62,258
113,68,5,209,89,484,44,142,7,131,154,478,62,259
802,78,1,296,136,1313,134,242,13,193,758,1340,62,260
978,75,2,322,132,1509,146,289,8,256,788,1487,62,261
984,106,1,357,160,1608,138,342,14,286,757,1537,62,262
1009,92,4,364,209,1678,163,294,16,256,816,1545,62,263
786,139,7,391,231,1554,141,298,45,273,687,1444,62,264
171,73,15,301,191,751,57,255,33,162,241,748,62,265
99,62,1,174,111,447,33,152,12,126,158,481,62,266
866,80,6,274,168,1394,120,238,14,208,728,1308,62,267
939,83,1,277,165,1465,120,297,10,211,800,1438,62,268
1010,95,6,336,175,1622,129,325,10,231,807,1502,62,269
965,96,4,349,158,1572,152,274,17,206,827,1476,62,270
820,127,6,327,205,1485,130,312,37,247,679,1405,62,271
187,163,10,352,216,928,71,299,57,213,272,912,62,272
96,63,2,202,94,457,30,171,6,107,185,499,62,273
801,92,2,283,179,1357,121,246,11,200,705,1283,62,274
925,104,4,265,167,1465,119,278,9,204,817,1427,62,275
955,101,4,333,147,1540,148,265,10,247,800,1470,62,276
920,106,2,326,163,1517,147,292,12,233,801,1485,62,277
775,102,10,351,253,1491,149,279,48,260,718,1454,62,278
146,103,16,335,139,739,49,187,46,214,234,730,62,279
96,64,5,197,120,482,36,150,13,122,153,474,62,280
810,101,16,294,155,1376,116,255,21,193,737,1322,62,281
898,97,9,322,166,1492,142,273,19,218,789,1441,62,282
895,78,3,364,174,1514,131,274,15,248,824,1492,62,283
783,111,3,346,226,1469,115,284,15,222,835,1471,62,284
647,101,3,348,251,1350,108,263,32,283,606,1292,62,285
174,102,7,272,152,707,51,240,29,189,253,762,62,286
105,65,7,215,114,506,41,165,14,97,180,497,62,287
354,76,8,234,132,804,68,182,19,159,337,765,62,288
931,83,7,297,157,1475,143,271,12,211,816,1453,62,289
949,94,11,342,207,1603,123,304,21,231,904,1583,62,290
846,102,3,344,153,1448,127,325,24,178,833,1487,62,291
721,150,21,379,226,1497,114,329,36,232,771,1482,62,292
194,129,8,378,184,893,68,267,40,222,260,857,62,293
92,65,2,208,168,535,40,187,7,126,204,564,62,294
795,104,3,264,165,1331,114,281,27,164,758,1344,62,295
923,85,3,291,160,1462,113,247,9,208,789,1366,62,296
964,81,3,335,175,1558,127,301,11,243,817,1499,62,297
934,93,3,332,191,1553,152,301,11,211,790,1465,62,298
759,96,5,309,189,1358,126,264,28,209,641,1268,62,299
160,76,3,273,158,670,51,194,29,171,233,678,62,300
122,51,1,224,103,501,61,161,9,116,175,522,62,301
817,119,5,277,187,1405,128,311,16,216,704,1375,62,302
961,100,7,357,214,1639,159,329,15,263,803,1569,62,303
937,154,2,312,193,1598,124,419,14,222,826,1605,62,304
858,113,5,294,204,1474,135,301,13,228,737,1414,62,305
720,115,4,358,193,1390,115,263,28,293,635,1334,62,306
177,72,5,319,153,726,61,202,31,198,228,720,62,307
113,67,2,223,93,498,41,122,7,119,168,457,62,308
750,84,4,309,211,1358,121,268,13,228,692,1322,62,309
734,77,4,340,125,1280,135,217,12,262,595,1221,62,310
877,76,1,339,176,1469,115,238,8,243,751,1355,62,311
988,135,4,328,175,1630,148,343,12,205,796,1504,62,312
849,99,4,335,200,1487,133,245,35,280,651,1344,62,313
159,85,8,262,179,693,65,189,20,188,252,714,62,314
118,57,5,197,96,473,45,133,10,98,171,457,62,315
319,79,2,243,121,764,81,169,11,157,345,763,62,316
976,67,3,299,154,1499,138,273,12,233,806,1462,62,317
1010,80,4,329,183,1606,153,271,7,222,748,1401,62,318
888,69,3,402,179,1541,107,236,16,269,896,1524,62,319
1055,68,6,279,179,1587,204,246,31,232,699,1412,62,320
175,73,9,277,142,676,56,176,22,165,304,723,62,321
101,56,7,204,131,499,35,148,17,114,178,492,62,322
924,87,3,330,155,1499,105,247,9,224,775,1360,62,323
977,109,7,319,160,1572,137,275,19,228,811,1470,62,324
1053,76,5,337,194,1665,175,234,16,219,815,1459,62,325
883,108,5,320,182,1498,134,315,14,204,816,1483,62,326
831,80,9,296,174,1390,164,218,24,205,646,1257,62,327
148,80,10,300,141,679,51,173,25,174,215,638,62,328
102,71,4,173,96,446,41,142,12,122,164,481,62,329
784,80,1,278,165,1308,129,219,17,194,723,1282,62,330
768,115,1,368,197,1449,134,276,9,266,743,1428,62,331
559,72,2,330,175,1138,103,212,15,330,496,1156,62,332
54,69,2,107,59,291,32,69,6,103,120,330,62,333
243,85,7,292,136,763,69,178,21,199,243,710,62,334
123,80,11,210,118,542,53,134,20,151,209,567,62,335
70,65,1,178,95,409,30,124,7,114,135,410,62,336
729,80,3,225,173,1210,105,200,18,171,681,1175,62,337
920,88,3,306,163,1480,141,271,11,220,776,1419,62,338
899,70,2,270,154,1395,150,230,8,209,747,1344,62,339
884,66,2,272,175,1399,145,205,19,196,728,1293,62,340
694,62,9,285,186,1236,112,199,36,195,622,1164,62,341
145,88,7,261,138,639,57,219,28,167,211,682,62,342
98,53,4,213,130,498,44,158,13,124,156,495,62,343
812,95,8,278,165,1358,114,248,14,196,720,1292,62,344
891,74,3,326,189,1483,133,291,12,189,774,1399,62,345
884,63,5,333,165,1450,131,227,14,214,807,1393,62,346
839,74,5,321,199,1438,111,296,21,188,855,1471,62,347
710,76,5,300,213,1304,92,268,19,209,665,1253,62,348
133,88,6,277,181,685,51,194,35,175,271,726,62,349
86,74,4,203,110,477,42,164,13,109,143,471,62,350
797,84,3,259,165,1308,106,258,8,174,737,1283,62,351
851,74,2,307,208,1442,115,251,9,207,932,1514,62,352
844,82,4,279,195,1404,118,283,11,217,850,1479,62,353
841,77,4,343,176,1441,124,248,13,259,750,1394,62,354
653,96,4,274,194,1221,104,213,20,226,605,1168,62,355
140,57,4,241,124,566,47,147,36,152,185,567,62,356
74,43,3,214,112,446,30,111,7,98,163,409,62,357
537,61,1,280,151,1030,85,217,15,218,484,1019,62,358
304,52,2,230,134,722,77,133,11,196,230,647,62,359
39,51,2,83,69,244,14,59,5,63,92,233,62,360
351,74,1,257,145,828,58,200,13,165,370,806,62,361
397,63,3,285,171,919,87,181,20,208,425,921,62,362
119,78,7,203,125,532,31,183,30,108,172,524,62,363
90,52,3,204,108,457,43,149,11,83,163,449,62,364
480,77,2,260,187,1006,99,241,7,191,514,1052,62,365
498,164,16,277,163,1118,99,198,46,310,418,1071,62,366
172,148,2,387,213,922,72,235,22,300,353,982,63,1
1420,194,4,697,472,2787,330,401,24,493,1445,2693,63,2
1767,162,5,702,609,3245,361,469,18,515,1782,3145,63,3
1617,174,4,697,474,2966,338,420,21,508,1609,2896,63,4
1255,185,7,697,579,2723,305,537,54,418,1312,2626,63,5
229,145,16,473,225,1088,108,319,49,251,374,1101,63,6
174,129,3,629,240,1175,84,344,28,281,480,1217,63,7
1592,189,9,653,511,2954,391,432,35,456,1588,2902,63,8
1797,141,6,597,382,2923,351,391,28,636,1481,2887,63,9
2015,203,3,647,503,3371,369,474,26,484,1919,3272,63,10
1894,188,3,693,619,3397,354,539,52,564,1811,3320,63,11
1268,166,6,676,501,2617,322,394,55,507,1240,2518,63,12
283,167,4,1203,337,1994,120,437,63,366,905,1891,63,13
200,109,4,519,219,1051,100,238,26,312,440,1116,63,14
378,198,33,558,247,1414,168,310,66,350,556,1450,63,15
556,135,5,391,279,1366,193,323,22,321,544,1403,63,16
1571,183,2,650,471,2877,357,463,39,423,1515,2797,63,17
1834,212,7,720,563,3336,384,620,37,502,1661,3204,63,18
722,148,12,485,249,1616,237,301,61,359,755,1713,63,19
253,128,7,508,280,1176,99,406,41,305,408,1259,63,20
161,110,5,444,221,941,68,259,30,283,383,1023,63,21
1539,185,6,638,464,2832,339,427,48,492,1474,2780,63,22
2073,182,5,678,506,3444,407,519,38,522,1903,3389,63,23
2072,178,3,627,549,3429,420,524,42,520,1948,3454,63,24
1902,206,9,838,513,3468,356,574,33,531,1799,3293,63,25
1388,212,17,745,579,2941,331,523,65,520,1390,2829,63,26
273,171,9,856,408,1717,114,501,50,367,708,1740,63,27
174,135,6,509,227,1051,87,257,24,267,437,1072,63,28
1663,186,10,664,485,3008,381,453,31,491,1527,2883,63,29
2126,177,6,709,561,3579,419,510,32,534,1974,3469,63,30
2108,183,16,648,574,3529,416,561,40,508,1886,3411,63,31
1946,192,5,721,545,3409,400,554,28,541,1795,3318,63,32
1403,196,10,682,583,2874,340,520,62,538,1330,2790,63,33
299,141,8,710,338,1496,122,367,53,356,562,1460,63,34
201,134,5,582,279,1201,88,309,21,327,465,1210,63,35
1652,178,3,612,467,2912,362,451,27,481,1560,2881,63,36
2084,212,9,713,572,3590,426,585,36,528,1924,3499,63,37
2140,214,10,628,568,3560,416,609,41,536,1947,3549,63,38
1940,193,2,730,546,3411,461,578,45,554,1721,3359,63,39
1370,215,11,687,568,2851,334,516,70,587,1277,2784,63,40
326,201,7,871,410,1815,103,474,58,373,755,1763,63,41
177,147,8,586,247,1165,89,276,21,269,506,1161,63,42
1637,165,1,644,466,2913,354,382,41,513,1553,2843,63,43
1946,192,14,696,585,3433,413,647,28,516,1781,3385,63,44
2081,206,8,664,507,3466,402,625,39,516,1753,3335,63,45
1887,167,4,671,520,3249,392,525,39,353,1693,3002,63,46
1310,205,12,773,547,2847,358,511,78,578,1235,2760,63,47
264,133,9,694,296,1396,108,404,61,314,545,1432,63,48
229,129,8,590,271,1227,96,340,31,264,514,1245,63,49
563,191,13,639,340,1746,169,357,38,388,784,1736,63,50
2075,195,9,745,599,3623,458,555,27,559,1872,3471,63,51
2178,176,6,726,521,3607,442,559,38,593,1917,3549,63,52
1973,179,8,708,580,3448,367,614,25,532,1815,3353,63,53
1380,198,11,682,492,2763,324,455,42,558,1354,2733,63,54
295,159,5,830,410,1699,126,416,72,401,645,1660,63,55
159,119,3,603,248,1132,67,329,22,277,476,1171,63,56
1687,211,15,672,541,3126,406,554,41,541,1567,3109,63,57
2202,161,5,639,632,3639,478,548,28,523,1971,3548,63,58
2145,167,7,701,537,3557,417,531,28,607,1946,3529,63,59
1924,171,8,734,560,3397,452,589,35,588,1750,3414,63,60
1432,204,7,675,613,2931,336,590,66,590,1388,2970,63,61
243,159,14,706,330,1452,115,420,70,367,599,1571,63,62
218,176,5,739,258,1396,86,336,40,383,630,1475,63,63
1721,202,3,684,522,3132,377,479,27,480,1685,3048,63,64
2208,192,0,718,553,3671,403,601,23,493,2078,3598,63,65
2197,214,14,690,568,3683,447,584,33,606,1975,3645,63,66
2019,207,7,763,569,3565,395,612,63,582,1808,3460,63,67
1510,225,5,764,655,3159,325,584,69,597,1512,3087,63,68
324,175,6,771,313,1589,107,444,63,356,627,1597,63,69
214,167,15,662,279,1337,88,323,40,311,535,1297,63,70
1699,201,11,728,508,3147,383,502,36,486,1673,3080,63,71
2244,233,8,880,621,3986,413,671,52,609,2162,3907,63,72
2243,222,11,918,568,3962,424,663,64,603,2202,3956,63,73
2101,202,17,925,606,3851,361,690,80,638,1983,3752,63,74
1425,258,8,859,609,3159,308,601,87,634,1453,3083,63,75
483,199,4,1203,402,2291,125,614,86,566,985,2376,63,76
269,165,3,752,377,1566,107,453,23,414,667,1664,63,77
1746,202,5,906,511,3370,381,540,26,596,1769,3312,63,78
2254,214,15,934,654,4071,383,647,42,648,2213,3933,63,79
2291,200,7,1043,720,4261,416,828,37,633,2287,4201,63,80
2055,192,1,970,633,3851,367,760,56,657,1951,3791,63,81
1501,186,10,1059,735,3491,323,708,88,732,1666,3517,63,82
320,205,12,683,380,1600,90,470,67,336,672,1635,63,83
370,129,10,1701,346,2556,106,523,29,616,1414,2688,63,84
1727,195,10,1408,618,3958,357,632,80,621,2228,3918,63,85
2198,221,16,1293,622,4350,423,711,42,650,2451,4277,63,86
2141,183,7,961,528,3820,414,521,43,669,2120,3767,63,87
1813,173,4,939,505,3434,398,556,37,604,1880,3475,63,88
1393,201,8,1451,686,3739,319,695,62,697,1917,3690,63,89
411,156,3,2024,563,3157,118,731,57,676,1535,3117,63,90
247,210,6,927,382,1772,82,500,21,402,781,1786,63,91
1586,222,17,1051,569,3445,358,673,37,503,1818,3389,63,92
2183,186,5,842,519,3735,401,589,43,577,2092,3702,63,93
2168,184,9,757,592,3710,427,637,29,569,2014,3676,63,94
2102,194,8,1110,671,4085,416,737,39,639,2186,4017,63,95
1467,227,9,960,627,3290,345,646,98,691,1597,3377,63,96
429,169,11,1093,384,2086,122,570,77,505,903,2177,63,97
396,154,6,922,320,1798,103,529,23,535,665,1855,63,98
1725,221,4,799,486,3235,434,522,52,562,1667,3237,63,99
2259,213,32,842,622,3968,443,676,86,620,2163,3988,63,100
2242,227,3,938,646,4056,436,655,35,730,2170,4026,63,101
2067,176,2,816,552,3613,438,661,31,597,1884,3611,63,102
1532,235,6,880,633,3286,395,629,65,660,1548,3297,63,103
515,182,5,1279,459,2440,131,687,115,511,1103,2547,63,104
303,185,5,977,294,1764,128,508,25,415,789,1865,63,105
1721,231,7,787,575,3321,426,656,35,572,1695,3384,63,106
2131,206,15,773,593,3718,413,656,65,589,1986,3709,63,107
2237,200,5,876,561,3879,441,717,37,591,2094,3880,63,108
2053,209,42,862,613,3779,433,649,84,602,2033,3801,63,109
1488,232,10,878,581,3189,347,597,67,635,1487,3133,63,110
375,160,8,1091,489,2123,76,805,98,320,626,1925,63,111
222,118,17,467,219,1043,65,298,48,256,363,1030,63,112
1801,206,13,714,537,3271,396,563,41,553,1765,3318,63,113
2271,211,12,816,647,3957,449,683,44,612,2182,3970,63,114
2320,213,16,764,654,3967,455,697,37,597,2141,3927,63,115
2157,196,10,858,600,3821,404,726,40,624,2030,3824,63,116
1590,198,8,797,649,3242,388,722,60,654,1558,3382,63,117
302,107,3,620,302,1334,99,339,97,292,399,1226,63,118
197,117,0,550,272,1136,69,357,54,237,348,1065,63,119
1750,168,9,691,478,3096,381,490,36,562,1665,3134,63,120
2285,190,16,777,583,3851,459,588,39,616,2146,3848,63,121
2246,192,6,730,606,3780,459,674,37,618,2081,3869,63,122
2081,172,14,699,519,3485,419,650,51,580,1838,3538,63,123
1410,229,10,769,560,2978,338,602,62,569,1443,3014,63,124
369,147,6,859,333,1714,121,480,71,371,669,1712,63,125
224,137,2,526,265,1154,59,396,18,339,377,1189,63,126
1726,180,4,618,485,3013,382,500,34,441,1707,3064,63,127
2391,180,2,764,723,4060,471,705,28,637,2142,3983,63,128
2328,221,8,788,787,4132,516,835,41,631,2142,4165,63,129
2085,179,3,785,572,3624,434,623,34,619,1903,3613,63,130
1450,183,9,659,591,2892,381,500,65,639,1459,3044,63,131
374,158,6,875,329,1742,121,447,67,468,762,1865,63,132
236,133,12,698,218,1297,86,339,30,331,568,1354,63,133
1737,186,2,713,565,3203,418,580,29,517,1680,3224,63,134
2260,171,5,909,583,3928,445,618,27,645,2153,3888,63,135
2236,207,11,780,713,3947,421,646,50,566,2284,3967,63,136
2056,231,20,965,566,3838,395,687,42,694,2063,3881,63,137
1497,203,5,827,542,3074,368,608,89,676,1496,3237,63,138
323,176,6,724,338,1567,128,468,66,319,667,1648,63,139
285,134,11,734,279,1443,92,384,41,401,608,1526,63,140
1792,196,3,733,565,3289,416,579,27,483,1826,3331,63,141
2359,201,5,857,605,4027,457,744,36,610,2244,4091,63,142
2325,180,10,880,584,3979,458,644,49,606,2231,3988,63,143
2105,183,4,831,518,3641,429,632,40,694,1950,3745,63,144
1368,244,9,850,615,3086,343,634,83,674,1321,3055,63,145
370,183,9,924,458,1944,131,591,110,441,754,2027,63,146
316,175,4,916,315,1726,85,483,67,434,695,1764,63,147
284,156,6,626,255,1327,95,397,25,337,562,1416,63,148
2110,207,9,715,544,3585,418,543,34,559,1965,3519,63,149
2264,161,4,845,528,3802,450,623,34,574,2144,3825,63,150
2107,174,7,820,591,3699,429,728,57,568,1983,3765,63,151
1517,200,12,848,525,3102,354,644,63,613,1542,3216,63,152
371,167,10,710,358,1616,108,482,51,384,698,1723,63,153
264,143,4,673,284,1368,89,412,29,354,547,1431,63,154
1942,189,4,898,560,3593,474,607,37,607,1880,3605,63,155
2466,200,8,965,657,4296,490,720,32,637,2363,4242,63,156
2547,177,4,866,609,4203,466,665,51,597,2339,4118,63,157
2245,194,5,812,676,3932,445,692,68,650,2076,3931,63,158
1556,220,10,853,781,3420,382,778,75,625,1594,3454,63,159
423,284,12,1536,831,3086,139,1272,125,489,995,3020,63,160
299,153,7,957,349,1765,117,546,40,391,748,1842,63,161
1924,208,3,899,544,3578,432,612,38,609,1913,3604,63,162
2518,183,7,1041,641,4390,471,749,61,664,2435,4380,63,163
2552,181,5,1076,707,4521,518,764,67,679,2453,4481,63,164
2235,190,11,946,518,3900,429,714,51,603,2079,3876,63,165
1503,251,11,898,636,3299,337,658,94,679,1559,3327,63,166
371,178,12,908,463,1932,149,575,100,494,752,2070,63,167
277,163,6,723,280,1449,112,367,27,353,628,1487,63,168
1866,193,4,929,554,3546,401,556,31,630,1911,3529,63,169
2393,166,11,921,599,4090,452,694,48,700,2142,4036,63,170
755,194,7,790,436,2182,267,570,52,413,918,2220,63,171
2020,199,6,950,600,3775,379,711,44,606,2038,3778,63,172
1454,224,9,916,496,3099,340,636,68,557,1490,3091,63,173
397,237,8,787,432,1861,118,556,105,425,695,1899,63,174
291,156,3,645,249,1344,114,355,46,342,532,1389,63,175
1827,231,1,811,514,3384,398,584,32,541,1688,3243,63,176
2425,185,19,910,599,4138,458,677,60,609,2263,4067,63,177
2412,180,8,896,623,4119,437,726,42,647,2295,4147,63,178
2180,260,4,930,631,4005,445,781,48,665,2110,4049,63,179
1520,210,1,938,595,3264,376,589,65,647,1606,3283,63,180
383,171,2,787,394,1737,125,505,40,447,718,1835,63,181
281,133,24,638,240,1316,100,334,55,325,540,1354,63,182
1870,179,0,870,524,3443,400,592,23,554,1874,3443,63,183
2287,202,11,1011,644,4155,449,714,58,643,2248,4112,63,184
1862,213,11,928,670,3684,399,696,56,756,1709,3616,63,185
411,1278,26,951,1210,3876,121,1891,93,511,848,3464,63,186
1045,209,6,959,503,2722,283,595,63,555,1161,2657,63,187
367,203,11,795,334,1710,108,494,60,453,670,1785,63,188
265,135,5,680,276,1361,97,308,26,331,532,1294,63,189
1748,182,7,787,552,3276,381,562,34,574,1728,3279,63,190
2207,210,7,800,569,3793,471,622,36,765,1936,3830,63,191
2062,216,5,839,582,3704,453,656,42,603,1942,3696,63,192
1923,214,5,900,557,3599,410,674,42,601,1932,3659,63,193
1430,246,9,824,615,3124,367,623,78,573,1492,3133,63,194
372,196,17,877,597,2059,120,770,91,436,690,2107,63,195
254,133,4,680,301,1372,89,402,29,371,504,1395,63,196
1812,181,5,746,483,3227,406,522,39,518,1760,3245,63,197
2291,187,3,819,576,3876,432,659,49,584,2029,3753,63,198
2223,170,36,762,516,3707,389,547,70,581,2091,3678,63,199
2035,205,7,968,544,3759,426,672,42,694,1931,3765,63,200
1201,233,11,640,675,2760,300,677,117,541,1478,3113,63,201
330,184,9,930,494,1947,133,612,71,442,744,2002,63,202
263,168,0,721,338,1490,94,377,23,385,588,1467,63,203
1758,162,4,777,509,3210,386,500,68,537,1691,3182,63,204
2354,185,6,907,645,4097,531,698,40,612,2150,4031,63,205
2129,193,5,898,716,3941,527,682,54,626,2089,3978,63,206
1971,199,1,956,579,3706,432,598,38,538,2097,3703,63,207
1436,222,6,923,619,3206,324,638,99,639,1537,3237,63,208
358,207,5,973,488,2031,134,582,142,474,755,2087,63,209
250,173,5,682,306,1416,103,405,48,316,562,1434,63,210
1727,183,11,784,755,3460,355,664,150,530,1729,3428,63,211
2254,201,3,829,560,3847,421,740,32,587,2068,3848,63,212
2299,203,5,769,562,3838,457,640,39,666,2124,3926,63,213
2019,224,4,881,589,3717,419,637,35,672,1864,3627,63,214
1455,248,12,987,716,3418,345,833,79,625,1405,3287,63,215
412,156,10,962,371,1911,92,587,58,427,764,1928,63,216
304,147,3,743,246,1443,110,381,28,405,642,1566,63,217
1741,171,13,703,566,3194,381,528,37,570,1729,3245,63,218
2185,210,12,830,674,3911,490,706,34,600,2074,3904,63,219
2109,183,8,897,657,3854,508,578,36,632,2111,3865,63,220
1783,174,13,763,581,3314,385,505,102,553,1833,3378,63,221
1252,178,14,631,568,2643,313,552,94,503,1174,2636,63,222
387,200,9,796,366,1758,147,470,67,382,750,1816,63,223
255,154,4,688,358,1459,88,428,26,337,615,1494,63,224
1760,218,5,811,556,3350,423,531,28,538,1782,3302,63,225
2202,189,6,906,621,3924,497,664,30,608,2053,3852,63,226
2202,219,4,926,664,4015,471,671,30,680,2155,4007,63,227
1880,205,6,868,639,3598,411,671,61,609,1841,3593,63,228
1372,248,9,850,621,3100,353,570,99,629,1382,3033,63,229
333,211,16,716,403,1679,110,448,106,378,670,1712,63,230
246,134,8,595,289,1272,90,348,49,302,482,1271,63,231
1740,193,20,803,504,3260,414,527,53,522,1707,3223,63,232
2184,195,12,791,630,3812,451,635,38,560,2002,3686,63,233
2165,228,9,847,691,3940,479,691,65,594,2087,3916,63,234
1916,213,3,831,562,3525,399,640,27,516,1966,3548,63,235
1395,221,11,722,652,3001,352,650,67,636,1427,3132,63,236
378,212,13,855,522,1980,97,631,69,418,745,1960,63,237
212,138,9,665,272,1296,93,365,17,353,537,1365,63,238
1781,207,10,740,585,3323,461,591,26,496,1721,3295,63,239
2272,216,24,817,675,4004,500,677,53,573,2100,3903,63,240
2268,206,3,798,632,3907,522,614,23,647,2054,3860,63,241
2013,187,4,824,583,3611,448,634,48,533,1874,3537,63,242
1383,238,7,824,609,3061,347,603,85,691,1322,3048,63,243
413,196,14,969,402,1994,135,542,87,492,708,1964,63,244
259,139,4,888,313,1603,102,472,34,401,710,1719,63,245
291,164,2,636,308,1401,100,361,20,398,581,1460,63,246
2218,191,2,875,592,3878,458,616,23,576,2152,3825,63,247
2441,176,21,828,639,4105,499,603,54,638,2303,4097,63,248
2238,191,5,744,632,3810,469,577,35,656,2008,3745,63,249
1468,209,8,731,596,3012,364,566,70,583,1494,3077,63,250
361,201,2,706,486,1756,139,508,170,422,647,1886,63,251
288,168,5,604,281,1346,112,369,31,325,524,1361,63,252
1912,203,10,776,629,3530,483,617,29,566,1827,3522,63,253
2481,178,5,838,692,4194,553,678,27,594,2275,4127,63,254
2539,189,5,803,695,4231,523,716,48,609,2289,4185,63,255
2221,205,5,840,657,3928,467,735,41,664,2043,3950,63,256
1639,256,10,774,635,3314,396,661,80,657,1608,3402,63,257
384,212,10,862,492,1960,128,651,117,451,680,2027,63,258
300,178,3,720,341,1542,114,381,32,390,678,1595,63,259
1989,178,8,808,583,3566,441,613,32,577,1887,3550,63,260
2532,175,0,871,655,4233,531,687,28,640,2359,4245,63,261
2482,179,3,816,648,4128,525,747,35,685,2236,4228,63,262
2247,191,34,812,676,3960,481,696,56,652,2058,3943,63,263
1635,211,9,817,588,3260,406,628,99,687,1587,3407,63,264
50,33,2,91,39,215,44,34,3,88,42,211,63,265
186,113,4,460,210,973,79,215,26,190,365,875,63,266
2002,167,5,789,533,3496,478,541,44,605,1850,3518,63,267
2534,171,3,849,714,4271,542,691,26,639,2360,4258,63,268
2547,169,7,783,728,4234,530,740,46,698,2211,4225,63,269
2231,198,5,871,631,3936,493,700,34,616,2101,3944,63,270
1521,204,9,737,645,3116,379,675,88,594,1477,3213,63,271
389,216,28,1014,574,2221,135,752,122,502,734,2245,63,272
263,149,1,722,308,1443,103,488,25,309,657,1582,63,273
1954,176,5,764,551,3450,437,521,48,582,1846,3434,63,274
2489,167,9,773,577,4015,526,682,31,614,2277,4130,63,275
2539,193,11,853,624,4220,553,667,29,658,2328,4235,63,276
2194,194,0,929,593,3910,444,643,27,708,2120,3942,63,277
1595,247,11,824,626,3303,392,564,98,686,1549,3289,63,278
369,273,27,854,425,1948,139,560,77,481,731,1988,63,279
254,146,4,627,323,1354,88,405,30,345,545,1413,63,280
2055,177,14,804,585,3635,440,604,39,642,1972,3697,63,281
2564,210,9,840,688,4311,551,659,34,651,2419,4314,63,282
2568,216,7,864,682,4337,533,705,32,678,2369,4317,63,283
2281,206,0,859,675,4021,506,708,35,682,2085,4016,63,284
1463,216,8,870,651,3208,389,635,66,632,1574,3296,63,285
522,182,15,1011,487,2217,121,723,69,455,894,2262,63,286
327,137,7,667,315,1453,92,401,63,395,530,1481,63,287
880,177,3,707,483,2250,315,456,34,507,1010,2322,63,288
2472,200,10,837,726,4245,519,766,34,636,2253,4208,63,289
2560,193,1,922,686,4362,510,698,61,645,2448,4362,63,290
2288,199,7,804,652,3950,463,740,46,697,2160,4106,63,291
1529,227,11,931,572,3270,330,620,92,699,1724,3465,63,292
438,256,10,919,481,2104,129,673,81,535,787,2205,63,293
266,200,2,716,363,1547,101,445,22,404,644,1616,63,294
2002,191,4,799,615,3611,465,609,41,598,1919,3632,63,295
2604,170,1,840,675,4290,508,649,48,644,2398,4247,63,296
2616,224,7,848,744,4439,522,746,59,682,2438,4447,63,297
2280,216,7,725,663,3891,494,720,45,611,2174,4044,63,298
1670,230,16,788,631,3335,438,606,89,611,1614,3358,63,299
418,159,5,962,461,2005,133,544,82,525,759,2043,63,300
571,183,5,783,306,1848,121,441,48,570,712,1892,63,301
1966,193,4,795,583,3541,489,545,38,580,1844,3496,63,302
2466,211,7,958,1179,4821,535,1404,37,630,2212,4818,63,303
2545,182,10,820,595,4152,514,703,36,654,2318,4225,63,304
2076,203,18,768,679,3744,478,584,44,613,1940,3659,63,305
1498,219,26,843,595,3181,329,543,91,666,1519,3148,63,306
47,17,15,27,36,142,44,19,12,24,39,138,63,307
17,15,13,30,44,119,15,16,15,27,49,122,63,308
1863,179,19,753,628,3442,461,532,37,584,1821,3435,63,309
1874,164,3,762,587,3390,428,420,36,737,1682,3303,63,310
2022,176,12,738,638,3586,500,585,33,544,1897,3559,63,311
2112,189,3,796,611,3711,472,537,30,626,2015,3680,63,312
1498,220,15,795,678,3206,386,634,71,641,1484,3216,63,313
343,144,2,884,387,1760,109,384,55,429,757,1734,63,314
228,99,11,719,335,1392,90,363,18,387,640,1498,63,315
842,153,4,653,447,2099,290,384,43,499,906,2122,63,316
2489,169,3,775,602,4038,513,618,27,636,2267,4061,63,317
2589,171,4,802,616,4182,470,702,40,716,2358,4286,63,318
2280,162,2,725,549,3718,435,569,35,612,2080,3731,63,319
1552,216,2,722,657,3149,389,640,61,569,1565,3224,63,320
371,167,6,830,389,1763,110,386,88,448,799,1831,63,321
235,117,4,630,288,1274,86,363,26,312,552,1339,63,322
1971,173,4,694,522,3364,435,517,42,551,1891,3436,63,323
2567,182,15,684,688,4136,579,617,27,556,2336,4115,63,324
2496,160,13,728,664,4061,588,613,35,574,2214,4024,63,325
2184,172,4,735,668,3763,488,658,27,553,1985,3711,63,326
1434,162,9,620,638,2863,369,563,43,531,1442,2948,63,327
295,138,3,797,462,1695,127,482,57,441,720,1827,63,328
233,114,14,682,261,1304,93,314,34,347,584,1372,63,329
1767,147,2,801,516,3233,411,470,32,515,1852,3280,63,330
1891,180,2,879,657,3609,423,595,21,620,2014,3673,63,331
1312,172,3,886,563,2936,339,476,25,854,1375,3069,63,332
135,93,3,274,147,652,68,141,11,320,323,863,63,333
614,131,2,967,424,2138,181,432,30,489,985,2117,63,334
270,131,7,737,353,1498,94,345,53,309,650,1451,63,335
184,108,1,635,269,1197,87,297,17,329,488,1218,63,336
1805,150,13,677,545,3190,410,506,33,457,1736,3142,63,337
2419,127,2,695,626,3869,458,611,27,551,2198,3845,63,338
2440,156,5,757,535,3893,489,612,25,603,2238,3967,63,339
2130,143,5,664,576,3518,383,708,30,547,1854,3522,63,340
1431,189,10,643,568,2841,322,513,69,499,1473,2876,63,341
213,94,6,551,317,1181,70,295,43,238,329,975,63,342
141,86,2,385,166,780,57,200,19,184,267,727,63,343
1873,153,3,674,542,3245,455,502,27,544,1749,3277,63,344
2547,172,2,777,585,4083,449,646,22,638,2373,4128,63,345
2449,171,0,772,544,3936,424,696,23,569,2201,3913,63,346
2234,181,4,754,589,3762,457,685,35,530,2054,3761,63,347
1445,183,12,673,572,2885,352,580,59,533,1470,2994,63,348
398,195,8,860,477,1938,133,629,64,468,638,1932,63,349
216,118,6,534,297,1171,86,332,28,341,428,1215,63,350
1793,130,1,670,511,3105,442,513,26,513,1693,3187,63,351
2360,181,13,737,668,3959,480,601,67,596,2190,3934,63,352
2184,170,6,800,624,3784,446,609,37,566,2122,3780,63,353
1945,163,8,721,594,3431,396,624,45,574,1814,3453,63,354
1188,178,6,583,628,2583,319,520,54,511,1100,2504,63,355
219,140,15,595,315,1284,99,390,58,293,508,1348,63,356
195,85,3,530,278,1091,69,375,25,269,447,1185,63,357
962,134,7,776,453,2332,284,417,33,454,1102,2290,63,358
508,100,3,410,210,1231,216,203,16,367,455,1257,63,359
83,78,2,161,122,446,65,90,13,144,158,470,63,360
660,122,2,698,416,1898,205,394,31,325,908,1863,63,361
661,138,7,820,406,2032,204,344,50,371,865,1834,63,362
212,90,7,506,259,1074,69,246,47,248,397,1007,63,363
160,84,2,499,207,952,62,190,37,245,386,920,63,364
931,127,3,969,481,2511,268,384,19,493,1232,2396,63,365
901,200,31,825,416,2373,261,267,104,609,1063,2304,63,366
171,349,9,1234,803,2566,158,587,5,799,978,2527,64,1
1945,579,22,1524,2393,6463,1587,863,26,1213,2639,6328,64,2
2498,774,12,1605,3168,8057,2193,1108,30,1471,3212,8014,64,3
2532,799,31,1750,3209,8321,2095,1248,31,1482,3261,8117,64,4
1602,1037,67,1732,2928,7366,1403,1631,119,1423,2605,7181,64,5
624,809,47,2347,1347,5174,327,1571,157,1938,1869,5862,64,6
497,553,11,2766,1449,5276,250,1402,30,2003,2557,6242,64,7
2519,920,3,1752,3166,8360,2097,1376,18,1348,3357,8196,64,8
3409,478,19,1895,2581,8382,2425,920,21,1542,3236,8144,64,9
3423,995,21,2185,3821,10445,2579,1604,46,1736,4014,9979,64,10
3106,954,6,2135,3793,9994,2264,1720,12,1765,3665,9426,64,11
1972,966,56,2005,3024,8023,1598,1384,96,1611,2802,7491,64,12
367,1148,60,3176,1939,6690,245,1409,141,1879,2857,6531,64,13
345,639,5,2312,1487,4788,181,900,9,1650,1818,4558,64,14
453,598,11,2035,1410,4507,339,1016,17,1495,1768,4635,64,15
1200,550,7,1287,1544,4588,639,1237,20,1039,1571,4506,64,16
3149,881,4,1979,3216,9229,1743,1591,12,1703,3815,8864,64,17
3531,1039,12,2344,3896,10822,2425,2070,58,1914,3929,10396,64,18
1205,1268,76,1879,2099,6527,730,1632,192,1343,2185,6082,64,19
416,1162,77,2851,2066,6572,257,1434,148,2068,2246,6153,64,20
288,553,7,2331,1425,4604,200,883,16,1646,1852,4597,64,21
2818,876,7,1705,3187,8593,2128,1456,18,1476,3440,8518,64,22
3820,986,10,2003,4144,10963,2877,1879,12,1615,4287,10670,64,23
3803,1055,8,2131,4248,11245,2872,1962,16,1716,4219,10785,64,24
3401,1073,15,2034,3935,10458,2461,1859,48,1643,3902,9913,64,25
2070,1578,147,2135,3085,9015,1451,2178,193,1750,3216,8788,64,26
441,1193,104,2979,2300,7017,257,1705,166,2326,2451,6905,64,27
312,554,13,2427,1365,4671,219,884,25,1870,1676,4674,64,28
2815,831,7,1810,3386,8849,2314,1412,13,1528,3348,8615,64,29
3764,955,13,1945,4227,10904,2929,1704,23,1607,4230,10493,64,30
3737,1144,10,2147,4180,11218,2870,1972,22,1736,4153,10753,64,31
3457,1065,12,2098,3889,10521,2501,1788,54,1725,3915,9983,64,32
2183,1496,72,1994,3466,9211,1717,1913,175,1642,3169,8616,64,33
454,1191,116,2913,2022,6696,277,1554,159,1987,2504,6481,64,34
336,563,17,2401,1453,4770,253,814,27,1664,1932,4690,64,35
2828,793,11,1820,3455,8907,2343,1455,15,1522,3446,8781,64,36
3874,966,15,1995,4217,11067,2933,1939,18,1759,4187,10836,64,37
3818,1086,19,2062,4375,11360,2920,1987,33,1825,4178,10943,64,38
3506,1144,28,2077,3936,10691,2627,1896,41,1647,3970,10181,64,39
2123,1421,100,2175,3280,9099,1702,1805,176,1808,3042,8533,64,40
427,1134,78,2862,2270,6771,282,1754,173,1937,2288,6434,64,41
305,805,10,2114,1628,4862,170,1126,54,1580,1939,4869,64,42
2725,800,55,1848,3329,8757,2198,1504,65,1582,3476,8825,64,43
3555,948,130,2047,3826,10506,2450,1930,152,1559,5001,11092,64,44
3638,1110,35,2274,4248,11305,2697,1878,63,1884,4416,10938,64,45
3361,1134,21,2177,3862,10555,2480,1840,34,1611,3916,9881,64,46
1860,1273,79,2265,2853,8330,1352,1829,149,1753,2823,7906,64,47
450,1146,86,3049,1964,6695,311,1545,150,2032,2494,6532,64,48
358,820,30,2784,1822,5814,209,1277,30,1969,2034,5519,64,49
887,757,25,2280,1730,5679,546,1190,40,1677,2266,5719,64,50
3534,902,49,2093,4018,10596,2740,1695,58,1733,4137,10363,64,51
3738,933,62,2140,4090,10963,2832,1805,83,1806,4012,10538,64,52
3431,1009,25,2103,3873,10441,2645,1808,37,1643,3882,10015,64,53
2068,1294,96,2033,3112,8603,1785,1730,159,1603,3178,8455,64,54
521,1225,69,2982,2260,7057,276,1658,147,2284,2549,6914,64,55
403,618,14,2387,1560,4982,217,1074,6,1740,1896,4933,64,56
2845,811,14,1728,3345,8743,2286,1514,10,1403,3355,8568,64,57
3857,903,15,1971,4084,10830,3021,1815,27,1629,4203,10695,64,58
3769,838,7,2190,3960,10764,2914,1707,12,1855,4107,10595,64,59
3538,1077,15,2078,3804,10512,2682,1924,26,1648,3771,10051,64,60
2138,1287,88,2103,3495,9111,1855,2039,138,1707,3026,8765,64,61
376,1200,82,2820,1996,6474,297,1552,155,1942,2386,6332,64,62
369,621,8,2819,1702,5519,233,1068,13,1936,2160,5410,64,63
2842,839,9,1783,3265,8738,2196,1486,17,1416,3399,8514,64,64
3861,899,14,2005,4057,10836,2856,1857,11,1603,4101,10428,64,65
3824,1018,20,2153,4077,11092,2760,1922,22,1795,4205,10704,64,66
3505,1290,16,2213,4015,11039,2555,2190,54,1779,3963,10541,64,67
2228,1461,87,2322,3386,9484,1797,2059,152,1828,3290,9126,64,68
469,1046,54,2943,1903,6415,319,1533,115,2101,2242,6310,64,69
365,715,6,2863,1724,5673,254,1079,17,1958,2352,5660,64,70
2722,944,7,1983,3383,9039,2286,1578,14,1540,3458,8876,64,71
3694,1140,14,2394,4255,11497,2921,2208,18,1882,4436,11465,64,72
3789,1357,17,2639,4262,12064,2917,2275,30,2025,4469,11716,64,73
3312,1413,16,2555,3999,11295,2367,2487,96,1843,4072,10865,64,74
1999,1500,91,2471,3226,9287,1479,2137,248,1897,3348,9109,64,75
874,1706,112,4358,3040,10090,466,2306,236,3302,3342,9652,64,76
451,923,8,2918,1901,6201,228,1459,11,1984,2360,6042,64,77
2863,977,16,2114,3597,9567,2382,1783,23,1652,3746,9586,64,78
3990,1055,19,2255,4441,11760,3139,2249,25,1877,4290,11580,64,79
3874,1227,20,2447,4600,12168,3005,2548,23,1989,4248,11813,64,80
3643,1256,11,2483,4233,11626,2740,2316,48,1898,4112,11114,64,81
2381,1605,96,2521,3787,10390,1958,2463,210,2015,3494,10140,64,82
423,1454,72,2943,2522,7414,325,2236,183,1859,2842,7445,64,83
604,934,23,3707,2169,7437,288,1591,37,2445,2945,7306,64,84
2830,1590,24,2561,3547,10552,2314,1999,38,1744,4276,10371,64,85
3858,1097,8,2671,4517,12151,2937,2390,16,1865,4602,11810,64,86
3641,1048,3,2527,4150,11369,2715,2136,13,1892,4370,11126,64,87
3194,1275,13,2665,3858,11005,2441,2191,38,1994,4159,10823,64,88
1964,1661,88,2995,3648,10356,1746,2399,163,2083,3671,10062,64,89
630,1462,83,4170,2744,9089,367,2262,138,2769,3265,8801,64,90
554,712,17,2999,1690,5972,284,1295,30,2044,2203,5856,64,91
2522,1026,11,2346,3336,9241,2159,1782,25,1711,3579,9256,64,92
3844,979,9,2569,4290,11691,2887,2051,19,1874,4564,11395,64,93
3742,1098,6,2489,4159,11494,2856,2303,12,1835,4204,11210,64,94
3569,1344,10,2852,4288,12063,2636,2418,20,1982,4469,11525,64,95
2234,1502,70,2923,3608,10337,1525,2484,187,2108,3761,10065,64,96
918,1469,84,3987,2485,8943,372,2215,155,2909,2919,8570,64,97
984,826,17,3296,1870,6993,322,1464,26,2693,2321,6826,64,98
2848,954,20,2348,3232,9402,2320,1698,67,1605,3538,9228,64,99
3821,1087,8,2292,4284,11492,2936,2219,26,1846,4227,11254,64,100
3756,1257,9,2532,4186,11740,2854,2191,26,1824,4375,11270,64,101
3577,1135,12,2460,4096,11280,2582,2228,25,2081,4107,11023,64,102
2321,1547,91,2511,3445,9915,1784,2340,167,2004,3457,9752,64,103
784,1644,91,3641,2660,8820,378,2198,170,2615,3285,8646,64,104
458,863,3,3399,1842,6565,281,1515,29,2284,2393,6502,64,105
2725,1076,7,2196,2939,8943,1859,1949,15,1567,3391,8781,64,106
3606,1155,17,2343,3435,10556,2193,2244,37,1677,4073,10224,64,107
3613,1249,10,2343,3737,10952,2464,2202,24,1884,4035,10609,64,108
3410,1479,12,2373,3604,10878,2230,2357,38,1834,4020,10479,64,109
2103,1820,87,2594,3762,10366,1466,2174,157,2264,4126,10187,64,110
637,1876,111,3680,2830,9134,373,2355,190,2461,3516,8895,64,111
387,714,21,2827,1513,5462,250,1140,31,1811,2131,5363,64,112
2710,978,20,2013,3400,9121,2266,1712,23,1594,3468,9063,64,113
3733,996,3,2371,4425,11528,2990,2164,19,2008,4189,11370,64,114
3670,1214,11,2729,4301,11925,2945,2473,20,2169,4084,11691,64,115
3415,1302,10,2534,4212,11473,2628,2399,22,2076,3960,11085,64,116
2246,1601,80,2558,3599,10084,1954,2364,172,1925,3366,9781,64,117
538,1374,92,3273,2260,7537,368,1876,267,2457,2605,7573,64,118
429,883,6,2847,1731,5896,271,1429,32,1872,2409,6013,64,119
2695,1054,7,2116,3313,9185,2459,1668,15,1704,3337,9183,64,120
3667,1144,15,2225,4180,11231,2898,2009,19,1912,4212,11050,64,121
3608,1198,11,2403,4072,11292,2757,2116,16,2031,4206,11126,64,122
3374,1335,21,2364,4128,11222,2651,2233,36,2094,3934,10948,64,123
2208,1625,90,2458,3643,10024,1891,2361,121,1927,3356,9656,64,124
515,1118,94,3369,1965,7061,317,1751,121,1992,2567,6748,64,125
370,774,12,2530,1597,5283,264,1208,18,1785,1916,5191,64,126
2653,1010,5,1997,3333,8998,2369,1582,15,1769,3296,9031,64,127
3639,1131,14,2211,4324,11319,2991,2104,15,1935,4132,11177,64,128
3503,1480,24,2407,4318,11732,3017,2357,31,1952,4115,11472,64,129
3221,1254,8,2348,4199,11030,2628,2084,20,2031,3771,10534,64,130
2010,1485,67,2246,3327,9135,1843,1797,125,1867,3143,8775,64,131
690,1283,78,3415,2385,7851,393,1518,117,2440,3008,7476,64,132
455,714,2,2411,1521,5103,273,1251,17,1831,1952,5324,64,133
2679,1083,12,2225,3570,9569,2427,1736,23,1798,3609,9593,64,134
3760,1061,4,2359,4095,11279,3068,1924,15,1959,4208,11174,64,135
3722,1116,6,2569,4200,11613,2827,2094,14,2004,4296,11235,64,136
3299,1452,12,2647,4085,11495,2694,2273,30,2151,3956,11104,64,137
2140,1616,87,2551,3366,9760,1815,2036,177,2045,3456,9529,64,138
486,1266,92,2839,1929,6612,261,1713,163,2032,2358,6527,64,139
500,821,2,2742,1650,5715,241,1305,19,1978,2161,5704,64,140
2753,1127,3,2138,3624,9645,2451,1788,16,1683,3604,9542,64,141
3731,1341,5,2299,4372,11748,2953,2116,25,1905,4241,11240,64,142
3693,1418,4,2401,4122,11638,2964,1952,21,2019,4371,11327,64,143
3227,1281,17,2284,3925,10734,2635,1827,34,1863,3770,10129,64,144
1826,1452,96,2740,3232,9346,1608,2061,123,2161,3011,8964,64,145
549,1462,85,3071,2188,7355,345,1890,98,2198,2565,7096,64,146
477,1175,7,2774,1797,6230,265,1518,33,2003,2193,6012,64,147
372,755,7,2247,1366,4747,298,940,26,1605,1863,4732,64,148
3328,1072,15,2198,3949,10562,2835,1726,40,1884,3959,10444,64,149
3603,1225,5,2334,4114,11281,2912,1781,11,1980,4193,10877,64,150
3407,1590,6,2289,4229,11521,2721,2165,18,1920,4118,10942,64,151
2259,1709,87,2166,3535,9756,1857,2116,138,1752,3200,9063,64,152
557,1419,68,3136,2231,7411,335,1778,116,2412,2382,7023,64,153
400,773,4,2593,1612,5382,237,1083,14,1905,2164,5403,64,154
3265,1006,8,2102,3498,9879,2414,1748,13,1719,3832,9726,64,155
4145,1168,10,2173,3935,11431,2700,2066,23,1946,4383,11118,64,156
4063,1148,12,2354,4050,11627,2810,1998,24,1972,4508,11312,64,157
3762,1377,14,2386,4439,11978,2593,2571,57,1924,4329,11474,64,158
2357,1725,111,2331,3892,10416,1567,2813,226,1954,3480,10040,64,159
636,1847,106,4359,3217,10165,348,3425,233,2619,3439,10064,64,160
461,1001,9,3311,2013,6795,230,1535,20,2163,2581,6529,64,161
3062,1089,12,2218,3337,9718,2265,1662,22,1725,3828,9502,64,162
4074,1216,12,2431,4064,11797,2700,2054,20,2047,4618,11439,64,163
4016,1387,18,2506,4222,12149,2748,2629,69,1979,4266,11691,64,164
3678,1465,18,2569,3837,11567,2428,2404,40,1899,4066,10837,64,165
2327,1851,85,2637,3291,10191,1562,2482,161,2063,3255,9523,64,166
594,1673,118,2980,2530,7895,322,2009,157,2257,2723,7468,64,167
455,850,14,2788,1630,5737,250,1288,19,2220,2121,5898,64,168
3027,1196,8,2027,2943,9201,1917,1798,28,1676,3732,9151,64,169
3875,1306,16,2413,3776,11386,2419,2271,60,1906,4374,11030,64,170
1108,1250,12,2742,2340,7452,584,1786,31,2114,2832,7347,64,171
3287,1313,8,2519,3199,10326,1960,2111,27,1890,3991,9979,64,172
2091,1600,77,2352,2913,9033,1401,2226,188,1870,3127,8812,64,173
582,1885,89,3117,2421,8094,353,2431,273,2585,2323,7965,64,174
432,856,6,2537,1620,5451,245,1245,19,1974,1930,5413,64,175
2994,1138,8,2013,2949,9102,1981,1631,18,1616,3632,8878,64,176
4027,1215,30,2203,3772,11247,2429,2106,45,1892,4505,10977,64,177
3872,1198,30,2285,3479,10864,2373,2041,51,1982,4331,10778,64,178
3592,1582,8,2359,3560,11101,2203,2377,28,1961,4135,10704,64,179
2238,1659,99,2352,3070,9418,1464,2200,135,1879,3326,9004,64,180
605,1573,120,3162,2422,7882,398,1993,185,2413,2619,7608,64,181
424,728,9,2513,1618,5292,232,1138,39,1896,1947,5252,64,182
2771,1061,7,2146,2983,8968,1905,1872,13,1652,3414,8856,64,183
3503,1279,15,2485,3722,11004,2276,2167,38,1939,4132,10552,64,184
2881,1453,14,2861,3282,10491,1867,2319,67,2132,3689,10074,64,185
480,2766,21,3130,2131,8528,296,4373,43,2388,2928,10028,64,186
1123,1457,63,2990,2711,8344,975,2098,150,2027,2614,7864,64,187
628,1400,75,2975,1913,6991,337,1674,140,2155,2406,6712,64,188
471,839,9,2602,1496,5417,271,1130,15,2045,1997,5458,64,189
2946,1046,4,2090,2775,8861,1915,1630,21,1552,3690,8808,64,190
3714,1277,5,2169,3242,10407,2148,2024,20,1916,4343,10451,64,191
3767,1284,17,2211,3421,10700,2039,2115,34,1857,4513,10558,64,192
3567,1509,19,2427,3373,10895,2027,2236,44,1926,4219,10452,64,193
2070,1521,80,2174,2863,8708,1367,2051,137,1665,3065,8285,64,194
485,1677,78,3261,2329,7830,331,1932,174,2389,2624,7450,64,195
452,886,13,2728,1868,5947,311,1302,23,2318,2052,6006,64,196
2792,1040,10,1831,2863,8536,1988,1459,31,1532,3558,8568,64,197
3770,1103,13,2032,3434,10352,2442,1938,22,1684,4232,10318,64,198
3747,971,9,2199,3353,10279,2311,1673,15,1804,4242,10045,64,199
3369,1274,15,2229,3524,10411,2121,2057,44,1811,4008,10041,64,200
2148,1646,80,2254,3254,9382,1376,2328,461,1859,3003,9027,64,201
569,1643,86,3301,2377,7976,363,2168,218,2384,2734,7867,64,202
420,887,8,2962,1761,6038,254,1231,20,2181,2299,5985,64,203
2861,995,68,2016,2848,8788,1887,1718,87,1539,3619,8850,64,204
3945,1163,8,2348,3668,11132,2376,2173,24,1849,4443,10865,64,205
3510,1269,7,2484,4012,11282,2204,2305,32,1811,4388,10740,64,206
3326,1447,7,2414,3455,10649,2142,2260,34,1739,3922,10097,64,207
2020,1797,112,2407,2970,9306,1356,2077,241,1827,3297,8798,64,208
556,1649,99,3163,2506,7973,343,2062,304,2384,2593,7686,64,209
499,889,14,2860,1947,6209,280,1433,88,2271,2098,6170,64,210
2783,952,5,2114,3109,8963,1912,1670,63,1625,3557,8827,64,211
3691,1182,7,2267,3529,10676,2361,1819,19,1764,4366,10329,64,212
3645,1281,12,2276,3259,10473,2145,1928,36,1865,4140,10114,64,213
3263,1346,13,2241,3398,10261,1977,2098,35,1811,3864,9785,64,214
2011,1517,79,2319,2951,8877,1320,2252,156,1850,3057,8635,64,215
585,965,69,3065,2016,6700,348,1461,136,2115,2399,6459,64,216
442,771,6,2628,1616,5463,275,1136,17,2043,1936,5407,64,217
2493,938,20,1852,2825,8128,1788,1607,29,1488,3249,8161,64,218
3458,1033,7,2152,3493,10143,2305,1955,24,1700,4007,9991,64,219
3329,1112,18,2310,3280,10049,2216,1749,44,1805,3841,9655,64,220
2929,985,11,1990,3036,8951,1901,1762,28,1714,3397,8802,64,221
1458,1302,66,1851,2402,7079,1134,1709,230,1424,2361,6858,64,222
496,1296,81,2892,2120,6885,370,1785,137,2189,2289,6770,64,223
377,750,6,2614,1716,5463,266,1136,22,1980,1989,5393,64,224
2480,1054,10,1987,2691,8222,1733,1560,9,1524,3277,8103,64,225
3329,1108,15,2177,3355,9984,2174,1777,35,1803,3915,9704,64,226
3213,1280,8,2169,3413,10083,2170,1941,20,1712,3855,9698,64,227
3020,1185,8,2228,3419,9860,1934,1986,53,1784,3644,9401,64,228
1926,1443,106,2285,2815,8575,1333,2123,142,1747,2868,8213,64,229
485,1408,99,2978,2094,7064,364,1668,164,2197,2395,6788,64,230
377,689,7,2628,1629,5330,268,996,13,1943,2027,5247,64,231
2435,864,12,1955,2730,7996,1796,1285,20,1543,3336,7980,64,232
3237,1144,6,2206,3411,10004,2161,1960,16,1759,3990,9886,64,233
3179,1139,7,2295,3481,10101,2137,2012,27,1755,3894,9825,64,234
3006,1259,8,2269,3186,9728,2014,1995,30,1739,3728,9506,64,235
1881,1576,78,2383,2956,8874,1391,2113,164,1840,3013,8521,64,236
559,1600,79,3098,2322,7658,373,1994,168,2393,2580,7508,64,237
406,767,10,2906,1741,5830,308,1156,44,2107,2088,5703,64,238
2823,926,15,1924,3270,8958,2061,1718,26,1525,3598,8928,64,239
3738,1034,21,2293,4058,11144,2687,2120,38,1731,4269,10845,64,240
3597,1083,11,2355,3879,10925,2542,1959,25,1774,4069,10369,64,241
3304,1029,15,2340,3753,10441,2228,1808,45,1799,4065,9945,64,242
1998,1566,64,2480,3063,9171,1483,1938,210,1977,3203,8811,64,243
521,1213,98,2987,2172,6991,328,1694,125,2145,2357,6649,64,244
438,1144,7,2745,1985,6319,273,1552,28,2015,2517,6385,64,245
406,848,13,2527,1720,5514,314,1167,23,1913,2131,5548,64,246
3854,952,16,2114,3834,10770,2601,1904,27,1778,4205,10515,64,247
3927,1071,17,2254,3861,11130,2589,1955,33,1788,4404,10769,64,248
3764,1365,53,2243,4083,11508,2581,2183,74,1843,4280,10961,64,249
2407,1843,76,2263,3502,10091,1806,2129,169,1909,3606,9619,64,250
583,1493,81,3350,2246,7753,360,2026,232,2422,2693,7733,64,251
459,778,1,2928,1781,5947,288,1267,16,2308,2231,6110,64,252
3291,1012,18,2083,3483,9887,2409,1830,23,1635,3708,9605,64,253
4360,1576,21,2218,4251,12426,2906,2662,45,1863,4631,12107,64,254
4167,1297,18,2429,4185,12096,2829,2426,38,1960,4500,11753,64,255
4021,1406,5,2565,4313,12310,2632,2572,31,1964,4453,11652,64,256
2526,1847,128,2348,3823,10672,1755,2572,240,1964,3740,10271,64,257
579,1758,145,3541,2518,8541,371,2354,232,2749,2786,8492,64,258
511,778,6,3083,1773,6151,318,1235,13,2333,2298,6197,64,259
3284,1035,13,2217,3498,10047,2429,1758,25,1693,4043,9948,64,260
4375,1091,8,2288,4137,11899,2908,2207,28,1841,4838,11822,64,261
4370,1237,3,2494,4133,12237,2914,2307,30,2294,4515,12060,64,262
4072,1536,19,2599,4419,12645,2661,2621,47,2124,4519,11972,64,263
2491,1964,136,2453,3619,10663,1732,2475,169,2122,3796,10294,64,264
639,2401,134,3483,3268,9925,436,2062,238,3105,3201,9042,64,265
401,757,6,2787,1722,5673,307,1250,18,2204,2030,5809,64,266
3343,1016,6,2014,3595,9974,2462,1907,14,1615,3960,9958,64,267
4439,1135,22,2344,4359,12299,2995,2215,37,1901,5012,12160,64,268
4386,1394,8,2421,4246,12455,2927,2417,26,1976,5019,12365,64,269
3855,1711,7,2609,4252,12434,2631,2441,46,2029,4844,11991,64,270
2512,1826,103,2628,3731,10800,1849,2535,195,2096,3806,10481,64,271
636,1896,143,3801,3084,9560,428,2779,208,2853,3029,9297,64,272
483,702,10,2948,1782,5925,299,1263,16,2215,2129,5922,64,273
3340,1060,7,2202,3627,10236,2340,1834,17,1877,3920,9988,64,274
4519,1293,5,2283,4323,12423,2944,2243,15,1908,4747,11857,64,275
4146,1272,8,2435,4258,12119,2829,2170,27,1906,4651,11583,64,276
3728,1459,6,2480,4120,11793,2452,2351,41,1991,4433,11268,64,277
2558,1870,95,2549,3673,10745,1826,2429,160,2116,3794,10325,64,278
597,1696,132,3927,2788,9140,445,2371,191,2949,3077,9033,64,279
512,798,5,3265,1898,6478,328,1372,22,2420,2401,6543,64,280
3332,1110,4,2176,3637,10259,2437,1977,19,1742,4059,10234,64,281
4516,1322,8,2439,4493,12778,2992,2333,23,1967,4980,12295,64,282
4290,1457,8,2747,4335,12837,2973,2405,33,2109,4932,12452,64,283
3769,1516,15,2510,4027,11837,2402,2519,23,1988,4719,11651,64,284
2312,1902,105,2928,3430,10677,1450,2403,172,2256,3859,10140,64,285
782,1629,105,3772,2667,8955,395,2282,194,2710,3059,8640,64,286
578,924,9,3321,2189,7021,302,1540,17,2689,2582,7130,64,287
1531,912,3,2658,2141,7245,685,1720,9,1936,2933,7283,64,288
4260,1165,5,2536,4302,12268,2823,2240,18,2017,4814,11912,64,289
4351,1246,14,2683,4284,12578,2833,2348,26,2032,4874,12113,64,290
4022,1569,13,2556,4409,12569,2553,2696,49,2237,4856,12391,64,291
2499,1984,151,2732,3913,11279,1753,2764,203,2252,3902,10874,64,292
696,2065,169,3843,3091,9864,416,2636,299,3036,3390,9777,64,293
501,888,12,3267,2152,6820,316,1569,40,2470,2535,6930,64,294
3309,1155,2,2471,3814,10751,2426,2193,32,1782,4175,10608,64,295
4635,1276,9,2624,4523,13067,3100,2470,26,2048,5118,12762,64,296
4492,1528,1,2843,4575,13439,3076,2664,14,2091,5224,13069,64,297
4225,1673,15,2677,4771,13361,2712,2914,41,2105,5164,12936,64,298
2630,1899,107,2716,3735,11087,1822,2583,234,2210,3861,10710,64,299
686,1961,142,3908,2967,9664,434,2613,240,3101,3287,9675,64,300
1001,874,5,3461,2068,7409,323,1486,15,2838,2526,7188,64,301
3475,1004,5,2303,3939,10726,2537,1845,29,1879,4187,10477,64,302
4306,1333,7,2663,5448,13757,3019,3643,29,2244,4619,13554,64,303
4397,1449,31,2710,4728,13315,3144,2600,48,2198,5004,12994,64,304
3856,1719,13,2751,4175,12514,2678,2345,42,2018,4879,11962,64,305
2346,2010,124,2554,3753,10787,1868,2438,206,2233,3687,10432,64,306
580,1761,159,3558,2777,8835,376,2489,197,2583,3067,8712,64,307
560,781,2,3021,1889,6253,314,1213,22,2288,2467,6304,64,308
3262,947,5,2174,3376,9764,2155,1870,16,1676,3903,9620,64,309
3262,1272,14,2395,3204,10147,1919,1775,97,1986,4068,9845,64,310
3242,1071,7,2299,3857,10476,2373,1718,19,1958,4048,10116,64,311
3791,1454,13,2487,4358,12103,2770,2124,26,1940,4688,11548,64,312
2452,1744,90,2485,3766,10537,1838,2256,223,2100,3846,10263,64,313
705,1646,108,3809,3241,9509,435,2049,219,3374,3269,9346,64,314
428,788,2,3090,2260,6568,278,1155,32,2534,2705,6704,64,315
1622,847,1,2739,2025,7234,723,1600,21,1998,2974,7316,64,316
4484,1085,10,2393,4266,12238,3045,2204,34,1981,5023,12287,64,317
4560,1291,5,2615,4565,13036,3100,2389,20,2068,5184,12761,64,318
4126,1212,8,2508,4538,12392,2882,2333,49,2091,5009,12364,64,319
2612,1892,157,2557,4105,11323,1988,2305,199,2248,4204,10944,64,320
919,1759,117,4319,3505,10619,589,2689,283,3926,4871,12358,64,321
625,884,23,3428,2387,7347,349,1849,69,3127,3302,8696,64,322
3464,1085,9,2145,3810,10513,2544,1813,21,1767,4236,10381,64,323
4566,1188,10,2412,4643,12819,3069,2300,26,2067,5192,12654,64,324
4371,1243,4,2678,4514,12810,3078,2163,23,2140,5005,12409,64,325
4104,1357,11,2556,4617,12645,2757,2355,33,2125,4811,12081,64,326
2543,1448,118,2310,3557,9976,1898,1895,205,2066,3470,9534,64,327
508,1334,95,3271,2629,7837,340,1758,225,2455,2699,7477,64,328
377,687,12,2651,1732,5459,237,1104,48,1910,2005,5304,64,329
2570,894,32,2267,3301,9064,2068,1390,43,1827,3467,8795,64,330
2725,1037,40,2367,3614,9783,2100,1572,47,2031,3308,9058,64,331
1575,860,2,2552,2343,7332,1196,1030,16,1966,2244,6452,64,332
281,403,7,1210,696,2597,178,695,27,671,778,2349,64,333
532,726,33,2117,1488,4896,538,1204,89,1608,1846,5285,64,334
313,860,39,2265,1782,5259,350,1367,109,1944,2085,5855,64,335
286,629,3,2112,1484,4514,268,1192,14,1870,1867,5211,64,336
2928,871,10,2000,3320,9129,2275,1618,18,1845,3838,9594,64,337
4143,1079,19,2402,4516,12159,2891,2264,43,2035,5063,12296,64,338
4207,1249,13,2540,4515,12524,2913,2269,29,2112,4937,12260,64,339
3916,1283,19,2513,4503,12234,2641,2585,55,1996,4796,12073,64,340
2498,1652,112,2347,3790,10399,1678,2308,210,2095,3944,10235,64,341
467,1664,145,3783,2974,9033,367,2582,227,2526,3238,8940,64,342
386,921,9,3365,2347,7028,289,1723,35,2342,2959,7348,64,343
3327,1238,9,2126,3775,10475,2486,2001,29,1805,4109,10430,64,344
4433,1266,13,2596,4713,13021,3159,2592,31,2134,5170,13086,64,345
4331,1339,11,2538,4236,12455,2901,2351,28,2112,4784,12176,64,346
4059,1675,11,2753,5117,13615,2747,2891,43,2423,5065,13169,64,347
2602,1940,154,2916,4148,11760,1825,2567,213,2367,4260,11232,64,348
607,1652,175,3901,3055,9390,357,2171,216,2907,3324,8975,64,349
369,761,6,2901,1991,6028,269,1305,22,2433,2145,6174,64,350
2959,1107,17,2057,3720,9860,2256,1683,34,1841,3842,9656,64,351
3811,1224,9,2458,4484,11986,2872,2088,32,2024,4393,11409,64,352
3647,1228,9,2431,4293,11608,2764,1922,26,1914,4408,11034,64,353
3151,1250,11,2397,4216,11025,2516,2013,18,2080,4006,10633,64,354
1873,1309,84,2536,2937,8739,1524,1634,116,1921,2992,8187,64,355
460,835,102,2550,1870,5817,313,1074,79,1883,2074,5423,64,356
283,585,10,1919,1413,4210,239,795,16,1449,1461,3960,64,357
994,607,15,1906,2087,5609,1017,875,23,1437,1821,5173,64,358
586,346,6,1561,1056,3555,505,484,13,1088,999,3089,64,359
129,205,2,582,435,1353,104,359,10,332,479,1284,64,360
587,568,11,1383,1502,4051,691,915,14,1126,1557,4303,64,361
715,809,54,1720,1815,5113,679,1137,79,1394,2054,5343,64,362
340,757,67,1829,1483,4476,303,1184,66,1435,1583,4571,64,363
238,555,13,2039,1381,4226,231,906,32,1508,1547,4224,64,364
1159,904,13,2215,2505,6796,1097,1290,27,1786,2641,6841,64,365
1127,1304,578,2597,1928,7534,1079,1472,625,2089,2419,7684,64,366
63,112,5,210,180,570,59,116,12,256,207,650,65,1
532,132,4,407,511,1586,342,219,12,336,745,1654,65,2
676,165,6,483,545,1875,378,262,17,394,845,1896,65,3
713,153,2,447,520,1835,361,257,10,339,848,1815,65,4
482,189,16,395,458,1540,267,273,32,350,611,1533,65,5
81,129,7,281,242,740,77,185,31,242,166,701,65,6
70,141,3,392,222,828,54,161,14,331,286,846,65,7
705,159,8,418,491,1781,321,302,12,374,815,1824,65,8
821,122,5,421,365,1734,408,205,12,402,691,1718,65,9
889,198,2,517,608,2214,417,303,9,431,1016,2176,65,10
825,191,4,504,608,2132,418,385,13,413,899,2128,65,11
512,179,8,448,468,1615,256,261,33,400,651,1601,65,12
128,179,12,573,328,1220,112,233,41,397,482,1265,65,13
85,131,9,284,220,729,55,150,22,328,240,795,65,14
167,119,16,384,262,948,140,167,31,323,304,965,65,15
284,146,8,274,281,993,176,203,15,291,315,1000,65,16
706,144,15,427,530,1822,357,299,23,326,751,1756,65,17
811,179,1,448,579,2018,381,386,16,320,851,1954,65,18
275,143,15,318,236,987,175,179,30,232,344,960,65,19
110,155,12,303,311,891,67,204,31,297,278,877,65,20
46,86,2,312,216,662,58,143,13,269,260,743,65,21
686,171,17,407,460,1741,297,232,22,351,786,1688,65,22
966,186,2,443,628,2225,465,357,6,367,990,2185,65,23
926,169,6,532,608,2241,443,399,14,379,970,2205,65,24
827,189,10,474,600,2100,378,367,19,399,886,2049,65,25
576,285,13,506,573,1953,301,368,65,414,743,1891,65,26
139,210,8,563,416,1336,98,279,43,455,418,1293,65,27
72,137,20,356,240,825,69,139,26,322,289,845,65,28
741,157,8,419,488,1813,329,249,12,358,830,1778,65,29
965,209,9,460,619,2262,484,394,18,399,956,2251,65,30
896,186,8,498,601,2189,468,375,18,377,935,2173,65,31
887,200,9,462,555,2113,384,356,21,425,912,2098,65,32
571,224,8,485,509,1797,268,333,32,408,684,1725,65,33
110,188,20,412,343,1073,91,199,32,348,374,1044,65,34
66,119,2,352,218,757,57,133,9,291,268,758,65,35
752,172,12,469,492,1897,363,283,17,366,792,1821,65,36
1008,203,5,500,734,2450,476,405,12,470,1028,2391,65,37
955,190,3,537,685,2370,487,374,13,415,1027,2316,65,38
905,179,1,509,647,2241,446,361,14,414,944,2179,65,39
554,242,10,506,513,1825,288,296,61,444,669,1758,65,40
145,213,20,564,423,1365,120,344,59,428,428,1379,65,41
104,150,7,438,288,987,75,189,25,355,369,1013,65,42
762,166,2,446,531,1907,346,262,14,396,836,1854,65,43
809,223,9,531,593,2165,426,423,22,406,886,2163,65,44
966,225,5,560,653,2409,445,378,24,443,1050,2340,65,45
889,210,9,462,557,2127,379,380,15,399,887,2060,65,46
533,229,13,479,497,1751,281,296,51,408,677,1713,65,47
97,174,7,348,282,908,85,214,40,297,340,976,65,48
89,156,5,412,245,907,65,200,21,342,313,941,65,49
206,171,6,429,356,1168,168,189,13,358,423,1151,65,50
934,199,1,420,633,2187,425,373,9,397,962,2166,65,51
931,205,1,505,566,2208,434,351,16,406,990,2197,65,52
885,184,3,466,546,2084,364,377,13,402,900,2056,65,53
581,203,7,460,506,1757,283,278,29,450,705,1745,65,54
96,119,4,352,267,838,80,159,24,265,282,810,65,55
59,84,3,243,188,577,65,119,8,213,198,603,65,56
757,213,2,365,537,1874,357,313,16,380,813,1879,65,57
973,193,3,504,664,2337,489,393,17,448,994,2341,65,58
919,206,21,521,618,2285,438,375,26,433,1004,2276,65,59
887,206,1,457,560,2111,377,390,14,412,902,2095,65,60
565,223,11,493,558,1850,263,341,44,370,698,1716,65,61
112,212,13,402,357,1096,98,247,48,338,354,1085,65,62
97,155,6,473,263,994,71,198,13,418,358,1058,65,63
750,165,19,470,494,1898,355,269,20,387,830,1861,65,64
942,214,6,469,621,2252,446,347,20,400,1043,2256,65,65
946,178,13,510,632,2279,415,383,19,405,982,2204,65,66
906,217,14,535,628,2300,419,381,49,492,952,2293,65,67
572,287,17,509,616,2001,299,398,56,460,739,1952,65,68
118,136,2,281,211,748,105,120,20,249,222,716,65,69
67,116,10,254,203,650,67,129,15,250,181,642,65,70
744,215,14,458,560,1991,349,318,21,415,901,2004,65,71
984,277,12,617,785,2675,636,432,16,522,1104,2710,65,72
998,267,11,588,757,2621,574,475,27,533,1008,2617,65,73
944,244,4,737,696,2625,507,446,14,469,1054,2490,65,74
596,233,11,489,522,1851,303,293,44,394,788,1822,65,75
105,189,9,438,296,1037,100,247,41,314,345,1047,65,76
60,101,7,324,225,717,67,177,16,229,239,728,65,77
789,191,4,593,530,2107,380,321,9,417,974,2101,65,78
992,255,12,626,748,2633,503,503,21,494,1086,2607,65,79
974,234,3,625,719,2555,483,506,14,481,1044,2528,65,80
903,225,8,597,645,2378,433,450,13,431,995,2322,65,81
593,289,5,598,629,2114,280,429,56,475,792,2032,65,82
108,216,8,402,371,1105,84,261,48,321,325,1039,65,83
134,126,13,634,339,1246,75,263,26,409,521,1294,65,84
659,192,7,569,574,2001,330,327,22,413,826,1918,65,85
886,180,10,605,667,2348,463,449,14,476,1011,2413,65,86
870,193,11,553,579,2206,434,351,21,416,875,2097,65,87
762,201,8,542,560,2073,366,401,19,414,857,2057,65,88
457,277,12,594,544,1884,264,407,36,431,743,1881,65,89
142,213,13,693,429,1490,105,377,50,410,564,1506,65,90
87,142,2,481,298,1010,69,248,9,330,388,1044,65,91
676,191,1,520,471,1859,316,372,13,357,789,1847,65,92
892,248,4,586,604,2334,440,421,12,447,988,2308,65,93
915,233,10,480,623,2261,417,425,11,367,924,2144,65,94
921,232,4,671,631,2459,458,469,11,452,937,2327,65,95
598,308,14,556,667,2143,321,414,40,464,800,2039,65,96
173,273,10,611,443,1510,117,303,51,463,506,1440,65,97
178,193,3,540,374,1288,93,327,11,430,436,1297,65,98
752,222,6,518,530,2028,364,320,10,391,863,1948,65,99
967,229,4,559,651,2410,447,456,29,440,996,2368,65,100
935,229,2,582,632,2380,440,444,12,449,1064,2409,65,101
899,214,8,507,624,2252,403,433,22,433,947,2238,65,102
565,280,18,505,620,1988,309,428,44,426,699,1906,65,103
217,252,12,577,414,1472,148,313,62,422,455,1400,65,104
80,207,13,551,318,1169,76,278,10,377,498,1239,65,105
744,166,4,502,559,1975,339,401,10,393,843,1986,65,106
991,238,5,579,667,2480,526,489,17,430,1082,2544,65,107
1019,264,3,572,707,2565,495,483,15,453,1102,2548,65,108
924,248,1,633,761,2567,476,493,16,453,992,2430,65,109
581,256,12,664,626,2139,330,406,56,468,781,2041,65,110
157,260,18,729,433,1597,120,451,50,432,550,1603,65,111
313,148,4,768,261,1494,93,213,8,387,308,1009,65,112
745,198,4,496,475,1918,360,340,8,407,854,1969,65,113
953,239,9,561,681,2443,488,469,19,426,1043,2445,65,114
953,223,4,534,707,2421,435,502,15,417,1019,2388,65,115
961,248,12,681,641,2543,435,573,28,523,1029,2588,65,116
563,268,6,506,573,1916,289,392,57,423,733,1894,65,117
160,232,13,423,380,1208,120,270,85,371,365,1211,65,118
132,153,4,509,297,1095,80,246,31,337,395,1089,65,119
761,230,7,508,535,2041,386,351,19,460,869,2085,65,120
955,219,7,513,637,2331,486,393,15,418,1031,2343,65,121
959,216,1,534,658,2368,449,447,10,436,996,2338,65,122
996,211,7,507,631,2352,425,433,24,423,986,2291,65,123
600,293,15,541,589,2038,287,379,59,475,780,1980,65,124
165,195,11,500,319,1190,103,272,39,372,357,1143,65,125
81,134,2,408,243,868,63,184,11,317,304,879,65,126
755,222,5,504,513,1999,383,304,15,394,899,1995,65,127
965,219,3,595,738,2520,542,493,16,448,1054,2553,65,128
954,258,6,597,747,2562,519,469,20,459,1036,2503,65,129
901,259,7,548,690,2405,461,413,19,435,968,2296,65,130
610,265,23,520,530,1948,351,334,52,477,698,1912,65,131
177,183,12,571,365,1308,115,254,44,427,459,1299,65,132
90,138,2,372,251,853,71,192,13,356,263,895,65,133
774,221,8,500,567,2070,388,352,15,428,862,2045,65,134
987,223,3,562,666,2441,541,414,15,443,954,2367,65,135
959,267,4,532,719,2481,504,417,26,450,1061,2458,65,136
906,291,6,561,738,2502,457,453,28,497,1032,2467,65,137
604,266,13,544,559,1986,317,367,70,452,772,1978,65,138
129,219,17,506,382,1253,108,304,55,416,373,1256,65,139
138,166,5,473,298,1080,79,239,13,391,401,1123,65,140
785,232,3,471,594,2085,418,360,12,440,842,2072,65,141
1003,236,3,491,762,2495,527,430,13,449,1074,2493,65,142
987,234,5,606,723,2555,497,425,23,479,1077,2501,65,143
879,260,8,524,673,2344,462,394,23,463,1040,2382,65,144
566,290,10,554,581,2001,337,372,48,538,682,1977,65,145
152,192,15,647,433,1439,111,365,60,480,353,1369,65,146
85,168,1,546,283,1083,73,234,24,417,355,1103,65,147
110,127,1,363,252,853,106,161,6,351,302,926,65,148
947,236,8,520,660,2371,541,365,25,436,973,2340,65,149
982,212,5,526,628,2353,487,354,11,450,951,2253,65,150
916,256,7,567,705,2451,475,426,23,487,957,2368,65,151
603,257,9,538,560,1967,360,348,36,457,759,1960,65,152
130,279,15,573,393,1390,108,354,44,419,429,1354,65,153
103,163,7,444,294,1011,80,235,15,381,357,1068,65,154
896,226,11,521,599,2253,422,363,17,454,1034,2290,65,155
1179,251,5,649,809,2893,552,516,14,502,1216,2800,65,156
1214,241,2,649,706,2812,511,463,16,548,1199,2737,65,157
1161,265,11,599,782,2818,603,504,28,531,1121,2787,65,158
715,303,10,666,796,2490,462,496,61,516,872,2407,65,159
178,277,9,866,475,1805,132,554,47,541,516,1790,65,160
108,159,5,594,345,1211,99,250,10,436,442,1237,65,161
920,215,6,543,593,2277,434,384,13,499,999,2329,65,162
1219,268,3,633,767,2890,601,473,19,508,1272,2873,65,163
1125,258,5,661,748,2797,573,489,33,507,1142,2744,65,164
1013,272,5,699,696,2685,503,502,23,498,1114,2640,65,165
668,272,9,599,672,2220,349,454,58,494,804,2159,65,166
183,272,16,665,461,1597,122,409,51,474,499,1555,65,167
125,209,2,550,314,1200,87,299,10,443,478,1317,65,168
907,273,2,599,673,2454,495,371,8,510,970,2354,65,169
1152,259,2,640,895,2948,578,466,20,531,1182,2777,65,170
378,244,8,593,491,1714,269,372,20,491,515,1667,65,171
993,300,6,651,686,2636,513,432,12,478,1077,2512,65,172
657,258,8,575,482,1980,339,380,41,443,743,1946,65,173
140,258,12,463,369,1242,111,295,55,406,356,1223,65,174
120,160,2,395,273,950,97,234,21,374,328,1054,65,175
889,237,3,515,596,2240,430,431,12,434,981,2288,65,176
1145,267,11,569,757,2749,578,470,11,451,1157,2667,65,177
1101,234,3,651,728,2717,519,511,12,490,1180,2712,65,178
1028,261,5,685,723,2702,519,548,22,475,1074,2638,65,179
688,329,15,600,580,2212,336,438,45,526,821,2166,65,180
180,232,14,623,418,1467,107,329,48,453,453,1390,65,181
117,150,3,352,236,858,76,185,12,351,273,897,65,182
847,245,6,561,624,2283,430,398,13,437,979,2257,65,183
1056,237,5,645,770,2713,545,414,13,524,1121,2617,65,184
892,273,7,611,733,2516,454,463,23,507,951,2398,65,185
157,726,11,540,835,2269,96,1052,57,381,378,1964,65,186
418,271,8,551,439,1687,228,352,49,456,606,1691,65,187
133,252,8,463,323,1179,114,270,47,397,385,1213,65,188
117,150,26,422,270,985,84,259,25,352,388,1108,65,189
841,228,34,535,551,2189,461,360,37,433,937,2228,65,190
1050,241,24,658,737,2710,628,447,41,526,1064,2706,65,191
1000,225,6,677,680,2588,550,426,19,493,1012,2500,65,192
960,265,8,569,690,2492,504,445,18,515,1020,2502,65,193
642,235,9,568,522,1976,334,346,55,427,809,1971,65,194
153,249,7,550,442,1401,145,309,46,441,418,1359,65,195
108,158,2,386,295,949,94,218,14,355,314,995,65,196
863,200,16,471,529,2079,433,325,24,412,857,2051,65,197
1087,277,4,548,756,2672,609,479,14,515,1100,2717,65,198
1101,283,19,589,623,2615,520,411,30,494,1086,2541,65,199
1018,313,12,645,634,2622,521,464,26,492,1068,2571,65,200
658,344,12,593,592,2199,354,406,86,495,804,2145,65,201
142,295,14,590,457,1498,111,352,51,455,460,1429,65,202
118,191,10,503,286,1108,100,291,18,401,320,1130,65,203
886,260,18,520,633,2317,396,452,26,395,983,2252,65,204
1150,271,18,606,748,2793,588,519,24,530,1158,2819,65,205
1046,229,1,666,695,2637,492,460,15,503,1079,2549,65,206
1021,254,27,695,652,2649,499,467,34,530,1120,2650,65,207
679,356,31,549,478,2093,306,416,72,439,817,2050,65,208
205,290,21,623,401,1540,129,350,120,455,416,1470,65,209
122,157,16,442,314,1051,91,247,33,439,343,1153,65,210
808,192,12,611,584,2207,414,347,50,502,938,2251,65,211
1055,208,2,634,692,2591,575,408,13,486,1157,2639,65,212
1083,229,15,605,628,2560,535,444,27,465,1032,2503,65,213
967,255,3,588,628,2441,478,425,19,465,1042,2429,65,214
699,289,17,610,586,2201,363,396,75,412,853,2099,65,215
208,210,11,638,350,1417,104,290,52,441,411,1298,65,216
122,176,7,436,247,988,72,264,18,330,371,1055,65,217
802,202,5,495,569,2073,384,379,14,406,979,2162,65,218
1009,234,8,566,665,2482,560,412,21,423,1057,2473,65,219
955,202,5,561,653,2376,485,382,22,432,1084,2405,65,220
850,227,2,517,553,2149,400,339,18,431,961,2149,65,221
517,204,10,545,489,1765,263,304,60,382,610,1619,65,222
147,193,8,538,405,1291,103,317,32,450,406,1308,65,223
101,156,4,455,273,989,82,222,14,380,373,1071,65,224
731,208,3,485,455,1882,360,324,11,388,847,1930,65,225
986,225,4,550,649,2414,530,385,18,440,1047,2420,65,226
978,220,1,599,630,2428,478,377,7,460,1017,2339,65,227
892,234,7,574,579,2286,431,408,22,499,910,2270,65,228
589,268,9,522,507,1895,301,361,48,481,760,1951,65,229
132,190,10,569,380,1281,109,248,48,457,403,1265,65,230
75,122,1,393,235,826,65,174,14,358,308,919,65,231
758,190,3,487,495,1933,352,280,11,421,882,1946,65,232
937,230,11,523,662,2363,514,396,23,429,1026,2388,65,233
940,248,2,568,662,2420,442,417,32,443,1036,2370,65,234
842,228,9,556,611,2246,415,381,22,453,937,2208,65,235
591,275,10,523,530,1929,287,382,43,416,776,1904,65,236
170,212,3,600,392,1377,120,351,35,417,460,1383,65,237
83,132,2,436,247,900,75,189,8,392,337,1001,65,238
775,162,1,485,543,1966,367,332,9,389,864,1961,65,239
1026,230,18,587,879,2740,605,502,32,535,1040,2714,65,240
999,215,5,555,754,2528,558,428,12,469,1035,2502,65,241
947,222,7,538,606,2320,438,382,27,455,964,2266,65,242
530,238,11,547,577,1903,272,368,55,480,658,1833,65,243
137,179,5,602,347,1270,113,283,41,479,457,1373,65,244
78,182,1,493,249,1003,65,203,13,382,405,1068,65,245
110,130,1,394,265,900,91,173,6,353,323,946,65,246
916,198,3,490,631,2238,494,364,7,436,934,2235,65,247
949,231,4,531,646,2361,506,375,10,443,1013,2347,65,248
936,216,3,581,624,2360,471,387,18,456,1013,2345,65,249
647,236,14,526,538,1961,356,374,45,481,737,1993,65,250
139,234,17,575,437,1402,108,290,78,474,421,1371,65,251
104,142,4,489,288,1027,87,212,9,444,361,1113,65,252
792,196,1,448,570,2007,385,315,15,428,915,2058,65,253
1064,220,4,531,752,2571,543,424,21,467,1027,2482,65,254
996,249,4,565,744,2558,516,449,13,488,1096,2562,65,255
965,285,7,576,659,2492,487,458,20,480,1074,2519,65,256
672,333,17,545,693,2260,375,534,68,487,878,2342,65,257
138,238,11,515,458,1360,135,256,30,610,351,1382,65,258
79,128,4,350,377,938,84,153,8,439,280,964,65,259
810,190,2,568,525,2095,393,340,6,414,885,2038,65,260
1018,196,4,556,679,2453,567,384,10,480,1059,2500,65,261
918,229,3,588,704,2442,498,375,18,473,1013,2377,65,262
947,218,2,537,690,2394,495,443,9,474,1021,2442,65,263
648,283,18,544,573,2066,387,349,59,453,809,2057,65,264
150,218,8,588,443,1407,137,346,51,489,401,1424,65,265
96,160,7,419,265,947,83,222,9,371,366,1051,65,266
814,170,3,481,530,1998,449,275,13,425,874,2036,65,267
996,194,4,573,781,2548,584,437,18,464,1088,2591,65,268
990,210,2,588,729,2519,554,416,15,460,1099,2544,65,269
936,225,6,623,743,2533,524,452,22,500,974,2472,65,270
599,218,12,607,677,2113,423,362,54,484,707,2030,65,271
148,249,13,605,480,1495,114,371,44,486,501,1516,65,272
101,141,2,389,272,905,85,194,7,322,306,914,65,273
771,174,2,482,486,1915,383,289,10,387,855,1924,65,274
1005,202,7,479,641,2334,565,380,23,392,1025,2385,65,275
948,202,3,509,624,2286,471,359,16,450,993,2289,65,276
854,228,1,595,576,2254,424,396,22,511,980,2333,65,277
611,306,18,538,589,2062,384,377,60,465,782,2068,65,278
162,233,15,597,393,1400,105,353,45,475,439,1417,65,279
112,127,1,469,306,1015,78,215,6,480,336,1115,65,280
822,164,4,483,565,2038,384,291,9,393,901,1978,65,281
1002,195,14,480,690,2381,577,434,18,437,992,2458,65,282
996,224,15,593,675,2503,510,388,23,488,1088,2497,65,283
932,214,5,591,708,2450,490,448,19,515,1005,2477,65,284
591,263,12,559,604,2029,326,339,74,492,780,2011,65,285
14,15,5,23,10,67,12,17,1,24,11,65,65,286
10,2,0,9,4,25,12,1,1,11,4,29,65,287
14,6,2,13,10,45,13,6,5,14,9,47,65,288
973,179,19,554,722,2447,510,492,20,397,1002,2421,65,289
1005,190,5,552,677,2429,481,423,25,442,1084,2455,65,290
869,230,5,552,649,2305,433,488,21,396,943,2281,65,291
602,270,20,595,618,2105,318,436,67,461,776,2058,65,292
144,233,19,592,422,1410,105,321,74,478,499,1477,65,293
102,126,2,441,315,986,87,264,15,355,306,1027,65,294
806,179,5,457,549,1996,390,330,19,392,882,2013,65,295
1065,244,10,560,758,2637,566,464,16,449,1143,2638,65,296
1038,202,10,609,773,2632,562,463,22,502,1110,2659,65,297
915,291,10,608,726,2550,492,494,29,449,1045,2509,65,298
634,292,8,650,592,2176,377,400,59,486,801,2123,65,299
164,266,24,518,438,1410,105,350,70,488,442,1455,65,300
188,137,4,441,264,1034,89,233,21,406,387,1136,65,301
771,210,10,509,543,2043,363,349,12,455,951,2130,65,302
982,184,6,588,1005,2765,569,620,28,465,1040,2722,65,303
973,215,4,656,771,2619,530,464,17,464,1064,2539,65,304
931,237,1,619,643,2431,478,358,24,448,982,2290,65,305
593,269,12,521,549,1944,318,320,57,469,698,1862,65,306
145,245,15,536,454,1395,91,347,57,424,448,1367,65,307
93,116,6,433,272,920,66,196,18,397,332,1009,65,308
802,135,3,483,499,1922,396,292,7,405,909,2009,65,309
772,188,8,478,625,2071,483,286,20,444,838,2071,65,310
854,203,9,522,694,2282,490,365,15,477,949,2296,65,311
943,214,11,551,672,2391,487,387,21,415,1020,2330,65,312
606,274,10,545,617,2052,335,355,42,459,771,1962,65,313
104,174,7,395,280,960,110,171,35,325,282,923,65,314
66,81,2,338,192,679,52,141,9,268,198,668,65,315
349,122,3,332,300,1106,245,157,9,280,357,1048,65,316
987,184,4,510,720,2405,555,373,7,459,1008,2402,65,317
983,195,9,580,738,2505,529,412,25,460,1120,2546,65,318
910,220,13,543,705,2391,495,357,18,420,962,2252,65,319
580,263,13,597,583,2036,350,351,46,385,834,1966,65,320
167,206,12,559,380,1324,125,275,45,465,441,1351,65,321
89,129,3,405,299,925,78,208,13,371,383,1053,65,322
808,150,16,455,570,1999,412,295,16,425,920,2068,65,323
1065,150,16,621,746,2598,588,379,19,543,1127,2656,65,324
992,192,18,544,671,2417,531,409,12,431,1072,2455,65,325
976,224,8,540,700,2448,492,392,17,471,1091,2463,65,326
606,216,8,477,467,1774,316,303,28,397,730,1774,65,327
120,211,8,511,433,1283,122,305,44,376,382,1229,65,328
101,123,1,374,268,867,86,161,11,326,344,928,65,329
706,150,13,508,496,1873,391,247,23,396,832,1889,65,330
809,210,7,522,604,2152,415,395,15,443,917,2185,65,331
507,227,7,606,457,1804,297,319,10,544,690,1860,65,332
79,100,3,209,126,517,50,73,6,211,176,516,65,333
209,173,9,537,341,1269,173,219,21,348,510,1271,65,334
88,156,13,399,319,975,100,215,24,319,328,986,65,335
120,91,7,297,251,766,87,146,12,333,246,824,65,336
743,126,8,466,473,1816,362,261,17,385,833,1858,65,337
980,183,10,505,683,2361,526,451,17,406,1027,2427,65,338
990,189,16,518,644,2357,499,399,25,458,1016,2397,65,339
900,182,8,563,710,2363,496,420,23,418,950,2307,65,340
567,226,10,468,504,1775,314,304,39,391,705,1753,65,341
121,195,14,477,454,1261,108,348,55,399,362,1272,65,342
87,103,1,398,345,934,81,245,12,341,348,1027,65,343
794,183,1,454,537,1969,385,304,13,403,874,1979,65,344
1045,196,9,498,677,2425,562,431,18,428,1050,2489,65,345
987,181,5,497,616,2286,513,377,19,409,979,2297,65,346
960,222,6,601,734,2523,449,461,15,435,1062,2422,65,347
554,227,21,516,601,1919,319,378,49,406,769,1921,65,348
119,229,11,587,516,1462,98,362,59,466,478,1463,65,349
109,124,3,385,297,918,87,208,10,333,330,968,65,350
753,172,5,501,518,1949,406,263,15,393,906,1983,65,351
979,247,1,604,705,2536,542,382,15,456,1085,2480,65,352
907,212,3,577,653,2352,495,348,11,481,1076,2411,65,353
824,228,3,641,711,2407,429,378,15,499,982,2303,65,354
491,213,10,479,578,1771,324,362,33,414,607,1740,65,355
110,183,6,489,337,1125,106,204,45,374,383,1112,65,356
85,100,3,335,281,804,75,188,3,250,290,806,65,357
423,145,3,414,403,1388,266,205,9,365,551,1396,65,358
216,121,1,389,244,971,204,119,9,337,314,983,65,359
47,69,2,189,84,391,26,69,3,117,146,361,65,360
273,144,3,443,372,1235,191,268,9,338,455,1261,65,361
278,173,9,523,388,1371,230,216,32,351,511,1340,65,362
85,157,8,374,294,918,84,184,31,277,300,876,65,363
75,128,9,394,258,864,73,156,18,332,356,935,65,364
367,142,1,532,474,1516,290,194,6,405,581,1476,65,365
325,328,63,443,429,1588,269,209,121,389,410,1398,65,366
77,49,3,217,112,458,43,124,3,194,167,531,66,1
1848,177,7,1123,1677,4832,1932,254,13,723,1832,4754,66,2
2206,233,13,1267,3832,7551,3909,276,21,960,2205,7371,66,3
2064,248,6,1310,3988,7616,3935,262,9,1121,2027,7354,66,4
1481,240,6,1471,3031,6229,3238,255,21,1045,1363,5922,66,5
144,67,7,221,118,557,42,158,19,155,158,532,66,6
93,68,2,317,173,653,41,175,4,202,217,639,66,7
1990,227,1,1164,3897,7279,3996,243,1,914,1852,7006,66,8
2341,212,4,2136,3825,8518,4549,238,6,1248,2045,8086,66,9
2619,284,31,1560,4265,8759,4370,301,32,1308,2413,8424,66,10
2358,278,2,1515,4039,8192,4123,327,5,1243,2192,7890,66,11
1467,161,8,1445,1556,4637,1884,272,13,858,1312,4339,66,12
129,82,8,379,297,895,56,171,18,235,383,863,66,13
86,49,3,284,143,565,42,126,7,163,197,535,66,14
215,74,4,286,157,736,96,182,8,200,251,737,66,15
537,114,8,393,341,1393,393,204,9,297,485,1388,66,16
1990,297,2,1314,4156,7759,3907,306,6,1290,1908,7417,66,17
2330,351,8,1492,4391,8572,4484,396,15,1149,2271,8315,66,18
653,135,5,1512,1457,3762,1535,229,26,1288,662,3740,66,19
133,84,19,334,205,775,56,181,35,173,237,682,66,20
85,54,4,251,154,548,38,154,8,158,197,555,66,21
2021,259,3,1265,4112,7660,4182,268,8,989,1899,7346,66,22
2664,305,10,1506,4395,8880,4538,341,6,1186,2487,8558,66,23
2679,278,5,1490,4349,8801,4431,338,9,1187,2514,8479,66,24
2425,269,1,1577,4237,8509,4424,388,9,1193,2177,8191,66,25
1607,241,6,1776,3066,6696,3463,324,26,1028,1543,6384,66,26
143,102,8,415,289,957,71,230,25,255,298,879,66,27
96,76,2,300,147,621,40,195,8,171,194,608,66,28
2121,268,2,1228,3911,7530,4010,281,6,1001,1963,7261,66,29
2801,299,5,1505,4449,9059,4624,359,8,1157,2609,8757,66,30
2734,276,10,1646,4324,8990,4451,367,14,1337,2482,8651,66,31
2417,281,4,1699,4202,8603,4294,396,15,1300,2269,8274,66,32
1664,239,7,1788,3204,6902,3531,322,23,1148,1549,6573,66,33
142,93,4,375,223,837,66,160,24,247,269,766,66,34
89,73,21,298,193,674,40,158,20,200,229,647,66,35
2134,259,26,1308,4162,7889,4276,289,25,1063,1976,7629,66,36
2788,290,14,1398,4408,8898,4557,378,20,1110,2618,8683,66,37
2708,288,10,1564,4429,8999,4568,374,9,1177,2640,8768,66,38
2495,287,3,1493,4230,8508,4387,365,9,1090,2351,8202,66,39
1681,205,5,1951,3113,6955,3574,291,23,1150,1575,6613,66,40
168,116,7,408,253,952,49,223,33,242,321,868,66,41
102,61,12,334,166,675,74,171,14,200,237,696,66,42
2051,257,12,1286,3843,7449,3926,309,15,1068,1945,7263,66,43
2520,266,1,1315,4076,8178,4202,384,2,1147,2300,8035,66,44
2759,239,7,1444,4220,8669,4220,395,14,1165,2436,8230,66,45
2448,296,6,1588,4035,8373,4185,369,14,1159,2310,8037,66,46
1609,167,8,1638,1430,4852,1970,263,22,910,1353,4518,66,47
174,107,2,380,223,886,64,193,17,224,291,789,66,48
100,62,17,377,201,757,38,188,23,252,276,777,66,49
258,90,5,430,254,1037,110,202,6,309,426,1053,66,50
2730,316,6,1485,4342,8879,4515,411,8,1157,2525,8616,66,51
2753,295,10,1542,4459,9059,4492,346,15,1267,2675,8795,66,52
2442,354,3,1656,4742,9197,4911,431,13,1291,2341,8987,66,53
1672,247,8,1830,3508,7265,4040,251,26,1074,1521,6912,66,54
171,80,12,400,270,933,64,187,26,235,293,805,66,55
105,63,16,299,203,686,43,165,19,284,219,730,66,56
2108,309,17,1327,4579,8340,4658,330,21,1068,2092,8169,66,57
2768,291,6,1516,4897,9478,5082,380,6,1125,2585,9178,66,58
2568,263,5,1634,4891,9361,4976,324,10,1181,2463,8954,66,59
2430,299,5,1641,4659,9034,4778,417,7,1273,2205,8680,66,60
1654,226,5,1834,3563,7282,3965,317,21,1235,1479,7017,66,61
165,93,15,360,252,885,71,209,31,213,317,841,66,62
112,76,1,395,167,751,42,198,6,250,285,781,66,63
2078,277,17,1369,4440,8181,4570,362,20,1016,2027,7995,66,64
2589,338,3,1568,4863,9361,5122,362,5,1157,2510,9156,66,65
2676,290,22,1617,4863,9468,4978,397,15,1280,2463,9133,66,66
2469,297,6,1626,4653,9051,4862,370,9,1301,2314,8856,66,67
1721,249,11,1916,3365,7262,3740,360,33,1268,1577,6978,66,68
153,123,3,365,205,849,65,198,34,216,292,805,66,69
105,97,7,358,252,819,42,181,12,315,283,833,66,70
2067,280,1,1494,4119,7961,4176,327,7,1221,2077,7808,66,71
2765,321,1,1630,4414,9131,4458,379,6,1312,2744,8899,66,72
2851,315,1,1855,4454,9476,4466,436,17,1364,2813,9096,66,73
2575,341,12,1923,4294,9145,4305,476,26,1482,2549,8838,66,74
1685,273,6,2148,3239,7351,3488,334,38,1464,1689,7013,66,75
255,197,6,590,386,1434,157,330,30,366,508,1391,66,76
103,96,12,462,262,935,56,276,16,275,343,966,66,77
2122,291,1,1496,4076,7986,4279,351,4,1145,2085,7864,66,78
2873,318,3,1691,4572,9457,4584,460,7,1330,2821,9202,66,79
2839,282,5,1674,4429,9229,4488,482,13,1313,2732,9028,66,80
2633,308,7,1760,4352,9060,4359,495,15,1431,2497,8797,66,81
1764,265,9,2060,3202,7300,3580,416,43,1279,1673,6991,66,82
159,160,9,357,333,1018,58,300,31,218,374,981,66,83
123,128,9,649,380,1289,55,261,19,404,540,1279,66,84
2158,321,7,1614,4058,8158,4010,408,19,1283,2178,7898,66,85
2654,346,12,1844,4279,9135,4339,471,18,1352,2733,8913,66,86
2487,281,14,1904,4265,8951,4246,394,13,1438,2450,8541,66,87
2222,306,13,1816,4016,8373,3982,398,14,1374,2387,8155,66,88
1546,296,6,2397,2587,6832,3074,405,20,1495,1531,6525,66,89
184,134,5,827,434,1584,76,306,28,520,597,1527,66,90
138,115,12,512,297,1074,64,250,15,354,370,1053,66,91
1966,242,11,1624,3907,7750,3964,389,11,1231,1945,7540,66,92
2776,299,2,1780,4537,9394,4575,398,7,1403,2689,9072,66,93
2680,307,8,1907,4593,9495,4627,452,10,1524,2587,9200,66,94
2670,332,8,2061,4470,9541,4450,481,18,1539,2646,9134,66,95
1724,383,11,2253,3429,7800,3575,505,22,1550,1775,7427,66,96
62,121,4,293,279,759,76,162,6,328,331,903,66,97
92,101,9,226,211,639,49,137,8,267,299,760,66,98
2104,263,13,1724,3632,7736,3965,301,21,1161,2059,7507,66,99
2816,307,13,1608,4262,9006,4387,442,24,1237,2770,8860,66,100
3520,325,15,1800,4316,9976,4464,420,21,1445,3182,9532,66,101
2568,311,18,1830,4369,9096,4460,451,26,1355,2375,8667,66,102
1799,290,11,2003,3343,7446,3645,359,32,1480,1592,7108,66,103
234,153,8,514,346,1255,95,281,40,350,421,1187,66,104
126,123,4,534,241,1028,59,250,10,326,358,1003,66,105
2143,265,1,1552,4114,8075,4163,365,9,1146,2165,7848,66,106
2804,331,9,1767,4349,9260,4451,454,20,1330,2620,8875,66,107
2827,321,11,1779,4270,9208,4536,461,15,1438,2575,9025,66,108
2550,359,24,1958,4433,9324,4418,466,37,1381,2625,8927,66,109
1787,287,24,1982,3438,7518,3546,416,38,1288,1758,7046,66,110
41,237,12,262,330,882,73,222,15,270,383,963,66,111
29,60,1,251,140,481,38,73,4,289,193,597,66,112
2176,242,12,1479,4232,8141,4273,308,11,1173,2190,7955,66,113
2915,290,18,1640,4719,9582,4723,415,27,1354,2772,9291,66,114
2842,298,5,1778,4428,9351,4602,425,10,1411,2597,9045,66,115
2570,260,10,3655,4328,10823,5688,407,17,1829,2505,10446,66,116
1880,240,9,2256,3194,7579,3693,380,24,1392,1725,7214,66,117
182,110,15,494,268,1069,61,253,36,369,337,1056,66,118
143,98,15,487,269,1012,55,255,17,321,334,982,66,119
2178,279,24,1587,4004,8072,4154,372,24,1245,2112,7907,66,120
3018,356,20,1722,4327,9443,4512,405,19,1386,2739,9061,66,121
2919,339,12,1866,4318,9454,4464,482,11,1507,2752,9216,66,122
2664,329,15,1830,4220,9058,4317,448,24,1437,2480,8706,66,123
1803,234,11,2160,2972,7180,3373,414,19,1408,1614,6828,66,124
198,101,5,506,244,1054,110,226,13,300,275,924,66,125
109,90,33,388,178,798,56,203,32,273,237,801,66,126
2164,264,13,1393,3986,7820,4057,324,14,1201,2154,7750,66,127
2898,315,6,1640,4476,9335,4619,405,11,1220,2742,8997,66,128
2816,327,9,1690,4443,9285,4466,473,19,1432,2677,9067,66,129
2579,329,8,1775,4201,8892,4187,406,12,1410,2550,8565,66,130
1724,213,6,2046,3045,7034,3428,340,29,1282,1701,6780,66,131
122,107,18,475,310,1032,92,227,37,298,517,1171,66,132
118,97,8,470,244,937,53,227,11,321,297,909,66,133
2181,291,3,1657,4027,8159,4115,377,8,1265,2151,7916,66,134
2910,325,14,1711,4370,9330,4404,397,20,1353,2674,8848,66,135
2718,288,22,1905,4360,9293,4598,466,22,1453,2602,9141,66,136
2618,322,5,1878,4138,8961,4331,603,19,1383,2464,8800,66,137
1816,218,6,2132,3010,7182,3350,351,26,1390,1737,6854,66,138
194,118,4,430,243,989,65,256,21,284,342,968,66,139
144,121,5,484,234,988,60,245,10,437,336,1088,66,140
2187,249,2,1496,4025,7959,3994,347,8,1218,2146,7713,66,141
2883,317,10,1761,4457,9428,4577,451,17,1346,2842,9233,66,142
2788,301,15,2064,4115,9283,4370,401,18,1393,2792,8974,66,143
2529,302,5,2344,3464,8644,4035,402,12,1417,2423,8289,66,144
1515,204,13,1473,1162,4367,1449,406,29,979,1238,4101,66,145
220,147,8,554,366,1295,97,307,28,405,432,1269,66,146
103,101,4,483,386,1077,60,196,8,443,483,1190,66,147
129,89,2,474,229,923,60,222,6,363,316,967,66,148
2741,267,31,1593,4154,8786,4307,361,37,1165,2655,8525,66,149
2737,284,3,1701,4474,9199,4413,341,6,1326,2579,8665,66,150
2609,294,4,1779,4106,8792,4229,422,11,1385,2530,8577,66,151
1803,243,17,2112,3122,7297,3525,346,43,1391,1630,6935,66,152
237,149,4,622,387,1399,82,282,33,399,406,1202,66,153
134,86,9,474,250,953,51,237,11,273,323,895,66,154
2402,272,5,1664,4125,8468,4232,416,9,1356,2221,8234,66,155
3052,333,8,1893,4552,9838,4732,419,15,1448,2814,9428,66,156
2916,306,3,1958,4473,9656,4638,402,7,1377,2732,9156,66,157
2727,346,7,1940,4409,9429,4539,522,13,1372,2526,8972,66,158
1924,300,0,2395,3216,7835,3694,513,23,1555,1673,7458,66,159
209,234,11,655,426,1535,78,509,41,342,442,1412,66,160
125,135,3,618,311,1192,70,251,6,405,467,1199,66,161
2244,299,9,1584,4144,8280,4276,354,8,1243,2229,8110,66,162
3050,365,29,1838,4525,9807,4704,530,34,1415,2813,9496,66,163
2952,317,18,1921,4455,9663,4657,527,25,1390,2773,9372,66,164
2747,350,2,1843,4175,9117,4401,514,10,1409,2449,8783,66,165
1821,275,8,2218,3106,7428,3455,412,44,1437,1622,6970,66,166
216,158,4,510,353,1241,72,333,26,357,411,1199,66,167
119,90,7,432,214,862,55,195,15,252,281,798,66,168
2127,273,3,1595,4132,8130,4258,333,4,1226,2103,7924,66,169
2766,304,12,2177,3998,9257,4416,436,26,1459,2506,8843,66,170
501,139,2,642,404,1688,154,308,2,465,664,1593,66,171
2515,254,2,1677,2548,6996,2628,422,8,1143,2407,6608,66,172
1704,290,5,2050,2741,6790,3369,369,17,1229,1489,6473,66,173
199,119,2,499,252,1071,78,282,26,297,320,1003,66,174
162,71,3,409,163,808,68,206,6,238,278,796,66,175
2117,268,18,1562,4152,8117,4245,332,27,1220,2115,7939,66,176
2858,344,4,1813,4489,9508,4502,460,10,1352,2832,9156,66,177
2811,265,6,1806,4354,9242,4444,414,7,1419,2633,8917,66,178
2580,323,2,1945,4105,8955,4214,509,5,1446,2433,8607,66,179
1831,300,4,2256,3170,7561,3517,390,34,1545,1608,7094,66,180
199,122,6,558,291,1176,62,328,20,345,355,1110,66,181
129,107,1,530,179,946,77,231,6,411,266,991,66,182
2214,290,6,1652,4265,8427,4333,437,8,1260,2140,8178,66,183
2681,349,7,1960,4472,9469,4625,459,15,1448,2618,9165,66,184
2230,248,4,2662,3027,8171,3720,497,16,1568,2188,7989,66,185
196,1115,6,704,649,2670,84,1486,20,445,570,2605,66,186
982,201,3,1125,768,3079,787,349,20,839,963,2958,66,187
200,147,2,525,326,1200,50,282,18,402,377,1129,66,188
121,109,2,476,213,921,53,231,4,321,286,895,66,189
2782,301,3,1639,4260,8985,4384,366,7,1377,2527,8661,66,190
3015,384,12,1860,4650,9921,4696,473,10,1514,2850,9543,66,191
3032,320,5,1834,4645,9836,4710,387,10,1570,2770,9447,66,192
2923,332,10,1799,4426,9490,4423,444,16,1493,2679,9055,66,193
2076,273,9,2102,3453,7913,3888,394,27,1403,1762,7474,66,194
207,145,17,533,418,1320,79,328,34,347,432,1220,66,195
123,108,4,458,236,929,65,213,6,362,290,936,66,196
2215,275,17,1600,4377,8484,4343,385,20,1267,2426,8441,66,197
2843,389,22,1704,4521,9479,4591,454,27,1409,2629,9110,66,198
2729,281,11,1889,4444,9354,4524,372,12,1444,2632,8984,66,199
2459,349,6,1936,4328,9078,4451,423,13,1469,2436,8792,66,200
1674,274,24,2015,3220,7207,3477,401,59,1368,1567,6872,66,201
215,147,3,587,382,1334,60,274,30,394,467,1225,66,202
132,146,3,486,242,1009,56,246,5,370,287,964,66,203
2191,294,9,1642,4462,8598,4469,350,13,1239,2173,8244,66,204
2804,301,6,1663,4687,9461,4671,445,10,1472,2638,9236,66,205
2553,289,11,1869,4737,9459,4628,438,14,1599,2500,9179,66,206
2503,329,9,1974,4299,9114,4443,450,18,1473,2383,8767,66,207
1657,291,2,2241,3223,7414,3601,417,29,1407,1658,7112,66,208
177,149,3,594,318,1241,98,295,47,373,422,1235,66,209
111,98,1,436,194,840,55,191,13,347,285,891,66,210
2147,249,3,1651,4423,8473,4365,355,12,1345,2080,8157,66,211
2792,351,8,1768,4670,9589,4788,426,12,1433,2751,9410,66,212
2743,343,25,1930,4498,9539,4757,426,28,1473,2638,9322,66,213
2432,334,2,1888,4258,8914,4398,474,5,1409,2299,8585,66,214
1699,255,2,2022,3169,7147,3531,357,29,1335,1459,6711,66,215
210,104,4,481,275,1074,69,230,29,323,390,1041,66,216
106,91,14,486,221,918,41,201,14,344,327,927,66,217
2148,274,8,1594,4186,8210,4273,347,9,1299,2018,7946,66,218
2735,311,4,1594,4621,9265,4646,421,9,1310,2639,9025,66,219
2632,247,5,1778,4414,9076,4460,363,12,1366,2580,8781,66,220
2253,283,9,1873,4367,8785,4479,394,6,1402,2227,8508,66,221
1363,258,3,1844,3022,6490,3337,303,21,1363,1283,6307,66,222
179,130,2,466,313,1090,70,289,28,333,346,1066,66,223
114,91,4,476,250,935,61,231,7,382,291,972,66,224
2012,253,3,1785,3736,7789,4083,314,7,1106,1969,7479,66,225
2770,273,6,1765,4027,8841,4337,392,6,1248,2638,8621,66,226
2589,277,6,1778,4327,8977,4350,366,10,1452,2554,8732,66,227
2335,270,8,1831,4140,8584,4207,401,6,1396,2257,8267,66,228
1593,249,3,1997,3301,7143,3578,335,31,1365,1584,6893,66,229
188,155,2,469,337,1151,64,211,28,347,372,1022,66,230
97,83,1,408,265,854,78,178,3,262,322,843,66,231
2043,243,2,1458,4244,7990,4201,316,6,1241,2056,7820,66,232
2695,300,5,1580,4572,9152,4683,404,11,1220,2641,8959,66,233
2636,287,14,1674,4510,9121,4555,461,10,1283,2647,8956,66,234
2398,269,12,1933,4127,8739,4270,384,15,1279,2472,8420,66,235
1666,246,11,1887,3175,6985,3465,351,25,1252,1550,6643,66,236
215,119,4,538,367,1243,76,274,22,339,410,1121,66,237
127,96,14,409,244,890,52,210,14,265,304,845,66,238
2232,247,19,1580,4283,8361,4284,369,12,1268,2128,8061,66,239
2864,319,12,1673,4602,9470,4793,459,13,1286,2688,9239,66,240
2794,326,21,1854,4608,9603,4649,507,27,1461,2681,9325,66,241
2488,255,0,2170,4085,8998,4454,349,4,1434,2418,8659,66,242
1419,133,5,1402,1093,4052,1373,339,21,964,1182,3879,66,243
207,106,21,533,289,1156,69,269,40,326,346,1050,66,244
110,86,4,481,221,902,47,193,8,303,317,868,66,245
133,107,7,478,223,948,64,206,11,328,283,892,66,246
2776,306,7,1501,4571,9161,4676,388,13,1161,2622,8860,66,247
2910,285,21,1573,4558,9347,4668,378,25,1393,2745,9209,66,248
2669,322,13,1827,4490,9321,4612,405,15,1373,2641,9046,66,249
1839,238,3,2009,3323,7412,3756,320,20,1308,1680,7084,66,250
127,136,4,388,233,888,54,257,29,279,370,989,66,251
133,90,4,446,216,889,73,188,7,314,291,873,66,252
2314,262,4,1479,4340,8399,4573,386,6,1088,2264,8317,66,253
2908,344,9,1662,4678,9601,4808,462,13,1326,2786,9395,66,254
2885,462,6,1748,4508,9609,4468,563,8,1389,2851,9279,66,255
2706,322,2,1759,4443,9232,4579,445,4,1361,2467,8856,66,256
1879,261,1,2130,3482,7753,3845,379,27,1365,1706,7322,66,257
203,127,1,512,290,1133,69,307,21,314,357,1068,66,258
137,109,0,502,217,965,56,234,5,323,382,1000,66,259
2371,238,11,1630,4158,8408,4246,357,15,1226,2202,8046,66,260
3118,293,12,1676,4728,9827,4742,469,17,1398,2898,9524,66,261
2917,292,7,1959,4573,9748,4802,458,9,1442,2758,9469,66,262
2788,296,9,1905,4643,9641,4698,507,22,1427,2589,9243,66,263
1875,299,11,2099,3214,7498,3661,342,50,1336,1720,7109,66,264
230,110,4,531,289,1164,76,243,26,338,374,1057,66,265
112,86,1,394,207,800,56,225,2,280,266,829,66,266
2333,244,15,1602,4404,8598,4511,330,21,1288,2262,8412,66,267
2992,307,6,1906,4871,10082,4952,446,9,1546,2921,9874,66,268
2908,288,1,1852,4703,9752,4875,443,6,1384,2760,9468,66,269
2712,297,5,1991,4401,9406,4598,441,17,1485,2645,9186,66,270
1850,253,5,2188,3317,7613,3720,362,22,1505,1642,7251,66,271
211,123,5,565,339,1243,85,294,39,363,354,1135,66,272
114,76,3,424,231,848,64,213,5,276,293,851,66,273
2319,280,6,1547,4407,8559,4555,337,11,1305,2225,8433,66,274
2856,313,10,1817,4882,9878,5075,389,17,1394,2758,9633,66,275
2912,343,13,1760,4906,9934,5023,443,16,1373,2835,9690,66,276
2573,329,13,1760,4548,9223,4700,403,14,1383,2466,8966,66,277
1790,250,7,1955,3325,7327,3650,337,31,1466,1646,7130,66,278
177,104,3,523,304,1111,72,274,25,348,394,1113,66,279
117,107,10,496,195,925,66,217,16,334,345,978,66,280
2409,286,6,1606,4491,8798,4582,322,13,1321,2336,8574,66,281
3028,292,16,1699,4860,9895,4980,404,18,1402,2967,9771,66,282
2990,314,19,1764,4828,9915,4896,421,24,1425,2856,9622,66,283
2609,343,11,1968,4351,9282,4556,409,18,1529,2612,9124,66,284
1777,231,5,1960,1598,5571,1985,326,26,1234,1631,5202,66,285
231,144,2,610,345,1332,78,266,22,408,485,1259,66,286
497,106,2,7331,279,8215,5318,232,10,1823,351,7734,66,287
508,82,3,543,383,1519,200,263,6,439,752,1660,66,288
3366,286,4,2070,4844,10570,4912,449,8,1799,3216,10384,66,289
3316,317,7,1993,4792,10425,4940,456,9,1706,3088,10199,66,290
2725,327,5,1841,4849,9747,4721,482,14,1656,2585,9458,66,291
1858,248,6,2094,3443,7649,3826,346,23,1416,1754,7365,66,292
217,132,5,538,326,1218,86,295,29,360,370,1140,66,293
124,97,2,416,237,876,34,230,6,293,308,871,66,294
2423,239,17,1464,4178,8321,4268,343,16,1175,2319,8121,66,295
3047,318,9,1831,4605,9810,4746,480,12,1343,2916,9497,66,296
2951,290,8,1713,4615,9577,4727,470,16,1394,2974,9581,66,297
2721,283,8,1744,4429,9185,4533,429,14,1354,2590,8920,66,298
1891,218,2,2068,3302,7481,3695,362,22,1365,1766,7210,66,299
65,106,5,1456,406,2038,488,255,32,1121,431,2327,66,300
1277,84,9,639,208,2217,11582,213,18,800,394,13007,66,301
2389,268,14,1641,4486,8798,4634,327,15,1398,2314,8688,66,302
3568,368,21,1862,4957,10776,4992,510,30,1698,3301,10531,66,303
3038,243,7,1940,4740,9968,4876,412,14,1592,2903,9797,66,304
2517,208,9,2170,4104,9008,4633,336,15,1315,2436,8735,66,305
1747,193,3,2014,3123,7080,3643,310,33,1334,1626,6946,66,306
180,117,7,393,296,993,64,252,29,249,332,926,66,307
108,57,39,375,173,752,47,144,35,270,230,726,66,308
2303,232,36,1430,4509,8510,4635,292,31,1200,2192,8350,66,309
2353,209,43,1850,4033,8488,4569,279,45,1263,2105,8261,66,310
2564,240,31,1799,4500,9134,4730,358,36,1348,2438,8910,66,311
2654,233,12,2081,4370,9350,4815,348,13,1414,2427,9017,66,312
1758,176,7,1824,1644,5409,2127,298,34,1105,1570,5134,66,313
174,108,13,441,204,940,65,203,26,280,308,882,66,314
128,59,3,390,170,750,49,152,9,244,284,738,66,315
435,88,22,512,297,1354,171,215,21,351,619,1377,66,316
2990,343,13,1644,4905,9895,5060,405,18,1335,2854,9672,66,317
3089,289,35,1733,4896,10042,5033,408,38,1413,2930,9822,66,318
2705,264,10,1764,4842,9585,4861,340,17,1376,2589,9183,66,319
1853,220,4,2053,3498,7628,3956,344,24,1340,1717,7381,66,320
171,101,11,463,250,996,58,188,24,275,370,915,66,321
119,64,43,344,149,719,42,177,43,246,258,766,66,322
2336,224,27,1487,4535,8609,4654,319,29,1184,2414,8600,66,323
3188,277,13,1701,4748,9927,4925,357,10,1281,2992,9565,66,324
3142,307,13,1778,4756,9996,4954,374,22,1325,2976,9651,66,325
2667,245,15,1783,4753,9463,4776,399,22,1431,2477,9105,66,326
1767,235,2,2322,3393,7719,4034,287,21,1342,1585,7269,66,327
190,84,1,405,223,903,82,192,16,240,288,818,66,328
74,42,12,343,186,657,45,155,11,209,248,668,66,329
2099,218,18,1718,4180,8233,4363,257,20,1356,2009,8005,66,330
2291,246,5,1900,3762,8204,4158,321,7,1327,2160,7973,66,331
1454,124,3,2484,975,5040,2253,222,4,1085,1084,4648,66,332
83,37,1,171,116,408,36,79,1,136,136,388,66,333
466,93,1,763,443,1766,455,186,15,436,543,1635,66,334
126,74,1,392,198,791,52,157,12,273,253,747,66,335
94,48,6,270,134,552,38,180,12,157,233,620,66,336
2188,219,11,1517,4531,8466,4680,278,12,1188,2121,8279,66,337
2881,299,4,1734,4910,9828,5058,370,12,1373,2806,9619,66,338
2824,224,21,1784,4912,9765,5064,345,21,1411,2726,9567,66,339
2673,242,11,1915,4637,9478,4820,424,15,1446,3056,9761,66,340
1812,222,2,2044,3447,7527,3922,276,25,1342,1628,7193,66,341
169,111,5,437,284,1006,63,286,38,266,273,926,66,342
116,53,11,380,201,761,52,178,10,276,278,794,66,343
2256,293,18,1540,4585,8692,4634,343,16,1269,2214,8476,66,344
3082,273,8,1837,4811,10011,5027,439,8,1380,2842,9696,66,345
2992,272,3,1783,4817,9867,4897,412,8,1460,2750,9527,66,346
2807,291,4,2073,4792,9967,4707,499,18,1609,2564,9397,66,347
1791,206,3,2454,3351,7805,3876,331,26,1420,1703,7356,66,348
252,90,6,922,260,1530,341,235,35,499,373,1483,66,349
124,66,8,328,161,687,49,184,16,222,205,676,66,350
2240,270,13,1494,4574,8591,4630,276,23,1258,2091,8278,66,351
2831,255,20,1944,4695,9745,4939,342,23,1495,2695,9494,66,352
2654,254,3,1911,4587,9409,4904,391,7,1382,2529,9213,66,353
2380,239,19,2132,4302,9072,4587,337,13,1541,2213,8691,66,354
1440,191,4,2375,2823,6833,3407,303,26,1355,1370,6461,66,355
152,90,3,420,239,904,69,174,19,250,283,795,66,356
88,57,6,333,179,663,45,178,5,204,249,681,66,357
1254,166,4,2113,1462,4999,2164,262,11,1056,1201,4694,66,358
560,75,18,450,258,1361,250,144,21,344,403,1162,66,359
45,54,4,224,131,458,28,103,8,183,137,459,66,360
825,153,4,826,755,2563,750,287,16,547,907,2507,66,361
861,164,7,1451,970,3453,1300,225,35,810,937,3307,66,362
135,100,8,419,221,883,47,176,28,269,345,865,66,363
101,82,11,458,204,856,60,164,17,373,282,896,66,364
1224,168,31,1763,1734,4920,2253,271,24,1016,1302,4866,66,365
1014,154,22,1303,737,3230,1187,181,64,797,793,3022,66,366
147,282,2,945,1088,2464,138,391,4,1136,943,2612,67,1
1672,716,12,1469,1966,5835,754,698,14,1767,2902,6135,67,2
1967,708,9,1556,2070,6310,854,946,14,1659,3004,6477,67,3
1931,752,13,1540,1936,6172,817,784,14,1808,2984,6407,67,4
1355,873,21,1542,1993,5784,596,983,67,1738,2567,5951,67,5
248,695,15,1337,1304,3599,212,645,43,1606,1154,3660,67,6
225,364,6,1803,1454,3852,153,580,15,1838,1522,4108,67,7
1931,642,4,1369,1778,5724,751,888,13,1526,2864,6042,67,8
2454,514,6,1433,1356,5763,858,601,8,1719,2819,6005,67,9
2606,758,5,1652,2168,7189,956,1000,11,1879,3603,7449,67,10
2384,812,6,1677,2212,7091,874,1171,23,1779,3240,7087,67,11
1476,788,15,1603,1697,5579,552,823,54,1698,2233,5360,67,12
348,883,9,2647,1808,5695,240,798,67,1948,2600,5653,67,13
213,422,5,1609,1479,3728,146,497,9,1761,1415,3828,67,14
334,559,6,1443,1250,3592,263,599,27,1604,1447,3940,67,15
795,575,2,992,1461,3825,515,697,8,1229,1487,3936,67,16
2264,745,12,1633,2033,6687,832,1117,21,1713,3240,6923,67,17
2475,793,1,2117,2374,7760,898,1373,18,1749,3996,8034,67,18
924,803,21,1356,1723,4827,380,894,66,1484,2329,5153,67,19
325,867,21,1969,2031,5213,207,864,71,2278,1940,5360,67,20
227,450,17,1750,1533,3977,154,639,23,1795,1524,4135,67,21
2123,622,2,1571,1543,5861,714,979,14,1479,3058,6244,67,22
2831,752,4,1705,2197,7489,966,1305,12,1721,3745,7749,67,23
2777,792,4,1897,2336,7806,1046,1327,14,1869,3544,7800,67,24
2525,812,2,1944,2263,7546,995,1390,11,1844,3417,7657,67,25
1679,1152,21,2032,2376,7260,629,1333,90,2162,3046,7260,67,26
343,1012,19,2536,2118,6028,247,1049,81,2420,2319,6116,67,27
229,432,2,1703,1462,3828,136,564,10,1845,1397,3952,67,28
2007,682,3,1625,1729,6046,771,960,7,1576,3052,6366,67,29
2771,773,4,1685,2206,7439,961,1240,12,1794,3729,7736,67,30
2744,776,26,1917,2398,7861,986,1482,29,1877,3681,8055,67,31
2617,895,6,1997,2291,7806,860,1436,18,1967,3667,7948,67,32
1676,997,20,1788,2355,6836,633,1223,79,2072,2847,6854,67,33
328,1000,23,2349,2116,5816,245,894,81,2298,2337,5855,67,34
274,422,9,1757,1521,3983,136,599,13,1798,1589,4135,67,35
2094,730,1,1625,1830,6280,776,968,14,1626,3222,6606,67,36
2818,798,3,1767,2337,7723,1012,1441,15,1728,3818,8014,67,37
2826,758,9,1833,2293,7719,961,1469,11,1832,3662,7935,67,38
2564,889,5,1859,2306,7623,824,1330,17,1889,3677,7737,67,39
1628,1136,31,1905,2152,6852,571,1206,93,2114,2989,6973,67,40
377,1044,24,2347,2341,6133,260,1203,115,2374,2315,6267,67,41
207,518,2,1618,1488,3833,140,655,15,1612,1602,4024,67,42
1914,670,7,1660,1822,6073,767,1050,16,1587,2962,6382,67,43
2550,865,5,1621,2410,7451,906,1458,8,1700,3580,7652,67,44
2671,825,5,1903,2484,7888,943,1417,12,1994,3834,8200,67,45
2474,879,9,1937,2212,7511,879,1278,20,1911,3460,7548,67,46
1533,1061,16,2123,2221,6954,612,1284,78,2113,3063,7150,67,47
314,1042,14,2225,2046,5641,221,965,100,2265,2085,5636,67,48
296,642,5,2169,1865,4977,160,748,19,1997,2075,4999,67,49
619,814,8,1936,2133,5510,564,800,11,2151,2296,5822,67,50
2674,750,2,1698,2221,7345,995,1322,10,1676,3555,7558,67,51
2979,805,2,1860,2338,7984,1073,1255,5,1869,3801,8003,67,52
2701,812,3,1911,2483,7910,1012,1354,11,1903,3605,7885,67,53
1704,951,18,1942,2206,6821,631,1139,77,2117,2903,6867,67,54
398,944,28,2374,2345,6089,242,1121,85,2407,2451,6306,67,55
293,486,4,1898,1687,4368,150,752,7,1950,1761,4620,67,56
2101,750,6,1565,2115,6537,840,1210,12,1687,3239,6988,67,57
2813,740,2,1829,2423,7807,1053,1361,15,1847,3839,8115,67,58
2923,812,5,1831,2186,7757,1069,1236,22,1850,3739,7916,67,59
2588,935,3,1875,2474,7875,983,1472,10,1903,3641,8009,67,60
1678,1088,9,2006,2539,7320,666,1426,75,2195,3130,7492,67,61
348,1064,24,2047,2022,5505,207,1018,92,2114,2204,5635,67,62
284,501,5,2291,1769,4850,151,705,21,1949,2194,5020,67,63
2046,761,34,1634,2035,6510,858,1068,41,1630,3253,6850,67,64
2836,980,2,1861,2268,7947,987,1289,9,1859,3907,8051,67,65
2804,822,9,1959,2326,7920,1036,1367,18,1948,3759,8128,67,66
2612,1142,22,2005,2403,8184,919,1567,45,2006,3765,8302,67,67
1779,1260,20,2079,2482,7620,634,1437,115,2289,3207,7682,67,68
387,983,29,2270,2149,5818,217,1067,71,2276,2157,5788,67,69
290,630,11,1983,1879,4793,140,698,16,2091,2105,5050,67,70
2002,923,4,1665,1922,6516,822,1155,11,1646,3211,6845,67,71
2684,947,1,2163,2500,8295,1008,1560,10,1972,3910,8460,67,72
2739,1053,3,2302,2789,8886,1082,1645,15,2136,4229,9107,67,73
2427,1343,7,2286,2932,8995,898,1642,59,2284,4051,8934,67,74
1660,1295,16,2293,2429,7693,621,1323,117,2339,3362,7762,67,75
807,1522,20,3145,2712,8206,278,1922,117,3042,3053,8412,67,76
433,625,11,2303,2044,5416,162,1062,10,2123,2314,5671,67,77
2076,947,13,1788,2096,6920,859,1202,22,1723,3427,7233,67,78
2880,1032,4,2083,2541,8540,1076,1522,9,2007,4054,8668,67,79
3263,1055,4,2267,3026,9615,1200,1892,14,2136,4075,9317,67,80
2719,966,6,2162,2641,8494,942,1726,22,2169,3767,8626,67,81
1793,1178,20,2394,2738,8123,672,1726,87,2475,3405,8365,67,82
385,1390,19,2256,2382,6432,173,1412,79,2200,2545,6409,67,83
474,680,7,3269,2342,6772,159,1084,23,2571,3020,6857,67,84
2103,1007,8,2246,2399,7763,843,1435,50,1919,3931,8178,67,85
2809,957,19,2612,2851,9248,960,1654,26,2276,4510,9426,67,86
2767,1088,13,2213,2592,8673,1032,1421,17,2219,4099,8788,67,87
2460,1108,29,2487,2543,8627,867,1416,51,2444,3902,8680,67,88
1551,1413,17,2860,2986,8827,642,1621,107,2772,3769,8911,67,89
518,1278,12,3933,3013,8754,238,1760,87,3195,3612,8892,67,90
304,361,1,2229,1629,4524,146,865,4,1770,1993,4778,67,91
2023,1040,6,2437,2426,7932,752,1654,21,2104,3735,8266,67,92
2794,962,6,2306,2479,8547,1005,1401,18,2184,4077,8685,67,93
2771,964,16,2467,2687,8905,1071,1653,23,2376,3989,9112,67,94
2651,1145,4,2428,2813,9041,947,1763,32,2271,4272,9285,67,95
1789,1311,10,2779,2825,8714,690,1618,100,2673,3649,8730,67,96
805,1327,18,3251,2835,8236,280,1606,108,3169,2979,8142,67,97
754,628,5,2743,1994,6124,202,1271,14,2461,2248,6196,67,98
2082,864,7,2122,1813,6888,805,1202,39,1800,3297,7143,67,99
2804,1173,7,1987,2466,8437,1059,1616,26,2026,3949,8676,67,100
2995,1087,9,2200,2562,8853,1033,1722,20,2186,4007,8968,67,101
2751,1109,7,2062,2528,8457,954,1666,36,2088,3959,8703,67,102
1918,1286,22,2276,2564,8066,718,1603,86,2366,3434,8207,67,103
611,1304,26,3101,2718,7760,233,1660,92,2939,2926,7850,67,104
370,735,3,2382,1951,5441,188,989,8,2337,2245,5767,67,105
2163,917,3,2090,2292,7465,958,1378,13,1985,3349,7683,67,106
2899,1197,1,2101,2623,8821,1120,1569,16,2136,4287,9128,67,107
2847,1139,30,2104,2364,8484,1133,1491,34,2195,3737,8590,67,108
2631,1187,27,2192,2666,8703,1002,1726,36,2297,3871,8932,67,109
1813,1314,18,2250,2606,8001,617,1578,103,2432,3503,8233,67,110
614,1364,28,3484,3292,8782,289,2208,169,2333,3516,8515,67,111
413,549,20,2402,1888,5272,200,897,31,2213,2205,5546,67,112
2203,975,19,1758,2029,6984,816,1218,23,1895,3431,7383,67,113
2844,968,3,2036,2587,8438,1028,1609,10,2039,4053,8739,67,114
2825,1053,4,2025,2754,8661,1048,1770,20,2050,3980,8868,67,115
2781,1049,3,2250,2628,8711,894,1842,22,2306,3833,8897,67,116
1719,1343,24,2328,2723,8137,658,1682,89,2310,3194,7933,67,117
425,1273,28,2584,2206,6516,243,1369,114,2704,2088,6518,67,118
351,576,13,2234,2006,5180,186,1092,50,2155,2135,5618,67,119
2132,926,0,1972,2084,7114,885,1204,9,1959,3378,7435,67,120
2791,1058,27,1869,2413,8158,1041,1368,43,2124,3941,8517,67,121
2807,1191,5,2064,2542,8609,1093,1560,35,2222,3985,8895,67,122
2572,1114,2,2197,2509,8394,974,1431,19,2184,3850,8458,67,123
1745,1356,17,2227,2620,7965,720,1686,79,2356,3199,8040,67,124
454,1093,15,2525,1982,6069,211,1293,59,2400,2272,6235,67,125
301,513,7,1916,1764,4501,157,827,16,2110,1734,4844,67,126
2145,988,13,1690,1988,6824,803,1137,24,1759,3327,7050,67,127
2819,1069,7,2027,2619,8541,1095,1509,20,2127,4027,8778,67,128
2725,1168,11,2132,2839,8875,1104,1740,17,2270,4030,9161,67,129
2500,1088,4,1979,2547,8118,976,1450,25,2230,3800,8481,67,130
1636,1231,17,2132,2475,7491,666,1184,91,2431,3212,7584,67,131
595,1132,18,2970,2248,6963,434,1093,74,2565,2789,6955,67,132
341,571,7,1896,1847,4662,165,787,14,2181,1935,5082,67,133
2016,1019,5,1840,2280,7160,894,1231,17,2016,3426,7584,67,134
2708,975,14,1903,2584,8184,1063,1284,24,2078,4105,8554,67,135
2755,1203,7,2137,2656,8758,1113,1455,19,2324,4177,9088,67,136
2555,1305,7,2252,2667,8786,991,1641,16,2265,3895,8808,67,137
1749,1193,26,2300,2672,7940,722,1423,77,2723,3369,8314,67,138
468,1244,16,2454,2268,6450,234,1197,93,2577,2347,6448,67,139
519,639,12,2540,1938,5648,227,1086,22,2516,2169,6020,67,140
2006,1025,4,1882,2399,7316,898,1309,13,1968,3467,7655,67,141
2869,1129,5,2014,2775,8792,1084,1615,19,2175,4021,8914,67,142
2692,1025,10,2312,2579,8618,1136,1417,23,2272,3974,8822,67,143
2481,1072,1,2056,2484,8094,958,1347,11,2284,3539,8139,67,144
1424,1321,14,2116,2693,7568,628,1511,98,2388,2907,7532,67,145
519,1255,18,2780,2404,6976,242,1500,91,2658,2511,7002,67,146
406,676,6,2747,2047,5882,206,1063,29,2465,2290,6053,67,147
437,809,3,2119,1459,4827,241,790,15,2109,1859,5014,67,148
2543,909,7,1780,2229,7468,1066,1182,23,1997,3637,7905,67,149
2710,883,6,1959,2284,7842,1174,1154,16,2051,3768,8163,67,150
2553,1088,14,2023,2688,8366,1134,1409,37,2194,3727,8501,67,151
1707,1306,32,1972,2580,7597,729,1412,89,2306,3186,7722,67,152
528,1347,24,2686,2348,6933,286,1339,84,2648,2583,6940,67,153
368,526,5,2013,1779,4691,196,861,13,2157,1882,5109,67,154
2245,958,5,1744,2339,7291,1010,1334,8,1935,3272,7559,67,155
2945,1137,2,2023,2875,8982,1207,1568,10,2202,4334,9321,67,156
2855,989,13,2092,2495,8444,1202,1377,18,2273,4021,8891,67,157
2688,1200,10,2100,2852,8850,1028,1885,33,2182,3890,9018,67,158
1841,1392,27,2216,3193,8669,655,2035,145,2554,3267,8656,67,159
512,1372,14,3619,3318,8835,265,2773,183,2679,3022,8922,67,160
323,615,5,2794,2174,5911,204,1092,32,2368,2489,6185,67,161
2263,1005,7,1883,2204,7362,924,1200,16,1905,3564,7609,67,162
3033,1205,2,1940,2730,8910,1109,1554,8,2206,4251,9128,67,163
2952,1209,10,2096,2876,9143,1107,1761,22,2203,4091,9184,67,164
2757,1212,2,2141,2710,8822,966,1544,12,2238,3992,8752,67,165
1806,1380,24,2185,2949,8344,748,1696,104,2581,3339,8468,67,166
489,1396,16,2582,2550,7033,313,1525,107,2519,2557,7021,67,167
336,533,2,2169,1815,4855,193,925,4,2154,1999,5275,67,168
2136,987,4,1752,2210,7089,886,1118,17,2092,3350,7463,67,169
2909,1090,1,2069,2836,8905,1167,1572,33,2348,3912,9032,67,170
915,1138,8,2366,2798,7225,788,1301,16,2771,2432,7308,67,171
2469,1120,3,2046,2414,8052,905,1424,24,2082,3679,8114,67,172
1783,1304,12,2015,2324,7438,687,1424,91,2185,3038,7425,67,173
484,1446,12,2355,2222,6519,264,1527,124,2522,2207,6644,67,174
316,552,14,1813,1790,4485,213,795,31,2067,1707,4813,67,175
2122,1028,6,1678,2189,7023,893,1168,18,1940,3267,7286,67,176
2895,1132,3,1936,2471,8437,1122,1408,9,2125,4069,8733,67,177
2968,1016,1,1885,2592,8462,1072,1396,10,1980,4026,8484,67,178
2679,1201,2,2171,2617,8670,951,1589,14,2184,3956,8694,67,179
1786,1333,15,2122,2615,7871,725,1478,93,2415,3262,7973,67,180
413,1303,6,2602,2396,6720,266,1361,68,2541,2513,6749,67,181
347,556,5,1932,1732,4572,212,738,15,2168,1654,4787,67,182
2132,1099,3,1751,2429,7414,1003,1316,5,1951,3427,7702,67,183
2647,1141,8,1977,2765,8538,1042,1467,27,2194,3904,8634,67,184
2187,1262,7,2159,3251,8866,881,1808,32,2670,3485,8876,67,185
491,3499,17,3091,2784,9882,264,3785,60,2657,2432,9198,67,186
968,1437,16,2348,2323,7092,495,1412,72,2410,2678,7067,67,187
434,1220,8,2320,2050,6032,254,1218,66,2409,2202,6149,67,188
329,636,3,1844,1888,4700,175,786,7,2150,1951,5069,67,189
2153,1015,7,1817,2043,7035,819,1208,16,1946,3397,7386,67,190
2902,1082,6,2053,2360,8403,1050,1366,14,2272,3876,8578,67,191
2792,1079,5,1979,2480,8335,1029,1300,15,2146,3907,8397,67,192
2588,1147,2,2066,2577,8380,946,1488,13,2273,3787,8507,67,193
1726,1289,10,1979,2403,7407,658,1435,91,2218,3076,7478,67,194
449,1329,19,2522,2788,7107,273,1636,90,2637,2497,7133,67,195
365,577,9,1966,1780,4697,189,852,17,2153,1682,4893,67,196
2135,1011,9,1833,2001,6989,959,1158,28,2019,4208,8372,67,197
2805,1128,2,1847,2290,8072,1103,1374,19,2062,3797,8355,67,198
2742,1082,15,1918,2560,8317,1142,1210,14,2138,4010,8514,67,199
2554,1180,4,2093,2760,8591,999,1491,19,2215,3989,8713,67,200
1710,1330,19,2225,2811,8095,661,1603,194,2550,2949,7957,67,201
448,1287,13,2512,2547,6807,307,1546,126,2562,2349,6890,67,202
369,568,9,2136,1860,4942,194,768,17,2093,2080,5152,67,203
2158,1014,6,1763,2063,7004,791,1161,21,1915,3551,7439,67,204
2844,1080,14,1821,2579,8338,1041,1420,28,2024,4032,8545,67,205
2709,1045,21,2107,3036,8918,1095,1566,34,2256,4016,8967,67,206
2565,1229,13,2030,2538,8375,922,1522,25,2225,3873,8567,67,207
1705,1437,19,2037,2559,7757,657,1434,137,2391,3256,7875,67,208
408,1267,34,2514,2443,6666,227,1501,179,2525,2437,6869,67,209
309,574,14,2026,1704,4627,195,832,44,2067,1718,4856,67,210
2105,915,24,1841,2387,7272,916,1291,59,1986,3407,7659,67,211
2737,1020,7,2062,2419,8245,1074,1246,14,2198,3915,8447,67,212
2685,1092,18,2033,2535,8363,1126,1265,21,2207,3962,8581,67,213
2469,1119,10,1932,2522,8052,976,1389,21,2136,3783,8305,67,214
1657,1326,18,2175,2628,7804,742,1625,104,2441,3184,8096,67,215
461,1092,11,2858,2192,6614,243,1043,96,2657,2584,6623,67,216
349,594,6,2101,1861,4911,220,727,15,2264,2098,5324,67,217
1985,1096,9,1727,2303,7120,966,1106,11,2055,3302,7440,67,218
2666,1132,17,1985,2577,8377,1120,1375,18,2201,3816,8530,67,219
2570,1092,9,2040,2713,8424,1142,1290,25,2330,3720,8507,67,220
2304,1005,1,1959,2401,7670,934,1182,11,2233,3515,7875,67,221
1441,1281,27,1836,2226,6811,597,1300,130,2105,2633,6765,67,222
360,1189,23,2279,2389,6240,268,1382,90,2478,2282,6500,67,223
320,485,3,1922,1867,4597,201,811,8,2150,1855,5025,67,224
1958,1044,6,1716,2230,6954,876,1129,16,1938,3294,7253,67,225
2673,1022,7,1806,2544,8052,1073,1227,15,2234,3855,8404,67,226
2525,1093,3,1984,2666,8271,1106,1334,11,2175,3989,8615,67,227
2374,1090,14,2045,2599,8122,999,1444,14,2068,3491,8016,67,228
1617,1275,14,2161,2472,7539,668,1372,72,2350,3198,7660,67,229
409,1103,10,2357,2382,6261,264,1096,116,2697,2357,6530,67,230
300,499,7,1876,1814,4496,196,672,14,2130,1812,4824,67,231
1997,921,10,1743,2172,6843,897,996,17,1990,3278,7178,67,232
2650,1152,22,1930,2789,8543,1120,1512,37,2106,3944,8719,67,233
2631,1163,29,2100,2938,8861,1177,1495,42,2248,4083,9045,67,234
2355,1111,8,2161,2556,8191,908,1519,17,2227,3791,8462,67,235
1625,1292,18,2137,2714,7786,687,1426,85,2539,3216,7953,67,236
525,1223,23,2492,2560,6823,248,1417,109,2654,2548,6976,67,237
337,559,6,2084,2013,4999,185,846,26,2335,1997,5389,67,238
2164,879,3,1842,2487,7375,927,1540,14,1944,3323,7748,67,239
2857,1032,1,2030,2973,8893,1089,1848,14,2143,4034,9128,67,240
2787,942,3,2120,2959,8811,1154,1758,12,2146,3960,9030,67,241
2567,874,3,2189,2497,8130,954,1334,22,2237,3624,8171,67,242
1570,1166,22,2212,2711,7681,612,1386,97,2549,2995,7639,67,243
403,1155,35,2799,2592,6984,256,1405,86,2603,2794,7144,67,244
352,564,6,2396,2088,5406,193,1026,28,2346,2263,5856,67,245
348,777,19,1918,1782,4844,243,887,22,2244,1841,5237,67,246
2726,901,17,1975,2392,8011,1093,1381,32,2055,3866,8427,67,247
2875,950,2,2222,2662,8711,1254,1533,9,2134,3898,8828,67,248
2791,1008,8,2184,2610,8601,1114,1599,30,2168,3821,8732,67,249
1804,1228,20,2098,2435,7585,713,1384,102,2267,3204,7670,67,250
472,1374,12,2837,2470,7165,263,1504,117,2743,2666,7293,67,251
352,565,10,1993,1946,4866,202,803,22,2267,1860,5154,67,252
2436,961,8,1784,2269,7458,1032,1372,14,1686,3488,7592,67,253
3136,969,10,2050,2787,8952,1225,1804,20,2057,4031,9137,67,254
3014,1058,11,2354,3080,9517,1275,1939,27,2288,4358,9887,67,255
2771,1015,11,2303,2838,8938,1041,2010,26,2118,3991,9186,67,256
1932,1435,14,2158,2938,8477,755,1746,104,2430,3498,8533,67,257
475,1398,16,2818,2930,7637,296,1560,149,2853,2831,7689,67,258
390,575,10,2330,1949,5254,211,871,19,2395,2127,5623,67,259
2346,959,26,1864,2366,7561,969,1503,31,2030,3500,8033,67,260
3167,1045,54,2046,2790,9102,1185,1658,54,2165,4355,9417,67,261
3132,1044,52,2195,2909,9332,1204,1831,49,2225,4228,9537,67,262
2922,1127,59,2380,3048,9536,1105,1889,64,2453,4138,9649,67,263
1997,1427,21,2273,2864,8582,802,1627,118,2571,3586,8704,67,264
440,1279,22,2907,2686,7334,289,1532,161,2849,2638,7469,67,265
327,538,16,1994,1982,4857,191,852,13,2178,1971,5205,67,266
2416,931,7,2044,2353,7751,978,1269,9,2082,3561,7899,67,267
3100,1067,19,2173,2760,9119,1241,1692,33,2272,4254,9492,67,268
2984,1023,14,2361,3086,9468,1218,1864,22,2273,4273,9650,67,269
2839,1205,7,2432,2805,9288,987,1853,19,2249,4162,9270,67,270
1874,1364,28,2121,2858,8245,710,1688,125,2496,3350,8369,67,271
511,1423,30,2832,2957,7753,302,1808,139,2793,2882,7924,67,272
334,490,16,2159,1904,4903,194,857,20,2262,1997,5330,67,273
2369,884,27,1921,2207,7408,901,1363,31,2044,3449,7788,67,274
3081,951,6,2018,2586,8642,1186,1524,15,2150,4081,8956,67,275
3055,1044,8,2181,2860,9148,1194,1637,20,2254,4296,9401,67,276
2731,1084,10,2337,2685,8847,932,1664,23,2245,4005,8869,67,277
1878,1473,44,2506,2722,8623,726,1493,97,2619,3733,8668,67,278
478,1150,21,2836,2843,7328,273,1462,104,2806,2991,7636,67,279
352,493,8,2147,2055,5055,182,881,13,2215,2046,5337,67,280
2358,1036,11,2014,2363,7782,1004,1403,15,2076,3690,8188,67,281
3148,1046,6,2119,2780,9099,1281,1694,16,2141,4292,9424,67,282
3125,1200,15,2251,2851,9442,1205,1681,21,2278,4251,9436,67,283
2740,1202,20,2339,2976,9277,1056,1557,28,2464,4148,9253,67,284
1685,1418,27,2611,2900,8641,723,1538,96,2755,3791,8903,67,285
727,1270,26,3238,2952,8213,293,1579,70,3163,3420,8525,67,286
755,630,18,3513,2393,7309,389,1223,28,2812,2321,6773,67,287
1408,1055,14,2420,2624,7521,681,1255,28,2595,3246,7805,67,288
3201,1068,1,2345,3067,9682,1186,1809,9,2449,4578,10031,67,289
3212,1233,15,2423,2975,9858,1226,1537,23,2419,4847,10052,67,290
2918,1252,21,2516,3315,10022,1082,1907,28,2594,4480,10091,67,291
1869,1470,61,2589,3003,8992,758,1817,127,2730,3850,9282,67,292
593,1431,23,2978,2747,7772,254,1626,204,2916,2941,7941,67,293
370,586,41,2328,2149,5474,218,1134,42,2343,2150,5887,67,294
2315,1062,10,1969,2418,7774,975,1423,22,2009,3919,8348,67,295
3119,1042,28,2122,2930,9241,1241,1614,24,2192,4223,9294,67,296
3171,1204,7,2407,3170,9959,1255,1915,23,2405,4494,10092,67,297
2844,1199,13,2388,3353,9797,1069,2018,18,2375,4551,10031,67,298
2028,1530,21,2608,3083,9270,738,1666,112,2905,4087,9508,67,299
888,1352,19,3599,2963,8821,319,1387,133,3602,3331,8772,67,300
2057,624,14,3547,2452,8694,582,1132,26,4186,3036,8962,67,301
2443,1125,8,2293,2516,8385,970,1420,16,2225,3947,8578,67,302
3087,1170,30,2349,3694,10330,1286,2579,34,2520,4226,10645,67,303
3057,1155,3,2379,3332,9926,1303,1698,9,2438,4581,10029,67,304
2684,1107,4,2308,2948,9051,1029,1589,27,2387,3982,9014,67,305
1736,1423,40,2220,2706,8125,733,1480,132,2470,3479,8294,67,306
477,1359,34,2608,2787,7265,282,1529,94,2767,2751,7423,67,307
438,469,9,2123,2029,5068,231,798,17,2515,1918,5479,67,308
2441,894,6,2029,2729,8099,1090,1344,14,2212,3703,8363,67,309
2473,832,8,2033,2598,7944,1141,1127,42,2307,3594,8211,67,310
2519,871,13,2003,2708,8114,1166,1300,19,2213,3664,8362,67,311
2775,1072,8,2122,2740,8717,1114,1506,16,2230,3994,8860,67,312
1810,1301,27,2408,2752,8298,743,1454,89,2651,3478,8415,67,313
521,1208,21,2855,2581,7186,291,1150,105,2983,2759,7288,67,314
359,462,2,2406,1956,5185,293,723,19,2211,2306,5552,67,315
1231,935,6,2395,2484,7051,764,1227,9,2656,2881,7537,67,316
3071,1082,13,2040,2787,8993,1260,1444,19,2183,4345,9251,67,317
3227,1010,3,2253,3125,9618,1317,1678,25,2411,4421,9852,67,318
2942,1059,11,2167,2782,8961,1111,1544,28,2443,4204,9330,67,319
1959,1245,15,2340,2716,8275,768,1383,94,2625,3755,8625,67,320
530,1360,18,2906,2881,7695,281,1124,124,3087,3370,7986,67,321
372,498,10,2011,2177,5068,212,825,15,2476,1966,5494,67,322
2437,1013,9,1992,2497,7948,1032,1313,11,2140,3704,8200,67,323
3179,1086,6,2131,2833,9235,1282,1426,17,2342,4475,9542,67,324
3109,1117,15,2218,3090,9549,1384,1513,22,2279,4547,9745,67,325
2845,1108,5,2334,2936,9228,1183,1733,14,2398,4075,9403,67,326
1833,1270,18,2176,2614,7911,739,1322,95,2726,3342,8224,67,327
401,1239,18,2566,2703,6927,302,1230,104,2916,2700,7252,67,328
339,516,10,1940,2082,4887,231,753,17,2114,1970,5085,67,329
2076,982,8,2106,2349,7521,946,975,14,2363,3398,7696,67,330
2202,1015,11,2269,2531,8028,917,1132,21,2382,3736,8188,67,331
1448,1001,20,2346,2547,7362,701,938,23,2850,2625,7137,67,332
226,177,0,845,491,1739,107,362,7,573,690,1739,67,333
555,1414,15,2798,2875,7657,601,928,38,3476,2922,7965,67,334
295,1079,16,2187,2228,5805,272,1002,55,2637,2305,6271,67,335
226,571,11,1824,2014,4646,176,980,14,2127,1869,5166,67,336
2093,988,6,1905,2433,7425,932,1288,6,2130,3646,8002,67,337
2947,966,1,2087,2919,8920,1112,1566,7,2374,4309,9368,67,338
3000,1032,4,2202,2791,9029,1200,1538,18,2306,4294,9356,67,339
2709,1005,2,2255,3015,8986,1031,1694,8,2437,4217,9387,67,340
1839,1317,23,2300,2937,8416,715,1328,95,2566,3851,8555,67,341
425,1317,13,2690,3168,7613,244,1747,150,2981,2756,7878,67,342
329,606,5,2396,2335,5671,190,1007,18,2659,2279,6153,67,343
2391,1056,4,2059,2440,7950,988,1541,26,2129,3832,8516,67,344
3312,1069,5,2291,2784,9461,1226,1713,17,2346,4454,9756,67,345
3246,1221,0,2304,2656,9427,1156,1645,18,2262,4578,9659,67,346
3051,1232,7,2591,3224,10105,1016,2092,25,2562,4724,10419,67,347
1983,1696,25,2764,2984,9452,731,1646,138,3024,4081,9620,67,348
1094,1478,28,3630,3224,9454,392,1710,133,4114,3141,9490,67,349
348,712,6,2178,2072,5316,251,901,16,2442,1988,5598,67,350
2130,962,13,2015,2570,7690,951,1128,19,2271,3714,8083,67,351
2811,1110,18,2208,3028,9175,1179,1427,29,2447,4293,9375,67,352
2636,1118,7,2258,3024,9043,1161,1340,18,2533,4198,9250,67,353
2310,1159,5,2327,2971,8772,934,1431,14,2621,3963,8963,67,354
1412,1327,20,2297,2792,7848,648,1433,80,2784,3218,8163,67,355
311,1223,14,2423,2781,6752,256,977,55,2910,2705,6903,67,356
249,723,29,2066,2244,5311,169,751,18,2300,2107,5345,67,357
1021,1118,7,2288,2706,7140,623,932,17,2785,3039,7396,67,358
484,290,7,1634,2068,4483,472,423,8,2309,1427,4639,67,359
122,117,4,486,387,1116,57,351,2,358,500,1268,67,360
642,936,9,1870,2234,5691,455,895,12,2232,2483,6077,67,361
697,1118,15,2071,2490,6391,463,995,45,2401,2802,6706,67,362
252,1074,18,1815,1997,5156,176,897,60,2239,2080,5452,67,363
249,609,8,1848,2008,4722,186,674,27,2095,1999,4981,67,364
1051,1039,17,2204,2513,6824,597,1033,20,2353,3112,7115,67,365
897,686,143,2106,2225,6057,532,609,384,2465,2155,6145,67,366
85,132,4,370,226,817,66,180,5,273,336,860,68,1
871,175,15,623,404,2088,173,327,19,408,995,1922,68,2
1227,178,13,608,503,2529,277,373,19,430,1233,2332,68,3
1285,174,1,604,516,2580,272,389,5,415,1287,2368,68,4
936,242,8,616,558,2360,271,407,27,444,1006,2155,68,5
144,183,15,491,230,1063,63,267,17,304,353,1004,68,6
121,175,1,556,277,1130,49,286,3,320,345,1003,68,7
1165,185,9,527,521,2407,296,369,9,394,1170,2238,68,8
1395,129,19,521,336,2400,290,289,21,474,1181,2255,68,9
1437,207,3,703,494,2844,289,473,4,460,1412,2638,68,10
1374,190,2,594,584,2744,280,488,6,398,1290,2462,68,11
992,244,6,756,542,2540,314,367,24,591,1052,2348,68,12
163,195,12,715,414,1499,57,314,29,350,605,1355,68,13
87,166,0,528,297,1078,54,229,7,318,392,1000,68,14
179,169,4,540,301,1193,82,277,4,340,443,1146,68,15
408,154,1,427,291,1281,138,286,2,288,484,1198,68,16
1015,181,6,801,499,2502,157,439,14,493,1293,2396,68,17
1394,203,0,604,561,2762,257,580,3,433,1299,2572,68,18
467,262,10,461,379,1579,120,353,27,347,610,1457,68,19
162,199,5,629,364,1359,56,390,23,390,413,1272,68,20
116,139,4,506,309,1074,56,252,4,330,388,1030,68,21
1270,147,2,593,485,2497,275,385,9,406,1246,2321,68,22
1538,159,2,602,501,2802,319,446,9,374,1456,2604,68,23
1421,166,5,701,524,2817,290,503,6,416,1258,2473,68,24
1403,211,0,676,525,2815,286,530,5,429,1268,2518,68,25
889,259,17,629,604,2398,217,470,29,464,884,2064,68,26
166,232,20,712,407,1537,78,375,24,404,532,1413,68,27
114,156,2,561,227,1060,60,209,3,389,400,1061,68,28
1219,140,12,601,458,2430,310,386,10,411,1196,2313,68,29
1515,220,9,595,542,2881,292,527,10,415,1533,2777,68,30
1500,201,7,660,479,2847,302,527,9,391,1316,2545,68,31
1482,204,6,646,557,2895,338,518,10,406,1301,2573,68,32
978,247,17,620,564,2426,272,530,34,448,1022,2306,68,33
185,205,11,657,379,1437,72,370,41,388,505,1376,68,34
111,119,9,529,264,1032,53,202,9,321,404,989,68,35
1269,141,1,552,443,2406,311,359,10,411,1197,2288,68,36
1521,208,4,623,520,2876,312,475,10,394,1413,2604,68,37
1505,209,2,635,542,2893,317,515,5,412,1392,2641,68,38
1420,226,4,631,544,2825,308,507,3,417,1364,2599,68,39
993,259,7,636,580,2475,298,470,20,493,1077,2358,68,40
151,274,11,650,477,1563,69,431,42,387,521,1450,68,41
120,212,5,531,290,1158,49,254,6,341,447,1097,68,42
1218,169,1,569,481,2438,303,376,11,399,1289,2378,68,43
1524,244,9,600,551,2928,350,528,14,448,1444,2784,68,44
1432,201,2,690,556,2881,379,526,6,498,1412,2821,68,45
1458,193,0,468,422,2541,319,440,4,248,1039,2050,68,46
839,250,7,697,541,2334,214,424,27,524,904,2093,68,47
169,211,6,662,380,1428,65,331,34,360,461,1251,68,48
107,163,14,566,282,1132,39,265,16,328,425,1073,68,49
401,139,7,584,262,1393,96,260,14,395,516,1281,68,50
1432,205,8,622,480,2747,344,478,12,434,1351,2619,68,51
1451,189,3,685,534,2862,311,482,9,473,1389,2664,68,52
1351,242,4,662,592,2851,284,549,10,453,1325,2621,68,53
1025,262,13,661,573,2534,281,475,26,490,1065,2337,68,54
173,231,13,664,405,1486,68,368,31,400,556,1423,68,55
136,156,6,539,309,1146,54,270,8,356,399,1087,68,56
1238,170,3,587,568,2566,304,439,4,375,1189,2311,68,57
1468,217,1,690,532,2908,327,486,6,431,1516,2766,68,58
1472,196,16,695,470,2849,287,485,16,449,1455,2692,68,59
1467,234,2,676,584,2963,315,534,6,448,1428,2731,68,60
1045,233,11,667,638,2594,299,530,47,508,1061,2445,68,61
173,244,11,610,398,1436,62,385,37,331,546,1361,68,62
130,170,3,571,303,1177,52,245,10,374,426,1107,68,63
1227,172,10,578,515,2502,307,447,7,402,1249,2412,68,64
1461,235,1,691,519,2907,418,593,6,423,1475,2915,68,65
1462,213,3,654,525,2857,303,545,3,460,1440,2751,68,66
1440,257,0,658,613,2968,314,629,7,457,1462,2869,68,67
1004,295,10,671,609,2589,321,568,35,507,1080,2511,68,68
196,261,14,740,437,1648,77,412,30,455,531,1505,68,69
120,189,2,605,322,1238,46,289,6,411,526,1278,68,70
1198,191,14,603,501,2507,294,437,16,405,1226,2378,68,71
1488,219,3,706,546,2962,287,549,15,456,1442,2749,68,72
1480,351,2,761,655,3249,306,652,21,506,1406,2891,68,73
1230,278,4,761,640,2913,272,671,18,452,1216,2629,68,74
843,320,18,800,603,2584,229,570,57,576,1029,2461,68,75
298,333,11,886,551,2079,96,527,34,615,622,1894,68,76
152,208,5,678,391,1434,64,398,4,427,515,1408,68,77
1277,161,2,686,590,2716,334,476,1,487,1323,2621,68,78
1555,219,3,755,587,3119,347,611,7,461,1591,3017,68,79
1536,250,1,765,652,3204,331,679,5,476,1468,2959,68,80
1428,244,3,745,684,3104,322,690,23,474,1488,2997,68,81
1069,303,5,754,662,2793,268,608,45,530,1247,2698,68,82
168,296,18,687,430,1599,64,515,37,356,548,1520,68,83
177,179,2,787,422,1567,80,344,5,438,593,1460,68,84
1233,219,8,693,536,2689,260,510,11,465,1281,2527,68,85
1505,254,4,693,605,3061,306,620,7,433,1546,2912,68,86
1397,217,5,777,546,2942,305,554,6,444,1432,2741,68,87
1415,262,3,829,575,3084,352,608,8,497,1470,2935,68,88
947,380,19,833,697,2876,312,582,37,536,1136,2603,68,89
180,331,19,996,538,2064,77,517,44,538,738,1914,68,90
134,165,1,558,305,1163,60,318,0,346,455,1179,68,91
1070,193,3,716,555,2537,272,505,8,448,1226,2459,68,92
1524,178,3,706,504,2915,335,526,3,445,1461,2770,68,93
1467,212,3,713,507,2902,283,555,8,440,1406,2692,68,94
1428,235,2,820,689,3174,347,646,3,499,1551,3046,68,95
908,327,14,812,686,2747,246,579,49,549,1117,2540,68,96
267,317,8,849,440,1881,85,448,33,559,590,1715,68,97
336,195,4,694,363,1592,81,326,4,580,520,1511,68,98
1200,178,22,684,513,2597,305,445,114,440,1232,2536,68,99
1522,209,9,682,565,2987,336,613,15,449,1403,2816,68,100
1466,259,5,783,568,3081,332,601,12,465,1379,2789,68,101
1425,215,4,688,603,2935,298,610,10,440,1427,2785,68,102
1004,249,24,839,628,2744,281,580,49,551,1074,2535,68,103
218,248,10,829,489,1794,137,514,47,454,628,1780,68,104
134,250,2,698,352,1436,67,407,5,354,550,1383,68,105
985,207,8,680,468,2348,202,512,11,413,1075,2213,68,106
1263,248,2,740,499,2752,210,627,8,461,1219,2525,68,107
1297,252,2,745,541,2837,211,643,4,428,1230,2516,68,108
1182,263,12,770,491,2718,212,551,21,438,1185,2407,68,109
659,328,13,470,578,2048,171,584,35,413,1020,2223,68,110
174,303,25,754,573,1829,100,592,44,406,697,1839,68,111
159,154,0,579,294,1186,69,265,7,409,522,1272,68,112
1278,226,4,643,558,2709,322,539,4,424,1346,2635,68,113
1557,252,12,736,600,3157,317,599,12,470,1498,2896,68,114
1488,250,5,696,593,3032,313,627,11,446,1411,2808,68,115
1447,233,10,774,635,3099,332,613,21,493,1435,2894,68,116
1082,318,15,754,667,2836,326,610,29,462,1180,2607,68,117
230,241,32,710,439,1652,73,434,47,393,492,1439,68,118
133,203,7,583,401,1327,50,366,9,396,468,1289,68,119
1218,180,11,616,520,2545,322,459,9,568,1229,2587,68,120
1566,231,2,663,501,2963,352,568,9,494,1402,2825,68,121
1453,248,5,746,587,3039,334,582,14,485,1446,2861,68,122
1465,254,9,728,609,3065,331,596,19,468,1416,2830,68,123
1000,339,17,836,677,2869,319,577,42,633,1218,2789,68,124
198,206,10,709,391,1514,81,371,34,410,621,1517,68,125
164,178,1,632,302,1277,57,273,12,433,483,1258,68,126
1205,166,1,580,502,2454,305,472,3,435,1224,2439,68,127
1583,232,4,728,590,3137,361,587,7,510,1433,2898,68,128
1517,239,8,739,598,3101,328,624,14,544,1471,2981,68,129
1392,221,8,754,628,3003,355,597,20,500,1463,2935,68,130
1013,308,16,752,610,2699,329,499,32,483,1160,2503,68,131
222,264,10,889,477,1862,83,442,37,475,680,1717,68,132
142,205,9,548,316,1220,57,326,9,344,461,1197,68,133
1233,215,13,675,563,2699,316,486,17,427,1335,2581,68,134
1479,216,12,701,561,2969,327,590,17,478,1509,2921,68,135
1528,224,14,828,573,3167,371,563,26,485,1484,2929,68,136
1429,236,0,617,593,2875,286,599,5,445,1329,2664,68,137
991,278,14,682,570,2535,319,505,37,512,1110,2483,68,138
179,267,24,716,348,1534,62,426,50,442,526,1506,68,139
152,164,0,589,303,1208,66,354,3,387,451,1261,68,140
1178,182,18,589,513,2480,273,464,21,428,1272,2458,68,141
1466,191,0,638,557,2852,306,557,7,416,1445,2731,68,142
1479,215,4,650,578,2926,319,539,9,453,1438,2758,68,143
1405,232,1,640,585,2863,329,552,7,454,1333,2675,68,144
930,235,12,673,615,2465,281,492,37,481,1001,2292,68,145
175,237,10,616,407,1445,81,459,24,385,490,1439,68,146
146,187,6,552,331,1222,51,351,15,302,479,1198,68,147
148,118,2,539,246,1053,67,259,7,321,460,1114,68,148
1391,178,4,660,515,2748,341,453,8,404,1435,2641,68,149
1375,195,10,695,428,2703,284,503,9,435,1412,2643,68,150
1371,215,1,677,596,2860,331,519,14,464,1381,2709,68,151
1062,273,10,711,621,2677,295,527,30,502,1095,2449,68,152
171,278,15,677,430,1571,68,434,40,394,567,1503,68,153
134,158,1,522,287,1102,55,275,3,321,422,1076,68,154
1185,151,7,675,515,2533,327,453,10,449,1247,2486,68,155
1369,191,14,684,483,2741,275,555,17,454,1356,2657,68,156
1540,217,6,674,491,2928,354,533,11,477,1427,2802,68,157
1439,253,16,709,602,3019,324,614,16,502,1388,2844,68,158
1064,707,23,830,683,3307,296,648,35,538,1528,3045,68,159
225,314,14,930,744,2227,83,819,80,479,733,2194,68,160
114,205,3,654,337,1313,55,375,18,350,486,1284,68,161
1212,165,4,646,486,2513,281,451,8,456,1200,2396,68,162
1472,234,14,760,493,2973,311,604,15,478,1386,2794,68,163
1507,193,4,711,520,2935,311,627,11,511,1317,2777,68,164
1327,233,2,708,595,2865,270,582,21,506,1286,2665,68,165
978,313,11,764,599,2665,296,615,42,568,1012,2533,68,166
243,278,22,706,455,1704,103,431,42,478,520,1574,68,167
129,194,1,575,292,1191,68,318,8,393,437,1224,68,168
1000,177,7,664,455,2303,247,456,11,437,1109,2260,68,169
1291,260,16,718,519,2804,242,580,36,534,1278,2670,68,170
402,218,2,658,451,1731,107,441,12,415,639,1614,68,171
1169,230,9,689,506,2603,206,554,21,500,1136,2417,68,172
833,281,8,705,545,2372,238,521,41,520,904,2224,68,173
217,372,10,675,453,1727,102,550,64,504,532,1752,68,174
153,173,17,587,286,1216,55,323,28,368,439,1213,68,175
1104,181,6,677,441,2409,255,434,7,542,1123,2361,68,176
1382,209,4,740,509,2844,258,561,7,519,1307,2652,68,177
1418,347,7,711,524,3007,302,613,14,528,1450,2907,68,178
1331,268,7,776,540,2922,262,600,21,569,1334,2786,68,179
937,320,11,700,618,2586,250,567,39,540,1000,2396,68,180
205,297,19,696,415,1632,77,431,47,467,537,1559,68,181
138,168,18,556,292,1172,62,291,12,360,399,1124,68,182
1021,154,3,688,452,2318,243,469,5,519,985,2221,68,183
1212,224,9,719,516,2680,250,536,12,508,1253,2559,68,184
989,270,8,767,593,2627,240,557,19,611,1109,2536,68,185
141,779,11,614,467,2012,70,813,20,430,523,1856,68,186
531,247,12,722,455,1967,170,461,42,438,735,1846,68,187
183,257,8,629,310,1387,82,348,32,384,517,1363,68,188
146,193,2,566,246,1153,65,279,5,350,456,1155,68,189
1119,193,3,652,459,2426,244,487,4,534,1133,2402,68,190
1356,224,2,700,518,2800,319,559,6,569,1321,2774,68,191
1364,205,2,741,532,2844,281,583,10,557,1324,2755,68,192
1337,233,10,677,540,2797,292,617,15,505,1211,2640,68,193
909,283,14,663,550,2419,271,506,50,543,914,2284,68,194
185,280,15,670,375,1525,81,429,34,414,492,1450,68,195
137,192,4,531,261,1125,61,299,17,360,411,1148,68,196
1046,148,1,575,413,2183,274,384,4,454,1104,2220,68,197
1316,197,3,673,411,2600,256,512,12,489,1321,2590,68,198
1313,148,3,768,437,2669,258,449,16,516,1262,2501,68,199
1214,255,3,692,456,2620,229,577,10,498,1216,2530,68,200
799,297,14,642,531,2283,236,506,62,463,948,2215,68,201
162,274,14,570,466,1486,86,458,39,391,567,1541,68,202
138,182,1,537,281,1139,65,294,7,363,443,1172,68,203
1028,131,2,612,395,2168,246,411,8,412,1047,2124,68,204
1327,192,3,656,496,2674,251,555,10,469,1240,2525,68,205
1250,198,3,704,517,2672,254,529,14,558,1321,2676,68,206
1238,213,3,650,475,2579,251,510,9,462,1204,2436,68,207
863,273,20,714,606,2476,221,564,55,540,964,2344,68,208
220,280,31,612,497,1640,97,501,76,418,537,1629,68,209
144,154,3,529,279,1109,88,306,12,368,387,1161,68,210
1026,176,2,647,431,2282,199,449,8,485,1038,2179,68,211
1269,214,10,618,451,2562,226,524,14,420,1277,2461,68,212
1221,211,11,663,443,2549,200,486,19,486,1245,2436,68,213
1121,243,16,745,489,2614,199,602,25,510,1162,2498,68,214
803,248,24,680,509,2264,202,515,34,510,861,2122,68,215
232,214,13,660,394,1513,103,328,33,421,553,1438,68,216
159,155,10,546,265,1135,67,300,12,374,404,1157,68,217
910,178,12,630,421,2151,215,441,18,435,999,2108,68,218
1176,214,8,699,442,2539,225,550,16,471,1230,2492,68,219
1110,197,2,696,414,2419,215,474,7,409,1146,2251,68,220
1031,199,2,608,410,2250,205,488,6,432,1060,2191,68,221
680,248,9,531,418,1886,193,406,34,411,709,1753,68,222
153,267,9,600,443,1472,93,393,38,393,468,1385,68,223
132,163,3,515,248,1061,65,309,9,357,387,1127,68,224
859,165,4,551,401,1980,190,419,6,408,905,1928,68,225
1122,189,7,631,412,2361,240,499,6,432,1073,2250,68,226
1117,211,6,651,465,2450,231,561,12,440,1122,2366,68,227
1018,207,7,683,503,2418,214,531,13,457,1052,2267,68,228
775,269,8,661,529,2242,214,488,39,481,846,2068,68,229
177,221,11,601,385,1395,94,364,31,360,472,1321,68,230
138,168,6,497,259,1068,58,267,4,327,357,1013,68,231
989,157,9,533,415,2103,280,385,11,367,999,2042,68,232
1137,237,2,606,501,2483,304,452,11,420,1178,2365,68,233
1122,163,1,672,465,2423,301,508,11,473,1038,2331,68,234
1112,219,1,649,497,2478,295,475,12,433,1113,2328,68,235
827,277,11,619,554,2288,319,481,35,425,870,2130,68,236
204,243,17,693,397,1554,91,433,38,390,586,1538,68,237
133,165,6,517,265,1086,63,268,15,343,433,1122,68,238
1137,144,1,586,467,2335,322,459,5,385,1179,2350,68,239
1429,217,10,654,529,2839,348,518,9,387,1440,2702,68,240
1390,192,1,628,502,2713,352,534,6,409,1306,2607,68,241
1343,160,6,599,550,2658,329,447,8,417,1337,2538,68,242
976,219,8,680,597,2480,282,485,39,546,907,2259,68,243
190,202,8,696,353,1449,95,370,31,391,543,1430,68,244
136,188,2,565,300,1191,61,309,11,338,501,1220,68,245
155,151,7,501,232,1046,76,303,11,345,384,1119,68,246
1571,186,4,610,529,2900,401,435,8,486,1417,2747,68,247
1469,168,3,649,544,2833,315,467,8,462,1471,2723,68,248
1451,187,14,655,592,2899,337,561,15,426,1358,2697,68,249
1108,293,19,638,597,2655,320,515,40,519,1094,2488,68,250
186,272,24,704,408,1594,83,442,40,481,612,1658,68,251
135,146,1,539,324,1145,83,270,5,427,443,1228,68,252
1300,182,12,561,525,2580,317,477,17,451,1327,2589,68,253
1528,266,10,649,590,3043,330,611,24,417,1488,2870,68,254
1521,226,4,698,606,3055,331,642,16,449,1497,2935,68,255
1525,232,4,647,567,2975,303,664,10,382,1430,2789,68,256
1081,309,13,697,730,2830,352,653,35,529,1252,2821,68,257
195,313,15,706,490,1719,96,534,46,388,588,1652,68,258
166,168,2,602,322,1260,74,279,10,407,555,1325,68,259
1301,129,1,597,563,2591,349,495,6,476,1303,2629,68,260
1592,209,4,725,581,3111,379,577,12,528,1610,3106,68,261
1582,227,33,671,587,3100,340,671,34,507,1488,3040,68,262
1559,221,4,714,656,3154,361,696,13,473,1431,2974,68,263
1139,325,14,762,631,2871,389,573,37,540,1160,2699,68,264
16,10,6,9,8,49,26,6,8,12,10,62,68,265
12,2,0,7,7,28,18,1,2,9,4,34,68,266
1369,144,2,593,509,2617,365,481,6,439,1310,2601,68,267
1608,191,1,655,632,3087,419,563,9,443,1666,3100,68,268
1556,221,1,741,562,3081,355,616,3,471,1507,2952,68,269
1571,225,2,736,605,3139,381,625,9,421,1411,2847,68,270
1137,302,11,761,595,2806,361,545,30,584,1145,2665,68,271
218,350,15,669,454,1706,91,475,50,445,607,1668,68,272
109,131,1,625,275,1141,66,304,4,363,480,1217,68,273
1335,167,3,689,565,2759,396,495,8,474,1362,2735,68,274
1663,239,6,660,593,3161,385,586,16,475,1578,3040,68,275
1510,165,5,697,593,2970,401,556,10,462,1523,2952,68,276
1469,216,2,683,594,2964,383,575,12,449,1376,2795,68,277
1146,283,9,799,622,2859,377,568,38,566,1218,2767,68,278
193,240,15,659,437,1544,84,522,37,363,588,1594,68,279
151,127,8,533,302,1121,81,314,14,354,492,1255,68,280
1303,165,2,608,586,2664,385,518,9,478,1332,2722,68,281
1604,195,4,705,614,3122,353,594,9,438,1659,3053,68,282
1526,180,3,713,585,3007,369,654,10,522,1385,2940,68,283
1194,211,6,713,616,2740,295,629,14,505,1310,2753,68,284
839,293,8,783,612,2535,253,527,37,549,1060,2426,68,285
241,300,18,813,500,1872,90,459,31,471,672,1723,68,286
218,214,1,676,304,1413,108,407,10,430,497,1452,68,287
467,148,1,709,393,1718,150,393,8,396,764,1711,68,288
1511,298,7,723,681,3220,358,638,17,465,1662,3140,68,289
1533,228,2,816,617,3196,384,665,11,560,1592,3212,68,290
1515,241,3,824,676,3259,438,623,10,502,1544,3117,68,291
1037,338,23,737,734,2869,339,625,33,489,1202,2688,68,292
283,346,20,776,489,1914,113,558,54,498,700,1923,68,293
157,176,2,664,393,1392,75,426,7,407,542,1457,68,294
1331,182,2,609,606,2730,351,502,8,420,1420,2701,68,295
1689,214,9,717,652,3281,443,594,15,468,1597,3117,68,296
1609,214,1,704,640,3168,395,644,3,475,1499,3016,68,297
1528,225,4,715,692,3164,383,674,11,466,1479,3013,68,298
1159,337,23,718,672,2909,359,604,29,558,1175,2725,68,299
254,315,10,753,463,1795,96,484,43,461,634,1718,68,300
294,159,3,703,343,1502,82,395,7,503,503,1490,68,301
1282,161,1,611,552,2607,344,462,4,411,1393,2614,68,302
1556,217,5,667,968,3413,367,932,11,503,1555,3368,68,303
1539,197,28,758,615,3137,388,622,33,510,1518,3071,68,304
1393,462,2,691,651,3199,296,612,21,450,1601,2980,68,305
1000,297,9,726,589,2621,247,530,38,538,1155,2508,68,306
207,286,15,781,497,1786,80,582,30,450,623,1765,68,307
179,176,7,628,327,1317,77,266,14,425,509,1291,68,308
1123,151,4,715,555,2548,252,424,4,468,1272,2420,68,309
1193,204,6,631,489,2523,278,413,16,487,1230,2424,68,310
1348,185,5,695,568,2801,345,492,12,486,1369,2704,68,311
1467,211,7,696,658,3039,345,582,12,439,1468,2846,68,312
1116,234,2,664,729,2745,310,549,22,534,1132,2547,68,313
211,275,18,747,421,1672,113,439,42,427,597,1618,68,314
180,144,1,620,298,1243,79,280,7,385,572,1323,68,315
498,137,1,610,417,1663,113,391,5,431,753,1693,68,316
1560,193,13,708,581,3055,388,529,21,488,1663,3089,68,317
1545,206,4,725,632,3112,336,621,12,491,1615,3075,68,318
1522,178,7,696,643,3046,375,580,19,490,1584,3048,68,319
1169,286,14,732,643,2844,346,557,27,546,1178,2654,68,320
212,253,21,649,427,1562,91,447,51,428,562,1579,68,321
168,162,2,586,312,1230,83,299,2,407,493,1284,68,322
1372,154,2,564,580,2672,329,472,5,377,1452,2635,68,323
1660,210,2,702,593,3167,395,573,8,446,1657,3079,68,324
1600,209,8,719,566,3102,368,548,11,468,1618,3013,68,325
1584,201,3,707,657,3152,373,602,6,484,1574,3039,68,326
1092,250,8,798,589,2737,351,480,27,581,1224,2663,68,327
187,208,12,786,487,1680,118,406,18,466,562,1570,68,328
145,153,2,621,327,1248,66,282,5,323,532,1208,68,329
1164,176,3,612,584,2539,320,396,13,439,1327,2495,68,330
1121,214,2,696,635,2668,292,450,15,495,1303,2555,68,331
654,158,6,724,455,1997,180,342,13,565,714,1814,68,332
108,84,0,332,172,696,67,151,1,248,209,676,68,333
303,142,6,625,315,1391,110,329,17,425,593,1474,68,334
146,181,6,588,348,1269,83,334,26,363,489,1295,68,335
146,119,3,566,315,1149,70,314,7,377,507,1275,68,336
1142,149,1,592,531,2415,310,461,7,387,1313,2478,68,337
1547,185,8,703,611,3054,381,630,12,453,1637,3113,68,338
1510,171,1,745,557,2984,343,598,8,509,1521,2979,68,339
1461,175,5,767,662,3070,329,661,12,464,1571,3037,68,340
1102,210,15,712,632,2671,326,484,21,514,1175,2520,68,341
15,8,4,27,8,62,22,5,3,22,9,61,68,342
5,11,1,19,1,37,5,7,1,18,5,36,68,343
1322,168,2,616,586,2694,320,499,10,456,1473,2758,68,344
1610,240,5,760,644,3259,339,608,9,504,1770,3230,68,345
1543,176,2,686,523,2930,307,620,12,436,1518,2893,68,346
1519,195,30,785,665,3194,415,673,41,476,1535,3140,68,347
1199,299,12,777,722,3009,359,586,46,579,1229,2799,68,348
246,285,9,791,496,1827,74,536,52,453,660,1775,68,349
140,150,1,544,310,1145,78,298,7,356,505,1244,68,350
1342,181,3,730,571,2827,338,476,6,470,1432,2722,68,351
1528,210,2,717,678,3135,326,589,4,515,1608,3042,68,352
1464,199,4,785,579,3031,344,558,6,474,1452,2834,68,353
1387,187,4,721,674,2973,337,552,10,491,1432,2822,68,354
776,197,11,695,522,2201,275,406,24,475,796,1976,68,355
155,149,6,554,330,1194,58,264,18,324,414,1078,68,356
107,97,6,441,226,877,48,165,5,268,377,863,68,357
396,109,5,553,363,1426,168,235,11,328,543,1285,68,358
213,84,5,424,210,936,102,140,6,301,300,849,68,359
53,46,1,191,82,373,25,85,3,134,117,364,68,360
278,97,0,415,283,1073,104,219,0,295,403,1021,68,361
267,108,5,408,234,1022,102,145,14,270,358,889,68,362
79,94,0,281,157,611,49,95,11,204,194,553,68,363
66,101,0,238,207,612,49,115,69,163,228,624,68,364
383,140,5,479,303,1310,128,269,4,353,596,1350,68,365
443,282,88,641,368,1822,137,359,144,514,659,1813,68,366
37,65,1,207,139,449,28,101,7,184,162,482,69,1
424,64,4,262,312,1066,203,119,10,231,590,1153,69,2
559,105,4,270,393,1331,219,193,15,244,675,1346,69,3
533,78,5,306,337,1259,208,157,10,247,673,1295,69,4
335,116,4,280,385,1120,159,245,19,233,514,1170,69,5
90,73,4,288,171,626,51,151,18,228,208,656,69,6
72,62,3,374,243,754,46,138,9,314,331,838,69,7
498,95,5,238,337,1173,179,199,15,215,639,1247,69,8
627,60,3,221,218,1129,203,141,6,228,585,1163,69,9
696,76,3,272,347,1394,231,202,11,263,735,1442,69,10
629,90,3,314,430,1466,225,244,7,286,732,1494,69,11
354,67,9,302,350,1082,167,182,19,231,463,1062,69,12
57,101,4,549,272,983,39,159,18,280,455,951,69,13
56,50,1,289,167,563,32,108,3,228,219,590,69,14
76,77,16,266,222,657,78,134,22,253,276,763,69,15
192,62,5,199,213,671,112,140,2,174,258,686,69,16
580,74,3,287,360,1304,236,188,6,254,717,1401,69,17
624,97,6,286,444,1457,269,321,8,238,713,1549,69,18
258,100,10,307,278,953,126,228,18,219,364,955,69,19
76,81,5,331,280,773,31,160,29,266,319,805,69,20
58,63,2,256,201,580,46,139,5,206,255,651,69,21
507,95,4,249,261,1116,177,191,7,225,647,1247,69,22
703,94,6,314,382,1499,225,265,12,272,811,1585,69,23
708,90,6,286,383,1473,238,251,13,265,759,1526,69,24
630,106,3,280,354,1373,223,284,6,253,657,1423,69,25
392,113,7,310,398,1220,165,240,24,302,538,1269,69,26
82,139,3,541,365,1130,43,217,20,384,472,1136,69,27
68,53,3,315,188,627,45,129,5,256,232,667,69,28
543,73,3,258,359,1236,247,178,6,234,640,1305,69,29
727,109,6,262,355,1459,241,234,6,232,853,1566,69,30
675,94,2,292,387,1450,231,261,6,249,758,1505,69,31
650,95,4,320,395,1464,224,244,8,262,740,1478,69,32
411,103,3,262,443,1222,165,232,29,266,529,1221,69,33
71,126,13,428,307,945,44,192,35,312,364,947,69,34
63,71,6,367,221,728,33,121,7,315,333,809,69,35
522,74,3,230,318,1147,181,163,5,209,652,1210,69,36
712,85,4,280,423,1504,251,262,6,223,811,1553,69,37
669,125,10,275,409,1488,225,302,10,249,765,1551,69,38
660,93,4,305,383,1445,278,241,5,268,713,1505,69,39
439,144,4,306,390,1283,195,234,21,306,577,1333,69,40
79,133,5,498,357,1072,62,251,31,380,378,1102,69,41
57,87,3,261,201,609,30,141,13,224,271,679,69,42
502,101,18,294,319,1234,208,197,23,278,598,1304,69,43
665,114,2,264,360,1405,217,286,9,213,776,1501,69,44
696,84,3,266,361,1410,217,212,13,248,794,1484,69,45
608,95,4,290,375,1372,228,242,11,272,662,1415,69,46
334,130,7,309,370,1150,177,217,32,301,511,1238,69,47
69,101,5,423,238,836,44,166,13,279,376,878,69,48
72,82,3,401,209,767,38,149,5,266,311,769,69,49
139,84,1,368,264,856,102,165,5,361,362,995,69,50
696,96,8,294,419,1513,250,295,8,248,843,1644,69,51
733,117,3,318,441,1612,318,270,8,280,768,1644,69,52
659,81,2,309,402,1453,267,263,4,234,714,1482,69,53
437,119,10,298,350,1214,159,228,26,272,532,1217,69,54
72,124,6,384,339,925,37,217,42,331,320,947,69,55
64,81,5,340,205,695,40,160,5,283,264,752,69,56
571,70,4,283,360,1288,179,230,8,268,675,1360,69,57
742,93,7,291,355,1488,231,267,11,253,806,1568,69,58
700,94,5,305,332,1436,239,224,10,234,760,1467,69,59
652,106,19,326,417,1520,250,288,21,248,762,1569,69,60
410,131,8,319,431,1299,172,290,34,292,554,1342,69,61
79,113,10,383,284,869,35,210,23,238,340,846,69,62
92,103,2,394,284,875,50,158,7,365,376,956,69,63
569,110,4,270,349,1302,240,192,10,236,707,1385,69,64
681,105,5,338,388,1517,252,268,11,226,835,1592,69,65
734,134,8,280,413,1569,275,312,13,248,764,1612,69,66
698,132,7,307,471,1615,256,318,17,293,796,1680,69,67
437,131,11,378,464,1421,188,277,23,323,631,1442,69,68
90,90,7,416,188,791,50,188,24,287,308,857,69,69
69,90,5,370,232,766,40,155,13,260,353,821,69,70
531,116,21,343,322,1333,183,253,30,256,661,1383,69,71
754,102,4,373,438,1671,233,318,18,254,942,1765,69,72
746,135,5,395,453,1734,246,334,12,289,873,1754,69,73
684,155,9,474,528,1850,241,344,30,353,898,1866,69,74
372,162,6,402,465,1407,194,268,51,320,586,1419,69,75
186,196,19,705,404,1510,71,362,52,482,584,1551,69,76
65,143,4,506,299,1017,37,251,11,351,443,1093,69,77
596,119,4,347,386,1452,219,248,9,326,728,1530,69,78
773,103,4,359,399,1638,276,310,7,300,802,1695,69,79
816,145,6,417,456,1840,264,424,10,343,908,1949,69,80
738,130,9,440,492,1809,282,386,19,352,805,1844,69,81
426,159,2,436,522,1545,211,335,41,381,623,1591,69,82
49,133,6,406,317,911,42,262,17,258,378,957,69,83
102,101,4,668,283,1158,37,214,7,387,584,1229,69,84
554,121,5,431,401,1512,193,315,12,296,765,1581,69,85
739,97,5,436,478,1755,240,358,10,294,921,1823,69,86
678,102,3,366,386,1535,241,277,11,258,841,1628,69,87
620,115,6,448,363,1552,228,315,11,318,789,1661,69,88
364,179,4,475,458,1480,187,366,30,340,622,1545,69,89
154,171,8,805,380,1518,67,374,37,472,621,1571,69,90
77,62,3,416,216,774,41,178,6,233,385,843,69,91
477,94,6,432,364,1373,196,340,8,255,680,1479,69,92
714,81,10,370,371,1546,234,240,11,260,867,1612,69,93
706,99,9,315,364,1493,235,299,13,219,776,1542,69,94
690,121,3,417,453,1684,233,356,8,310,825,1732,69,95
425,152,4,409,452,1442,173,313,37,316,623,1462,69,96
139,133,6,561,358,1197,64,315,42,449,421,1291,69,97
188,133,2,495,339,1157,60,300,4,459,473,1296,69,98
540,105,4,327,343,1319,214,255,9,248,687,1413,69,99
749,129,2,310,415,1605,254,292,11,263,870,1690,69,100
787,102,2,363,444,1698,257,315,11,311,918,1812,69,101
683,132,2,354,356,1527,239,301,7,254,802,1603,69,102
424,148,3,404,426,1405,215,329,32,309,604,1489,69,103
140,179,20,552,476,1367,57,376,51,416,475,1375,69,104
104,105,1,443,247,900,44,243,6,414,354,1061,69,105
553,108,4,297,416,1378,226,275,5,280,676,1462,69,106
744,144,6,363,472,1729,316,335,17,287,899,1854,69,107
766,168,15,395,466,1810,321,347,18,279,824,1789,69,108
734,133,3,433,491,1794,327,318,15,316,822,1798,69,109
418,114,7,418,498,1455,182,338,29,352,596,1497,69,110
97,155,3,717,484,1456,53,463,27,376,571,1490,69,111
97,79,7,475,218,876,41,175,16,330,362,924,69,112
596,106,6,304,338,1350,214,234,7,243,678,1376,69,113
786,108,5,365,435,1699,234,334,9,281,913,1771,69,114
788,113,2,375,560,1838,264,420,9,342,895,1930,69,115
694,109,4,400,485,1692,269,356,8,333,794,1760,69,116
444,159,5,357,455,1420,214,349,24,317,610,1514,69,117
100,120,9,483,317,1029,65,277,53,304,370,1069,69,118
80,116,9,488,290,983,52,252,36,368,447,1155,69,119
589,105,4,308,315,1321,205,253,8,275,721,1462,69,120
763,112,3,358,380,1616,262,284,5,281,922,1754,69,121
785,124,6,339,408,1662,266,309,19,295,833,1722,69,122
688,160,2,382,427,1659,258,336,6,333,776,1709,69,123
426,203,7,309,506,1451,188,373,30,335,547,1473,69,124
109,129,4,496,317,1055,62,286,19,358,386,1111,69,125
65,79,4,333,266,747,42,201,8,315,281,847,69,126
572,94,2,281,342,1291,235,270,6,242,655,1408,69,127
770,125,6,322,462,1685,257,375,13,275,848,1768,69,128
774,143,4,335,476,1732,262,408,11,269,854,1804,69,129
647,126,4,369,448,1594,299,274,10,277,784,1644,69,130
433,128,5,317,338,1221,205,220,19,264,557,1265,69,131
143,106,3,595,342,1189,61,233,18,416,520,1248,69,132
77,123,3,366,228,797,41,192,9,306,389,937,69,133
593,123,5,347,370,1438,234,264,11,324,780,1613,69,134
786,104,4,346,421,1661,336,254,9,271,885,1755,69,135
710,125,7,319,475,1636,308,312,11,270,850,1751,69,136
678,164,2,418,445,1707,320,351,7,287,852,1817,69,137
413,180,9,391,444,1437,199,265,43,329,647,1483,69,138
81,129,7,425,274,916,54,270,28,376,341,1069,69,139
134,114,4,452,273,977,54,205,8,403,423,1093,69,140
588,137,15,326,422,1488,238,314,19,299,738,1608,69,141
803,139,14,352,494,1802,309,352,22,290,936,1909,69,142
768,132,15,393,428,1736,302,278,9,282,917,1788,69,143
683,130,4,321,437,1575,273,287,8,268,817,1653,69,144
388,170,6,413,545,1522,175,401,27,410,546,1559,69,145
124,163,4,566,444,1301,70,354,32,382,443,1281,69,146
114,126,3,531,285,1059,41,256,6,392,465,1160,69,147
108,100,6,404,227,845,63,162,9,341,366,941,69,148
758,107,7,320,379,1571,278,280,9,307,832,1706,69,149
767,129,10,373,368,1647,266,278,12,332,873,1761,69,150
702,146,8,387,469,1712,272,347,15,340,809,1783,69,151
466,180,4,356,423,1429,192,271,23,327,637,1450,69,152
122,148,6,478,391,1145,70,292,26,425,404,1217,69,153
121,117,1,436,257,932,51,203,9,414,303,980,69,154
620,114,2,352,446,1534,235,309,5,342,800,1691,69,155
804,129,1,368,537,1839,312,354,3,292,924,1885,69,156
831,140,1,340,437,1749,335,331,5,286,858,1815,69,157
711,144,4,367,569,1795,298,422,14,313,804,1851,69,158
453,193,8,367,648,1669,202,515,40,335,635,1727,69,159
108,196,13,846,609,1772,61,649,47,419,515,1691,69,160
79,123,2,566,317,1087,60,262,10,364,489,1185,69,161
633,132,2,321,382,1470,250,239,6,296,769,1560,69,162
812,149,2,393,522,1878,334,326,4,294,1022,1980,69,163
815,170,3,395,532,1915,328,389,21,325,923,1986,69,164
739,167,3,426,483,1818,329,334,8,321,871,1863,69,165
506,156,7,361,563,1593,211,408,31,388,663,1701,69,166
111,174,10,561,435,1291,68,387,40,405,469,1369,69,167
76,113,2,494,244,929,55,235,5,343,387,1025,69,168
606,136,2,334,365,1443,235,254,7,285,746,1527,69,169
789,130,3,371,582,1875,290,375,16,402,837,1920,69,170
218,149,5,493,416,1281,173,316,9,411,422,1331,69,171
643,169,4,462,493,1771,298,336,6,339,1253,2232,69,172
411,201,5,364,388,1369,216,270,32,326,536,1380,69,173
101,235,9,408,350,1103,68,395,45,337,317,1162,69,174
62,115,4,332,216,729,59,190,11,314,275,849,69,175
596,127,2,351,372,1448,242,266,12,306,735,1561,69,176
845,143,2,363,448,1801,316,347,12,328,905,1908,69,177
817,110,2,392,425,1746,321,251,11,323,873,1779,69,178
731,180,3,448,459,1821,272,362,12,399,860,1905,69,179
461,170,7,429,459,1526,205,288,30,384,640,1547,69,180
123,162,8,547,411,1251,77,277,35,419,452,1260,69,181
80,109,12,340,246,787,56,205,13,318,283,875,69,182
617,148,7,386,462,1620,249,346,6,359,812,1772,69,183
769,152,6,463,464,1854,286,360,16,370,918,1950,69,184
622,224,6,392,570,1814,255,458,13,385,780,1891,69,185
161,745,4,633,517,2060,73,1179,28,481,378,2139,69,186
222,164,2,429,381,1198,150,309,28,346,422,1255,69,187
111,124,5,439,282,961,71,267,21,334,313,1006,69,188
88,122,3,401,212,826,53,189,5,333,313,893,69,189
582,138,2,310,415,1447,253,278,10,279,771,1591,69,190
770,151,3,340,433,1697,322,322,6,297,864,1811,69,191
741,149,3,396,438,1727,326,305,7,277,857,1772,69,192
715,193,3,369,464,1744,296,370,4,307,815,1792,69,193
443,202,9,458,422,1534,226,292,27,353,642,1540,69,194
117,217,13,418,520,1285,70,440,27,411,391,1339,69,195
71,130,7,353,231,792,49,195,5,368,283,900,69,196
599,132,2,334,342,1409,242,310,10,250,605,1417,69,197
720,140,1,317,405,1583,291,272,11,259,816,1649,69,198
704,111,3,350,386,1554,285,289,5,302,789,1670,69,199
669,174,4,428,474,1749,266,325,7,343,838,1779,69,200
446,234,8,420,576,1684,231,392,101,385,617,1726,69,201
107,193,4,534,434,1272,82,369,42,395,388,1276,69,202
98,110,2,443,303,956,48,182,11,390,443,1074,69,203
566,121,1,362,424,1474,289,273,4,290,716,1572,69,204
794,161,3,416,557,1931,319,346,10,358,940,1973,69,205
742,164,2,417,572,1897,313,439,12,396,835,1995,69,206
679,156,2,446,479,1762,293,370,8,328,891,1890,69,207
446,231,7,432,439,1555,213,332,47,390,709,1691,69,208
155,201,12,490,431,1289,63,370,62,421,433,1349,69,209
114,120,3,389,288,914,55,221,8,429,328,1041,69,210
622,146,6,384,464,1622,279,315,21,322,788,1725,69,211
840,149,1,358,463,1811,309,330,4,347,979,1969,69,212
780,166,3,381,416,1746,294,305,12,362,872,1845,69,213
704,152,1,397,446,1700,282,349,13,352,785,1781,69,214
471,173,3,419,503,1569,233,426,23,383,570,1635,69,215
146,130,2,598,388,1264,76,284,25,454,455,1294,69,216
114,151,2,461,324,1052,52,214,4,431,456,1157,69,217
611,170,4,348,405,1538,222,330,9,317,694,1572,69,218
735,122,6,345,485,1693,285,310,12,329,865,1801,69,219
723,147,3,343,452,1668,309,284,9,347,833,1782,69,220
637,111,4,326,393,1471,221,269,13,309,736,1548,69,221
328,171,6,326,418,1249,182,288,45,263,461,1239,69,222
119,191,7,522,451,1290,79,327,25,459,422,1312,69,223
82,148,11,443,267,951,57,219,12,420,366,1074,69,224
549,149,2,396,399,1495,238,252,4,366,793,1653,69,225
757,163,3,383,495,1801,312,319,5,373,926,1935,69,226
722,148,3,384,467,1724,261,276,8,341,897,1783,69,227
697,179,2,409,460,1747,255,319,10,407,792,1783,69,228
442,179,4,411,472,1508,198,290,21,379,617,1505,69,229
87,183,4,519,401,1194,67,243,39,427,461,1237,69,230
67,111,9,417,329,933,58,174,9,371,366,978,69,231
587,138,2,382,401,1510,222,224,4,350,798,1598,69,232
783,163,5,392,469,1812,240,367,10,372,939,1928,69,233
728,176,2,424,535,1865,269,357,9,411,956,2002,69,234
640,176,4,425,480,1725,238,331,9,370,864,1812,69,235
448,211,5,377,500,1541,197,335,23,354,654,1563,69,236
155,215,10,600,506,1486,79,412,26,443,535,1495,69,237
88,137,6,405,315,951,65,197,10,447,396,1115,69,238
591,145,7,339,458,1540,238,383,4,317,761,1703,69,239
822,157,4,351,523,1857,283,377,4,315,895,1874,69,240
746,139,4,379,485,1753,270,346,7,320,829,1772,69,241
661,152,3,397,440,1653,285,289,7,333,769,1683,69,242
334,163,6,461,496,1460,194,354,32,443,498,1521,69,243
116,174,10,583,422,1305,69,336,26,471,497,1399,69,244
74,182,3,544,336,1139,58,294,7,385,490,1234,69,245
90,131,3,472,302,998,86,224,6,455,370,1141,69,246
781,133,4,366,437,1721,314,289,4,312,915,1834,69,247
816,146,3,385,424,1774,340,348,5,357,904,1954,69,248
732,147,9,387,451,1726,296,336,16,314,809,1771,69,249
495,168,14,398,467,1542,254,306,24,385,631,1600,69,250
115,159,5,589,479,1347,93,355,49,472,508,1477,69,251
75,150,2,400,296,923,46,200,4,397,341,988,69,252
654,126,3,304,430,1517,247,285,4,304,770,1610,69,253
876,134,17,365,493,1885,312,325,22,323,974,1956,69,254
844,162,7,382,487,1882,296,429,19,348,987,2079,69,255
813,188,15,410,511,1937,303,434,16,334,886,1973,69,256
512,202,20,369,551,1654,204,373,40,382,703,1702,69,257
93,204,6,572,536,1411,71,400,40,492,471,1474,69,258
72,130,9,488,309,1008,47,215,12,391,434,1099,69,259
643,97,7,322,424,1493,228,270,16,297,768,1579,69,260
840,105,11,382,417,1755,280,295,12,299,942,1828,69,261
808,124,2,357,426,1717,269,325,8,305,927,1834,69,262
772,148,7,385,532,1844,293,376,10,334,882,1895,69,263
507,204,16,420,448,1595,224,293,57,391,669,1634,69,264
120,159,10,660,404,1353,94,324,36,477,463,1394,69,265
69,106,2,398,313,888,46,180,3,368,365,962,69,266
627,103,8,327,395,1460,233,207,13,341,789,1583,69,267
880,90,5,372,439,1786,277,317,11,293,934,1832,69,268
873,106,5,351,477,1812,293,360,10,312,913,1888,69,269
758,119,12,398,424,1711,263,338,19,322,845,1787,69,270
511,170,2,344,482,1509,202,364,24,405,597,1592,69,271
128,198,6,578,523,1433,70,424,48,446,470,1458,69,272
88,125,7,441,279,940,56,194,8,366,385,1009,69,273
661,108,14,326,414,1523,235,261,15,301,813,1625,69,274
869,108,9,348,394,1728,293,288,9,264,951,1805,69,275
871,146,4,405,458,1884,317,332,9,282,989,1929,69,276
736,136,5,423,531,1831,259,324,4,353,953,1893,69,277
512,195,4,461,435,1607,210,283,32,442,688,1655,69,278
100,210,7,573,580,1470,80,305,24,662,444,1515,69,279
58,126,2,471,263,920,53,218,5,381,420,1077,69,280
675,125,4,329,426,1559,243,281,4,312,853,1693,69,281
934,162,6,368,434,1904,286,298,8,318,1096,2006,69,282
871,130,11,429,450,1891,286,335,8,361,1027,2017,69,283
813,116,2,452,504,1887,263,346,7,346,997,1959,69,284
410,187,5,488,516,1606,216,323,34,438,682,1693,69,285
127,180,8,640,489,1444,73,349,29,421,519,1391,69,286
302,120,3,483,352,1260,61,237,7,592,441,1338,69,287
293,110,1,498,348,1250,168,255,8,404,603,1438,69,288
959,104,10,455,526,2054,298,370,11,370,1068,2117,69,289
927,113,3,410,462,1915,273,344,11,327,1033,1988,69,290
790,139,11,409,512,1861,282,398,18,331,944,1973,69,291
485,174,5,418,505,1587,211,288,33,376,721,1629,69,292
136,184,10,598,478,1406,55,328,58,485,449,1375,69,293
81,96,7,461,296,941,46,275,8,389,383,1101,69,294
720,108,7,365,429,1629,236,283,9,325,854,1707,69,295
976,139,6,396,483,2000,320,311,9,344,1074,2058,69,296
935,136,21,395,527,2014,320,354,17,355,986,2032,69,297
815,183,3,420,541,1962,305,371,9,354,970,2009,69,298
513,226,7,434,549,1729,216,327,35,415,760,1753,69,299
118,172,8,642,471,1411,81,286,53,532,520,1472,69,300
531,125,7,631,394,1688,101,242,13,795,556,1707,69,301
715,96,2,376,409,1598,224,262,7,316,891,1700,69,302
918,109,2,453,687,2169,268,573,6,390,1020,2257,69,303
873,146,4,398,504,1925,277,373,8,357,1023,2038,69,304
746,136,3,413,496,1794,284,308,7,332,909,1840,69,305
514,178,8,425,511,1636,211,260,34,416,686,1607,69,306
123,209,8,579,509,1428,65,366,34,473,516,1454,69,307
100,98,4,421,303,926,63,213,4,448,345,1073,69,308
706,107,8,365,417,1603,243,236,9,355,848,1691,69,309
741,118,1,411,436,1707,288,211,12,396,852,1759,69,310
682,121,5,350,492,1650,298,311,8,316,842,1775,69,311
783,130,9,370,451,1743,265,304,19,324,903,1815,69,312
463,169,7,468,521,1628,188,270,37,460,664,1619,69,313
121,161,3,617,426,1328,72,208,27,480,479,1266,69,314
81,82,1,477,278,919,42,154,6,383,411,996,69,315
269,100,2,469,332,1172,137,241,5,395,543,1321,69,316
913,105,1,384,461,1864,288,288,7,351,1041,1975,69,317
899,112,2,330,498,1841,283,361,8,294,995,1941,69,318
817,124,6,317,470,1734,271,330,16,301,857,1775,69,319
514,162,9,336,443,1464,210,299,26,358,666,1559,69,320
104,199,15,610,400,1328,59,203,28,437,557,1284,69,321
88,90,4,391,277,850,65,192,9,349,323,938,69,322
717,118,2,295,388,1520,228,238,12,278,833,1589,69,323
910,128,2,390,443,1873,280,337,3,323,1037,1980,69,324
910,100,11,394,495,1910,284,285,18,358,1092,2037,69,325
826,106,1,386,499,1818,288,357,8,325,921,1899,69,326
508,125,2,339,416,1390,209,224,29,370,628,1460,69,327
109,159,3,494,412,1177,64,285,29,369,453,1200,69,328
92,105,3,409,249,858,40,176,11,370,390,987,69,329
598,98,6,394,390,1486,239,215,7,336,793,1590,69,330
627,113,3,395,428,1566,265,235,8,342,768,1618,69,331
394,121,11,477,426,1429,196,255,10,473,480,1414,69,332
77,29,1,165,99,371,33,74,4,166,127,404,69,333
158,91,2,511,262,1024,125,180,12,385,465,1167,69,334
70,94,2,398,277,841,76,194,12,322,368,972,69,335
54,84,1,348,300,787,52,220,9,311,359,951,69,336
639,114,10,302,357,1422,224,220,15,290,822,1571,69,337
827,117,3,385,536,1868,319,326,9,332,959,1945,69,338
869,125,1,345,455,1795,308,297,8,311,937,1861,69,339
779,86,4,290,472,1631,304,312,8,278,816,1718,69,340
482,101,6,337,434,1360,212,241,28,330,606,1417,69,341
83,169,13,504,462,1231,78,324,39,372,409,1222,69,342
66,90,4,439,328,927,39,209,4,377,390,1019,69,343
639,104,7,305,410,1465,227,238,18,294,830,1607,69,344
924,101,5,420,572,2022,395,326,13,342,1000,2076,69,345
821,107,3,351,460,1742,364,277,8,291,888,1828,69,346
791,101,3,498,510,1903,339,380,9,350,858,1936,69,347
502,154,6,415,477,1554,205,338,23,370,698,1634,69,348
194,162,9,653,473,1491,65,338,38,538,493,1472,69,349
59,105,2,349,264,779,45,207,8,315,304,879,69,350
631,87,6,333,384,1441,215,233,16,322,783,1569,69,351
844,123,12,377,521,1877,271,296,19,324,989,1899,69,352
757,102,4,397,476,1736,270,270,11,309,909,1769,69,353
714,133,10,429,527,1813,261,325,16,347,824,1773,69,354
393,136,8,400,477,1414,166,286,26,397,534,1409,69,355
84,108,3,446,313,954,58,181,21,353,328,941,69,356
43,69,2,387,290,791,32,184,5,265,318,804,69,357
264,94,5,400,360,1123,157,174,11,356,426,1124,69,358
117,49,4,276,190,636,116,70,6,250,217,659,69,359
21,20,1,109,52,203,12,77,8,70,81,248,69,360
163,91,8,331,275,868,129,169,13,269,346,926,69,361
177,97,3,397,303,977,126,187,13,350,370,1046,69,362
51,104,2,264,201,622,46,146,16,244,254,706,69,363
53,76,9,346,206,690,59,126,25,290,298,798,69,364
309,103,5,461,390,1268,202,247,13,391,569,1422,69,365
239,209,70,426,300,1244,184,178,161,374,440,1337,69,366
29,37,1,55,79,201,24,88,5,65,89,271,70,1
236,49,0,145,254,684,193,121,0,120,300,734,70,2
294,57,2,157,308,818,222,143,1,126,319,811,70,3
296,55,1,151,255,758,214,138,3,126,313,794,70,4
164,82,3,192,232,673,155,138,32,118,240,683,70,5
44,43,1,104,97,289,31,91,15,81,103,321,70,6
34,42,0,158,75,309,20,97,2,95,133,347,70,7
242,67,1,136,235,681,196,119,0,101,282,698,70,8
303,49,21,129,218,720,217,81,17,123,279,717,70,9
332,78,1,183,322,916,276,144,2,178,383,983,70,10
340,78,0,184,334,936,233,181,5,172,356,947,70,11
189,59,1,162,181,592,122,108,5,117,212,564,70,12
54,65,0,230,101,450,20,119,19,106,168,432,70,13
27,34,0,108,85,254,16,55,2,68,104,245,70,14
66,43,2,105,104,320,61,65,9,82,78,295,70,15
109,32,1,126,119,387,118,78,0,77,123,396,70,16
264,75,8,148,247,742,203,127,11,128,293,762,70,17
304,70,3,171,324,872,225,145,8,148,340,866,70,18
106,58,0,156,134,454,94,101,17,114,129,455,70,19
39,57,1,170,113,380,30,129,23,96,150,428,70,20
35,30,0,124,82,271,19,84,4,86,116,309,70,21
209,62,3,155,243,672,187,110,3,113,279,692,70,22
351,66,4,187,315,923,260,115,6,146,378,905,70,23
336,82,4,151,334,907,274,151,9,134,345,913,70,24
340,69,1,155,272,837,237,172,1,144,325,879,70,25
209,84,6,205,232,736,153,152,29,153,245,732,70,26
61,82,8,233,172,556,39,137,40,137,238,591,70,27
29,48,0,151,97,325,19,94,6,113,148,380,70,28
267,65,3,135,241,711,203,118,8,124,273,726,70,29
364,84,3,195,316,962,274,146,2,182,370,974,70,30
372,68,1,181,325,947,276,156,5,153,372,962,70,31
345,77,7,182,311,922,242,166,9,137,382,936,70,32
222,83,1,172,253,731,163,133,26,145,282,749,70,33
58,93,5,173,185,514,31,149,41,131,189,541,70,34
49,41,2,164,90,346,26,89,3,130,132,380,70,35
280,50,3,147,266,746,202,124,6,111,294,737,70,36
376,70,4,167,338,955,285,159,5,136,373,958,70,37
340,74,4,149,318,885,261,140,6,145,335,887,70,38
345,94,2,168,327,936,248,178,5,151,372,954,70,39
197,84,4,164,245,694,148,123,29,144,296,740,70,40
58,68,1,247,154,528,32,137,24,162,177,532,70,41
45,42,0,151,92,330,24,110,9,124,145,412,70,42
252,50,0,145,231,678,165,112,5,138,284,704,70,43
303,57,0,144,305,809,246,165,6,123,291,831,70,44
325,68,3,152,281,829,229,136,5,137,347,854,70,45
345,66,3,182,268,864,237,120,5,152,346,860,70,46
231,85,1,181,223,721,179,136,12,151,267,745,70,47
56,71,5,168,129,429,30,101,25,121,144,421,70,48
37,71,0,161,111,380,24,94,8,133,144,403,70,49
98,54,0,158,164,474,87,84,1,137,158,467,70,50
373,86,1,190,318,968,259,147,2,151,394,953,70,51
376,56,0,181,360,973,298,135,3,159,364,959,70,52
340,63,2,157,307,869,247,147,3,146,392,935,70,53
220,80,4,166,227,697,156,125,17,163,265,726,70,54
59,72,3,187,145,466,42,136,33,138,176,525,70,55
39,33,1,134,119,326,17,101,6,135,128,387,70,56
298,76,2,161,268,805,229,129,6,147,294,805,70,57
397,77,2,159,365,1000,289,156,6,156,408,1015,70,58
333,69,0,130,278,810,223,133,4,132,344,836,70,59
349,76,4,176,300,905,239,171,11,172,399,992,70,60
226,109,3,183,263,784,173,185,25,162,272,817,70,61
44,94,6,194,149,487,39,134,40,140,168,521,70,62
35,56,2,217,136,446,28,123,4,114,198,467,70,63
289,73,0,180,276,818,206,113,5,151,334,809,70,64
380,79,0,144,323,926,259,155,5,140,408,967,70,65
365,67,1,169,323,925,261,145,5,150,343,904,70,66
332,56,0,187,335,910,247,146,17,162,383,955,70,67
222,124,0,179,247,772,165,175,31,157,256,784,70,68
62,89,3,175,111,440,29,154,33,138,142,496,70,69
28,56,1,147,76,308,19,109,4,98,139,369,70,70
249,73,0,130,270,722,205,110,4,143,308,770,70,71
371,84,0,228,343,1026,301,160,7,170,415,1053,70,72
367,97,2,195,391,1052,275,195,10,192,414,1086,70,73
360,100,0,253,359,1072,267,211,13,177,424,1092,70,74
207,101,1,222,244,775,156,161,29,169,297,812,70,75
93,134,4,400,206,837,42,297,39,187,296,861,70,76
51,61,1,262,134,509,19,184,6,130,211,550,70,77
281,69,1,194,251,796,215,156,6,166,342,885,70,78
391,92,0,200,362,1045,290,181,4,179,444,1098,70,79
379,97,0,200,405,1081,276,229,15,195,407,1122,70,80
353,87,0,229,349,1018,247,216,6,168,405,1042,70,81
238,92,3,273,305,911,173,231,30,164,330,928,70,82
49,84,4,195,148,480,37,142,30,128,174,511,70,83
66,70,1,363,123,623,26,155,5,162,304,652,70,84
274,52,0,244,302,872,231,171,18,143,369,932,70,85
398,64,0,269,381,1112,285,199,4,208,418,1114,70,86
312,78,1,147,323,861,253,168,5,137,355,918,70,87
313,61,1,240,319,934,228,165,9,162,366,930,70,88
203,92,9,246,256,806,163,179,22,154,286,804,70,89
67,81,4,340,197,689,29,221,28,142,295,715,70,90
53,60,1,210,112,436,33,143,4,137,155,472,70,91
271,73,0,231,257,832,212,184,13,173,294,876,70,92
369,55,0,176,335,935,288,158,10,154,372,982,70,93
396,91,0,205,358,1050,292,172,5,168,378,1015,70,94
380,80,1,249,361,1071,260,232,13,165,412,1082,70,95
237,80,9,229,312,867,168,202,18,147,311,846,70,96
64,82,4,274,118,542,36,134,27,166,226,589,70,97
78,65,0,252,116,511,33,170,4,161,176,544,70,98
253,70,4,189,254,770,190,158,3,151,292,794,70,99
371,82,2,206,364,1025,291,177,11,176,420,1075,70,100
365,90,2,184,361,1002,256,229,8,197,378,1068,70,101
384,69,3,218,359,1033,237,221,7,175,368,1008,70,102
211,117,4,218,285,835,189,205,33,131,342,900,70,103
94,98,3,365,189,749,27,233,53,146,337,796,70,104
59,69,1,228,128,485,33,143,3,136,232,547,70,105
257,78,2,184,275,796,215,182,6,151,336,890,70,106
399,93,1,190,362,1045,309,191,5,163,434,1102,70,107
372,80,2,221,413,1088,318,203,6,174,380,1081,70,108
394,99,1,247,367,1108,290,194,7,190,405,1086,70,109
236,99,1,191,269,796,173,182,34,152,306,847,70,110
54,130,7,390,170,751,28,319,50,153,258,808,70,111
44,54,0,221,105,424,26,113,14,118,188,459,70,112
270,80,3,173,238,764,203,152,4,158,327,844,70,113
374,92,3,185,404,1058,307,190,5,165,431,1098,70,114
386,111,9,203,449,1158,319,246,7,166,415,1153,70,115
359,89,1,265,370,1084,257,219,10,187,381,1054,70,116
212,86,3,222,309,832,188,178,38,173,274,851,70,117
61,72,4,229,163,529,29,162,42,146,176,555,70,118
52,59,0,245,146,502,26,181,36,137,262,642,70,119
289,63,3,197,329,881,241,151,7,152,306,857,70,120
399,76,3,178,368,1024,320,143,9,177,407,1056,70,121
410,96,3,207,379,1095,300,177,5,177,425,1084,70,122
391,104,4,233,320,1052,249,184,2,169,394,998,70,123
233,89,4,199,286,811,171,195,20,141,303,830,70,124
64,95,2,210,133,504,28,149,19,152,167,515,70,125
49,87,0,186,126,448,24,161,10,118,157,470,70,126
268,82,3,192,298,843,235,162,4,169,314,884,70,127
423,87,5,215,392,1122,331,166,20,165,445,1127,70,128
406,120,1,218,395,1140,322,229,14,212,420,1197,70,129
345,99,0,223,346,1013,285,215,10,164,379,1053,70,130
244,81,3,228,238,794,168,135,17,165,287,772,70,131
76,80,1,272,143,572,46,172,22,145,232,617,70,132
43,73,0,202,99,417,30,119,5,134,185,473,70,133
289,65,2,191,307,854,228,158,9,178,331,904,70,134
453,85,0,165,384,1087,364,157,9,188,468,1186,70,135
412,99,3,222,431,1167,354,184,8,194,402,1142,70,136
393,97,4,263,393,1150,298,200,18,180,408,1104,70,137
250,91,4,250,259,854,169,180,22,172,301,844,70,138
52,122,4,210,140,528,28,168,35,145,168,544,70,139
50,61,0,280,146,537,30,128,10,181,215,564,70,140
299,61,2,226,314,902,248,168,4,159,359,938,70,141
400,110,3,228,406,1147,326,180,10,193,446,1155,70,142
398,99,1,274,399,1171,335,186,11,179,423,1134,70,143
367,115,2,227,360,1071,286,198,11,182,391,1068,70,144
221,113,5,303,271,913,198,251,23,206,269,947,70,145
77,104,2,295,153,631,36,208,25,179,219,667,70,146
66,78,1,297,156,598,27,184,16,158,257,642,70,147
52,73,3,174,88,390,22,121,4,118,161,426,70,148
423,92,2,206,402,1125,327,148,17,221,450,1163,70,149
417,72,3,269,387,1148,331,173,5,252,424,1185,70,150
378,96,4,245,407,1130,343,190,17,188,403,1141,70,151
245,143,6,214,296,904,202,195,37,194,341,969,70,152
73,123,1,270,165,632,32,210,23,175,231,671,70,153
53,54,0,239,115,461,37,126,5,165,200,533,70,154
345,105,6,214,343,1013,276,181,12,171,384,1024,70,155
485,96,4,222,492,1299,392,220,16,165,534,1327,70,156
464,105,5,240,431,1245,375,215,9,213,436,1248,70,157
430,97,5,269,439,1240,327,236,8,242,451,1264,70,158
288,137,11,305,354,1095,221,307,53,239,449,1269,70,159
98,151,10,474,216,949,49,445,65,194,280,1033,70,160
56,67,0,285,213,621,29,216,2,183,229,659,70,161
373,92,6,257,372,1100,287,176,10,186,408,1067,70,162
482,105,4,216,472,1279,403,222,10,222,452,1309,70,163
447,107,3,230,465,1252,398,270,22,181,485,1356,70,164
440,105,4,291,432,1272,336,226,11,212,458,1243,70,165
267,140,10,246,311,974,195,180,60,185,326,946,70,166
73,124,3,272,174,646,44,223,31,165,212,675,70,167
53,81,2,176,136,448,35,156,7,157,194,549,70,168
326,77,6,214,330,953,289,175,10,171,386,1031,70,169
434,109,3,232,439,1217,351,224,18,188,480,1261,70,170
191,97,0,274,295,857,183,168,7,205,267,830,70,171
430,124,5,237,385,1181,298,188,20,188,481,1175,70,172
253,108,9,232,286,888,193,191,41,176,272,873,70,173
102,112,6,201,155,576,35,200,37,181,178,631,70,174
60,73,0,199,136,468,32,144,7,129,161,473,70,175
337,81,4,191,332,945,262,172,14,145,415,1008,70,176
325,100,11,207,426,1069,402,227,9,184,445,1267,70,177
479,114,4,245,439,1281,324,268,8,207,498,1305,70,178
447,120,5,246,401,1219,263,292,21,255,518,1349,70,179
280,161,4,270,315,1030,205,218,45,647,323,1438,70,180
77,107,2,248,150,584,39,190,36,144,237,646,70,181
52,79,0,195,106,432,27,119,5,144,165,460,70,182
337,95,0,220,352,1004,269,200,4,165,395,1033,70,183
444,107,4,270,417,1242,355,219,4,219,461,1258,70,184
343,113,4,312,355,1127,282,242,19,198,382,1123,70,185
92,211,7,290,290,890,41,449,49,154,190,883,70,186
150,107,3,230,235,725,114,188,20,175,292,789,70,187
76,95,3,245,128,547,41,141,24,134,230,570,70,188
49,56,0,179,89,373,31,129,4,137,177,478,70,189
296,77,0,265,318,956,280,204,6,177,364,1031,70,190
418,83,4,224,394,1123,343,168,10,214,443,1178,70,191
421,85,3,223,401,1133,350,216,12,201,393,1172,70,192
405,92,4,239,422,1162,317,237,12,193,420,1179,70,193
221,104,0,238,269,832,182,176,41,173,302,874,70,194
87,111,8,251,204,661,45,263,35,140,222,705,70,195
61,66,0,159,134,420,34,136,12,136,177,495,70,196
319,90,5,183,282,879,263,186,7,166,316,938,70,197
466,93,3,189,411,1162,365,203,13,158,450,1189,70,198
407,91,4,199,399,1100,368,159,5,185,432,1149,70,199
416,129,1,237,422,1205,292,236,8,192,445,1173,70,200
239,136,4,226,319,924,181,225,48,154,329,937,70,201
68,127,6,321,225,747,47,232,59,212,195,745,70,202
69,73,0,236,104,482,28,146,6,153,195,528,70,203
318,84,3,191,359,955,267,177,9,122,378,953,70,204
459,91,4,209,437,1200,347,232,8,194,450,1231,70,205
429,102,3,230,521,1285,350,254,19,216,472,1311,70,206
423,122,4,243,375,1167,303,247,17,204,481,1252,70,207
227,133,6,283,307,956,206,217,49,178,333,983,70,208
85,120,5,295,191,696,55,249,53,206,242,805,70,209
57,88,0,191,120,456,21,143,7,145,210,526,70,210
319,94,3,230,392,1038,287,200,36,208,426,1157,70,211
414,104,4,262,450,1234,369,207,7,235,468,1286,70,212
418,105,1,194,467,1185,366,200,5,188,458,1217,70,213
359,111,4,230,389,1093,327,211,16,179,433,1166,70,214
255,129,16,279,329,1008,208,236,66,145,317,972,70,215
73,101,6,298,145,623,30,237,32,187,152,638,70,216
51,71,1,228,137,488,27,138,7,184,205,561,70,217
298,86,4,191,320,899,268,185,4,166,317,940,70,218
475,90,14,217,418,1214,367,188,20,194,491,1260,70,219
412,102,5,252,402,1173,354,192,8,238,450,1242,70,220
370,89,3,218,282,962,272,128,13,174,366,953,70,221
183,130,10,211,213,747,168,171,46,138,267,790,70,222
72,150,2,263,220,707,29,213,55,174,215,686,70,223
69,58,0,258,142,527,41,132,3,185,211,572,70,224
320,102,0,199,274,895,244,166,5,208,394,1017,70,225
378,116,4,216,385,1099,351,178,3,212,422,1166,70,226
353,109,0,187,374,1023,313,192,7,187,396,1095,70,227
310,106,1,209,381,1007,275,164,19,158,407,1023,70,228
199,124,4,233,311,871,204,206,20,153,305,888,70,229
60,116,7,258,165,606,51,170,43,146,204,614,70,230
52,64,5,155,103,379,22,137,16,141,160,476,70,231
279,71,1,160,289,800,237,152,6,149,352,896,70,232
411,124,3,223,405,1166,357,215,11,203,443,1229,70,233
405,105,2,193,423,1128,333,189,12,203,444,1181,70,234
359,121,3,239,395,1117,279,198,16,166,449,1108,70,235
252,131,6,274,308,971,185,212,31,209,338,975,70,236
90,105,6,267,155,623,30,186,32,143,265,656,70,237
50,55,2,222,116,445,17,146,12,143,183,501,70,238
302,70,0,175,318,865,252,187,2,137,373,951,70,239
402,71,4,175,412,1064,324,207,14,187,435,1167,70,240
385,107,3,201,427,1123,296,195,9,190,450,1140,70,241
359,77,3,213,370,1022,247,170,32,179,355,983,70,242
222,108,7,267,281,885,164,183,32,183,278,840,70,243
59,94,5,290,134,582,32,189,34,146,227,628,70,244
63,74,0,254,115,506,36,151,9,147,235,578,70,245
51,68,5,223,136,483,37,163,8,190,206,604,70,246
384,105,13,189,349,1040,304,185,14,187,407,1097,70,247
374,138,4,227,404,1147,298,229,10,213,451,1201,70,248
359,141,7,201,378,1086,285,224,13,197,408,1127,70,249
228,120,7,246,304,905,195,183,31,188,324,921,70,250
90,92,3,255,178,618,49,189,56,157,196,647,70,251
57,57,0,220,104,438,30,127,7,146,190,500,70,252
306,68,0,191,317,882,236,150,3,177,394,960,70,253
427,88,9,206,412,1142,317,182,8,188,474,1169,70,254
394,120,1,192,447,1154,332,229,6,179,453,1199,70,255
408,99,3,198,412,1120,270,207,12,177,473,1139,70,256
241,112,4,223,328,908,176,195,19,175,332,897,70,257
80,119,2,273,184,658,32,221,32,200,232,717,70,258
67,61,0,232,140,500,24,145,0,159,195,523,70,259
333,81,8,195,310,927,250,170,6,160,354,940,70,260
461,110,2,240,389,1202,353,190,10,224,506,1283,70,261
401,88,4,195,424,1112,319,182,9,200,452,1162,70,262
400,95,4,212,379,1090,285,206,6,171,417,1085,70,263
235,129,5,217,304,890,179,186,35,173,338,911,70,264
59,78,7,257,201,602,32,210,46,178,212,678,70,265
48,59,2,185,113,407,23,140,4,114,168,449,70,266
338,84,2,186,300,910,260,123,11,170,406,970,70,267
424,100,4,207,402,1137,326,180,9,190,464,1169,70,268
411,96,4,199,410,1120,348,215,7,190,410,1170,70,269
407,99,4,238,391,1139,284,199,9,218,447,1157,70,270
240,103,10,192,319,864,194,187,37,172,301,891,70,271
74,117,7,322,180,700,39,258,46,164,242,749,70,272
58,64,0,193,122,437,32,190,4,129,139,494,70,273
311,81,2,168,339,901,245,163,9,147,388,952,70,274
416,109,0,227,385,1137,317,186,12,198,473,1186,70,275
427,120,2,219,403,1171,310,198,10,193,493,1204,70,276
374,127,2,224,393,1120,244,203,11,205,442,1105,70,277
246,137,3,228,274,888,196,197,30,174,321,918,70,278
74,110,2,290,174,650,27,241,35,139,219,661,70,279
52,69,1,216,154,492,27,120,7,172,208,534,70,280
349,65,2,216,311,943,285,161,10,182,366,1004,70,281
492,93,3,216,388,1192,342,194,12,198,455,1201,70,282
429,121,5,233,410,1198,313,214,12,211,486,1236,70,283
398,93,3,257,380,1131,267,199,14,236,456,1172,70,284
245,128,6,202,310,891,190,166,27,196,347,926,70,285
86,107,3,272,210,678,43,209,30,167,241,690,70,286
83,74,0,237,127,521,46,135,16,164,214,575,70,287
171,67,5,189,241,673,178,124,10,169,263,744,70,288
470,83,4,193,430,1180,322,199,8,190,453,1172,70,289
491,132,4,208,416,1251,348,220,10,177,470,1225,70,290
450,99,2,263,469,1283,309,217,17,195,465,1203,70,291
295,139,5,220,293,952,193,237,15,141,343,929,70,292
78,106,0,258,185,627,44,171,38,171,215,639,70,293
59,74,0,206,122,461,34,151,14,157,204,560,70,294
324,79,2,209,323,937,262,152,15,155,425,1009,70,295
437,84,13,224,453,1211,337,180,20,198,485,1220,70,296
444,114,4,224,525,1311,403,212,15,226,496,1352,70,297
399,108,2,258,414,1181,281,197,12,202,469,1161,70,298
247,117,9,272,292,937,197,208,26,161,342,934,70,299
56,137,4,275,158,630,20,194,34,143,240,631,70,300
159,53,0,304,130,646,34,149,10,206,186,585,70,301
367,78,1,209,306,961,251,150,1,161,391,954,70,302
444,99,6,236,529,1314,324,285,29,183,456,1277,70,303
427,89,3,207,476,1202,306,241,9,208,480,1244,70,304
367,78,3,209,399,1056,272,190,20,179,379,1040,70,305
243,136,6,202,268,855,176,169,38,157,329,869,70,306
66,111,11,286,225,699,30,266,43,178,256,773,70,307
48,42,1,223,113,427,25,100,6,165,179,475,70,308
364,42,1,190,369,966,306,170,12,158,364,1010,70,309
318,83,4,184,379,968,258,146,17,187,403,1011,70,310
373,103,4,166,391,1037,292,193,12,194,406,1097,70,311
413,104,2,207,376,1102,303,174,15,168,427,1087,70,312
250,93,7,245,288,883,171,169,23,196,313,872,70,313
82,86,4,277,157,606,31,170,21,203,215,640,70,314
55,59,4,209,94,421,19,89,12,149,163,432,70,315
181,60,4,208,250,703,150,134,9,178,265,736,70,316
433,105,4,192,429,1163,340,165,8,199,464,1176,70,317
493,131,4,219,506,1353,373,223,10,206,468,1280,70,318
450,93,6,264,357,1170,297,170,17,200,406,1090,70,319
276,93,8,213,267,857,154,157,26,157,337,831,70,320
72,119,2,267,165,625,15,155,49,205,228,652,70,321
61,42,0,184,109,396,33,117,6,136,155,447,70,322
314,86,5,195,306,906,254,145,8,163,389,959,70,323
428,83,8,180,453,1152,319,167,14,187,444,1131,70,324
451,105,2,208,405,1171,328,190,10,185,518,1231,70,325
452,105,2,226,430,1215,292,183,16,177,407,1075,70,326
248,104,7,167,257,783,168,182,21,153,272,796,70,327
63,108,5,254,178,608,25,159,39,136,191,550,70,328
57,54,0,177,125,413,19,97,0,147,163,426,70,329
325,65,2,196,288,876,222,136,8,155,373,894,70,330
324,79,2,229,343,977,227,179,5,187,439,1037,70,331
238,100,3,269,214,824,141,134,5,201,344,825,70,332
38,56,0,96,69,259,18,49,2,125,95,289,70,333
120,93,0,412,168,793,56,172,7,174,313,722,70,334
48,97,2,237,124,508,23,142,26,99,222,512,70,335
48,48,2,178,143,419,28,116,7,120,180,451,70,336
289,68,0,189,301,847,226,139,4,143,369,881,70,337
424,87,5,186,428,1130,293,203,9,183,422,1110,70,338
390,95,4,179,358,1026,288,175,11,158,426,1058,70,339
390,92,3,193,324,1002,229,194,10,172,405,1010,70,340
219,99,5,188,324,835,155,162,38,152,267,774,70,341
49,86,2,223,180,540,28,171,33,167,175,574,70,342
36,53,0,201,105,395,34,124,6,132,187,483,70,343
309,74,1,166,307,857,222,163,7,156,386,934,70,344
443,105,4,199,382,1133,288,209,11,183,462,1153,70,345
398,92,3,157,347,997,296,179,8,178,398,1059,70,346
379,105,0,226,445,1155,249,218,8,227,428,1130,70,347
229,103,5,208,309,854,168,197,27,188,310,890,70,348
86,97,11,259,158,611,33,200,41,166,197,637,70,349
49,57,1,146,99,352,17,122,5,124,137,405,70,350
284,71,1,172,292,820,236,151,2,141,349,879,70,351
377,101,3,196,425,1102,295,176,18,184,474,1147,70,352
349,90,0,178,358,975,289,155,8,206,393,1051,70,353
328,94,1,212,323,958,254,179,10,171,386,1000,70,354
186,127,4,165,251,733,122,180,16,146,223,687,70,355
43,82,3,212,147,487,23,147,16,141,190,517,70,356
36,51,0,162,94,343,23,103,3,96,125,350,70,357
135,58,0,191,188,572,106,143,1,123,228,601,70,358
92,41,0,116,73,322,63,58,0,120,145,386,70,359
29,30,0,44,39,142,7,39,0,51,50,147,70,360
102,59,0,187,115,463,69,99,1,100,175,444,70,361
116,77,1,213,186,593,81,146,12,149,215,603,70,362
26,71,4,175,108,384,14,155,22,95,131,417,70,363
40,57,0,205,87,389,13,101,8,123,208,453,70,364
145,85,0,197,207,634,121,143,7,176,292,739,70,365
146,174,47,196,171,734,89,119,103,151,237,699,70,366
213,270,4,611,484,1582,103,365,5,522,574,1569,71,1
1209,371,3,1044,934,3561,492,580,12,891,1642,3617,71,2
1605,437,12,1188,1058,4300,675,701,24,997,1977,4374,71,3
1561,436,4,1281,994,4276,688,685,11,1045,1936,4365,71,4
1230,524,38,1194,1155,4141,618,744,48,978,1659,4047,71,5
10,8,11,13,5,47,5,7,13,13,6,44,71,6
5,19,17,16,6,63,3,14,12,12,8,49,71,7
1545,398,6,1028,1011,3988,656,718,22,809,1866,4071,71,8
1754,272,1,964,694,3685,652,486,20,851,1656,3665,71,9
1863,456,4,1344,1046,4713,674,744,24,1052,2173,4667,71,10
1826,496,6,1242,1174,4744,643,765,32,1000,2210,4650,71,11
1468,466,21,1288,1186,4429,656,691,54,1117,1812,4330,71,12
365,450,38,1400,899,3152,218,660,58,877,1199,3012,71,13
240,337,3,1000,644,2224,144,397,5,778,782,2106,71,14
331,343,10,906,586,2176,132,481,20,707,853,2193,71,15
777,248,1,805,507,2338,327,429,3,693,856,2308,71,16
1409,424,9,1294,964,4100,411,783,23,882,1961,4060,71,17
1801,497,6,1164,1153,4621,635,883,33,938,2070,4559,71,18
706,452,34,896,775,2863,364,689,75,668,1032,2828,71,19
325,374,27,1136,802,2664,201,560,50,852,877,2540,71,20
256,302,6,930,655,2149,114,431,19,806,730,2100,71,21
1671,383,6,1096,1065,4221,641,745,16,882,1898,4182,71,22
1977,536,0,1272,1157,4942,764,807,11,914,2356,4852,71,23
1922,519,7,1372,1079,4899,772,902,13,1041,2196,4924,71,24
1843,604,13,1344,1112,4916,713,873,37,961,2184,4768,71,25
1364,634,48,1488,1233,4767,651,926,70,1092,1705,4444,71,26
374,510,27,1362,1076,3349,246,711,68,1070,1112,3207,71,27
283,330,9,1041,698,2361,125,444,15,792,795,2171,71,28
1700,468,5,1207,1068,4448,734,747,9,906,1991,4387,71,29
2047,548,2,1364,1132,5093,783,841,18,928,2357,4927,71,30
1983,527,7,1367,1153,5037,773,857,16,1037,2249,4932,71,31
1938,637,5,1433,1192,5205,750,886,30,1123,2303,5092,71,32
1511,547,33,1371,1271,4733,653,828,62,1019,1863,4425,71,33
395,517,31,1349,892,3184,222,686,83,969,1044,3004,71,34
280,357,12,1024,740,2413,159,506,24,809,932,2430,71,35
1670,420,16,1162,1019,4287,766,783,34,859,1971,4413,71,36
2023,556,5,1273,1129,4986,819,886,26,950,2380,5061,71,37
2085,484,7,1377,1169,5122,807,923,14,1064,2247,5055,71,38
1875,574,7,1238,1129,4823,737,921,28,985,2173,4844,71,39
1518,541,30,1332,1336,4757,665,890,76,1053,1894,4578,71,40
711,770,33,2621,1749,5884,401,1580,167,1945,2251,6344,71,41
503,434,2,1977,1104,4020,244,1048,42,1308,1860,4502,71,42
1632,425,4,1129,974,4164,761,682,18,865,1956,4282,71,43
1806,492,24,1252,955,4529,714,897,51,882,1487,4031,71,44
1954,560,21,1396,1231,5162,786,867,30,1077,2388,5148,71,45
1777,443,9,1121,1129,4479,689,838,24,842,2181,4574,71,46
1296,522,48,1200,1126,4192,590,793,68,1008,1619,4078,71,47
329,419,43,1095,856,2742,176,641,70,901,938,2726,71,48
269,321,3,921,705,2219,144,492,20,763,817,2236,71,49
501,283,2,1038,725,2549,266,553,9,828,1010,2666,71,50
1854,450,6,1126,1066,4502,717,812,22,893,2162,4606,71,51
1800,445,4,1392,982,4623,750,780,17,951,2163,4661,71,52
1742,454,6,1130,1078,4410,656,872,18,824,2163,4533,71,53
1451,508,42,1076,1204,4281,601,854,62,935,1858,4310,71,54
380,516,16,1356,958,3226,230,630,61,1162,1088,3171,71,55
247,303,5,868,578,2001,141,498,17,732,791,2179,71,56
1599,383,2,937,1035,3956,723,715,7,768,2027,4240,71,57
1947,393,3,1198,1063,4604,799,821,17,939,2183,4759,71,58
1892,464,5,1321,948,4630,751,783,13,941,2144,4632,71,59
1842,524,2,1111,1103,4582,722,809,15,937,2292,4775,71,60
1458,554,45,1240,1254,4551,667,891,60,1078,1933,4629,71,61
339,533,33,1113,941,2959,182,706,61,955,1035,2939,71,62
293,382,3,1141,693,2512,122,484,12,913,1004,2535,71,63
1622,439,9,1070,992,4132,773,663,13,851,2044,4344,71,64
1880,464,7,1193,1075,4619,741,809,10,938,2315,4813,71,65
1932,513,4,1291,1092,4832,762,869,11,1036,2293,4971,71,66
1835,517,2,1359,1215,4928,719,963,15,999,2218,4914,71,67
1521,531,42,1233,1287,4614,648,905,58,1026,1984,4621,71,68
379,460,36,1202,745,2822,192,646,49,996,967,2850,71,69
266,318,3,1018,619,2224,122,535,13,762,798,2230,71,70
1516,469,2,1098,974,4059,779,774,12,761,1868,4194,71,71
1901,580,3,1278,1099,4861,783,956,13,928,2348,5028,71,72
1905,549,13,1406,1199,5072,781,995,20,1046,2291,5133,71,73
1678,570,3,1397,1280,4928,672,1092,27,1081,2095,4967,71,74
1348,654,29,1403,1315,4749,570,952,84,1166,1933,4705,71,75
509,790,36,1613,1079,4027,290,943,75,1272,1431,4011,71,76
274,427,5,1068,772,2546,132,694,14,802,950,2592,71,77
1637,425,5,1192,1079,4338,816,785,11,901,2037,4550,71,78
2025,570,5,1284,1191,5075,788,1117,12,913,2439,5269,71,79
2105,557,2,1500,1218,5382,872,1079,6,1242,2419,5618,71,80
1918,461,7,1192,1257,4835,670,1041,9,884,2239,4843,71,81
1551,691,35,1237,1327,4841,683,1092,83,1020,2032,4910,71,82
350,509,26,1019,901,2805,182,814,69,861,1011,2937,71,83
366,424,4,1119,657,2570,169,639,11,824,1020,2663,71,84
1774,457,4,1240,1157,4632,781,826,12,941,2178,4738,71,85
1918,522,3,1397,1148,4988,815,963,16,933,2484,5211,71,86
1886,530,3,1337,909,4665,759,952,11,935,2091,4748,71,87
1751,449,7,1328,1089,4624,655,937,12,1004,2122,4730,71,88
1446,669,32,1369,1246,4762,611,988,68,1183,1945,4795,71,89
447,516,32,1511,1068,3574,256,843,65,1194,1238,3596,71,90
273,307,3,1065,649,2297,155,590,18,741,889,2393,71,91
1482,455,5,1165,1049,4156,665,833,12,920,1956,4386,71,92
1956,496,7,1325,1102,4886,846,892,11,961,2460,5170,71,93
1905,458,15,1268,1010,4656,791,994,17,934,2133,4869,71,94
1991,640,10,1325,1395,5361,727,1282,17,1004,3136,6166,71,95
1496,663,36,1339,1273,4807,648,1032,100,1041,1951,4772,71,96
471,615,34,1440,919,3479,230,884,68,1123,1123,3428,71,97
394,421,5,1173,726,2719,161,672,12,948,979,2772,71,98
1670,446,11,1238,985,4350,820,860,28,873,1962,4543,71,99
2066,694,10,1269,1142,5181,868,1045,15,996,2496,5420,71,100
2010,702,13,1450,1124,5299,838,972,27,1130,2524,5491,71,101
1984,576,27,1224,1246,5057,736,928,22,1053,2320,5059,71,102
1533,719,49,1295,1337,4933,715,1080,88,1120,2060,5063,71,103
461,665,46,1472,1146,3790,261,848,95,1266,1310,3780,71,104
322,414,6,1210,852,2804,153,701,23,960,1028,2865,71,105
1412,437,5,1137,907,3898,494,875,13,860,1724,3966,71,106
1601,590,4,1230,925,4350,470,1013,19,911,1998,4411,71,107
1696,525,8,1380,1170,4779,568,998,23,1107,2051,4747,71,108
1638,641,11,1281,1010,4581,521,1034,27,925,1983,4490,71,109
1294,657,35,1268,1034,4288,494,1001,74,935,1722,4226,71,110
409,769,37,1507,1174,3896,237,1000,81,1212,1356,3886,71,111
304,370,4,1057,650,2385,159,571,9,822,929,2490,71,112
1643,481,5,1136,1028,4293,741,855,16,787,2037,4436,71,113
2016,596,14,1326,1238,5190,857,1047,21,970,2464,5359,71,114
2042,619,12,1430,1179,5282,822,1112,18,1096,2407,5455,71,115
1969,581,7,1262,1201,5020,769,1083,14,912,2324,5102,71,116
1569,774,43,1293,1380,5059,736,1131,71,1022,2184,5144,71,117
425,682,17,1298,985,3407,266,888,101,1118,1129,3502,71,118
323,512,5,1168,836,2844,179,822,22,955,1186,3164,71,119
1766,469,8,1162,1026,4431,825,902,24,865,1963,4579,71,120
2062,620,8,1193,1185,5068,811,1021,12,940,2449,5233,71,121
2033,685,15,1429,1200,5362,872,995,16,1127,2469,5479,71,122
1967,748,8,1305,1218,5246,799,1110,28,1024,2288,5249,71,123
1619,874,36,1381,1356,5266,768,1145,50,1161,2202,5326,71,124
414,656,30,1456,945,3501,233,788,58,1191,1173,3443,71,125
341,409,10,978,765,2503,141,587,19,859,927,2533,71,126
1688,409,2,1157,1044,4300,759,813,8,865,2028,4473,71,127
2043,493,12,1281,1206,5035,821,994,16,995,2370,5196,71,128
2008,580,4,1636,1188,5416,834,1117,16,1165,2341,5473,71,129
2114,596,6,1349,1214,5279,751,946,19,1169,2242,5127,71,130
1538,723,34,1247,1222,4764,744,936,65,1041,1969,4755,71,131
458,570,21,1459,999,3507,260,716,64,1031,1307,3378,71,132
360,374,3,1030,667,2434,161,608,15,864,850,2498,71,133
1658,484,1,1247,1128,4518,776,875,13,930,2086,4680,71,134
2007,498,7,1329,1078,4919,790,922,9,1093,2259,5073,71,135
1903,452,7,1325,1121,4808,742,948,27,1043,2270,5030,71,136
1942,598,4,1292,1295,5131,730,1045,23,1003,2307,5108,71,137
1642,661,42,1366,1333,5044,702,992,77,1206,2052,5029,71,138
940,953,46,2912,1826,6677,455,1941,220,2008,2658,7282,71,139
695,715,6,2618,1344,5378,343,1547,35,1933,2486,6344,71,140
1720,456,3,1262,1174,4615,786,946,10,950,2081,4773,71,141
2083,591,4,1339,1237,5254,894,1067,13,993,2406,5373,71,142
1995,656,6,1453,1210,5320,809,1045,24,1145,2461,5484,71,143
1905,577,11,1307,1184,4984,762,967,20,1065,2389,5203,71,144
1530,735,42,1398,1409,5114,740,1041,82,1268,1917,5048,71,145
401,705,30,1289,1018,3443,212,890,90,1057,1122,3371,71,146
325,525,5,1163,692,2710,181,641,20,881,1038,2761,71,147
334,288,1,919,636,2178,224,572,15,853,756,2420,71,148
1881,538,9,1221,1102,4751,814,939,15,952,2259,4979,71,149
1954,529,11,1322,1076,4892,815,920,35,1060,2197,5027,71,150
1892,529,7,1252,1287,4967,772,1008,11,1010,2328,5129,71,151
1596,636,45,1323,1297,4897,763,1102,61,1102,1952,4980,71,152
441,628,19,1390,984,3462,244,859,56,1250,1082,3491,71,153
314,340,7,1011,623,2295,180,519,15,807,908,2429,71,154
1768,457,3,1213,1124,4565,758,912,12,996,2106,4784,71,155
1889,530,9,1609,1161,5198,755,985,22,1198,2260,5220,71,156
1970,527,6,1440,1040,4983,760,964,24,1133,2206,5087,71,157
1911,564,9,1273,1247,5004,708,1163,42,945,2226,5084,71,158
1591,677,48,1367,1274,4957,686,1237,89,1094,1893,4999,71,159
453,665,22,1726,1200,4066,284,1311,125,1171,1221,4112,71,160
297,388,9,1153,774,2621,149,759,27,816,946,2697,71,161
1675,412,12,1304,1088,4491,740,868,21,1054,2025,4708,71,162
2014,530,5,1331,1136,5016,714,988,20,1049,2382,5153,71,163
2041,662,15,1435,1167,5320,722,1062,33,1108,2361,5286,71,164
1859,616,9,1401,1146,5031,705,1042,21,1109,2223,5100,71,165
1543,670,31,1276,1197,4717,648,969,107,1164,1824,4712,71,166
466,641,41,1325,950,3423,287,960,84,1048,1088,3467,71,167
332,418,11,1098,693,2552,156,598,16,865,940,2575,71,168
1542,470,5,1138,1050,4205,512,859,21,1029,1962,4383,71,169
1792,569,17,1177,1015,4570,577,1082,35,1003,2045,4742,71,170
673,602,10,1419,1131,3835,338,934,26,1269,1412,3979,71,171
1659,491,3,1224,1027,4404,511,1023,12,915,1823,4284,71,172
1357,618,47,1255,1289,4566,521,1020,66,1288,1627,4522,71,173
395,657,29,1127,841,3049,206,877,96,969,922,3070,71,174
291,339,3,926,596,2155,141,639,13,758,813,2364,71,175
1531,444,4,1172,832,3983,549,868,21,946,1744,4128,71,176
1869,481,5,1240,1011,4606,584,940,19,973,2095,4611,71,177
1828,507,2,1349,983,4669,571,956,19,1085,2140,4771,71,178
1832,604,7,1339,1017,4799,626,1009,20,1066,2130,4851,71,179
1476,652,43,1335,1109,4615,597,1091,98,1111,1755,4652,71,180
451,540,34,1249,1001,3275,262,820,59,1027,1045,3213,71,181
266,356,9,979,624,2234,170,548,52,722,851,2343,71,182
1581,422,6,1240,937,4186,597,863,26,961,1753,4200,71,183
1818,517,11,1336,1005,4687,633,971,13,1120,2064,4801,71,184
1534,610,16,1255,1181,4596,611,1124,43,1184,1828,4790,71,185
308,998,17,1018,866,3207,154,1170,41,812,913,3090,71,186
940,616,25,1231,943,3755,396,882,60,999,1358,3695,71,187
426,576,42,1177,724,2945,253,806,63,911,916,2949,71,188
299,415,13,964,620,2311,176,627,30,719,877,2429,71,189
1545,414,13,1077,894,3943,567,891,20,902,1731,4111,71,190
1784,467,4,1203,925,4383,603,978,15,1004,2051,4651,71,191
1759,384,6,1337,972,4458,563,885,29,1081,2010,4568,71,192
1826,581,9,1245,1009,4670,595,1150,17,1051,2080,4893,71,193
1358,600,34,1226,941,4159,527,993,69,1078,1644,4311,71,194
402,755,32,1283,930,3402,259,959,85,1032,1074,3409,71,195
290,397,8,984,562,2241,188,619,16,733,807,2363,71,196
1581,411,10,1130,850,3982,577,753,18,967,1745,4060,71,197
1862,486,3,1154,871,4376,602,927,8,942,1904,4383,71,198
1826,478,5,1203,870,4382,591,791,18,994,2079,4473,71,199
1803,611,4,1278,1094,4790,578,1042,13,1051,2057,4741,71,200
1353,697,43,1237,1129,4459,536,1069,139,1023,1678,4445,71,201
409,581,37,1285,929,3241,252,846,63,1059,1017,3237,71,202
311,425,6,991,704,2437,169,557,9,811,905,2451,71,203
1559,368,12,1075,792,3806,525,853,20,929,1736,4063,71,204
1861,544,17,1377,970,4769,579,972,17,1081,2083,4732,71,205
1856,508,6,1317,974,4661,579,976,15,1054,2165,4789,71,206
1760,648,6,1325,1084,4823,495,1078,12,1063,2057,4705,71,207
1453,680,53,1288,1151,4625,571,1033,70,1106,1818,4598,71,208
418,660,42,1278,1050,3448,275,913,132,1081,1054,3455,71,209
307,431,4,990,690,2422,164,649,31,794,904,2542,71,210
1519,465,2,1128,939,4053,541,838,20,959,1742,4100,71,211
1800,476,5,1222,919,4422,588,905,21,948,2014,4476,71,212
1765,499,5,1169,957,4395,550,894,16,1002,1994,4456,71,213
1670,657,13,1235,1030,4605,510,1062,24,1009,1993,4598,71,214
1350,615,33,1270,1020,4288,489,946,81,978,1671,4165,71,215
490,505,55,1280,777,3107,259,721,80,964,1069,3093,71,216
330,375,4,1058,603,2370,200,576,20,783,890,2469,71,217
1390,473,3,1090,885,3841,466,896,12,966,1715,4055,71,218
1630,548,4,1160,997,4339,523,977,16,968,1980,4464,71,219
1607,470,5,1279,927,4288,496,905,19,1005,1972,4397,71,220
1497,424,3,1103,854,3881,458,805,19,864,1691,3837,71,221
1050,572,35,963,877,3497,381,847,83,830,1362,3503,71,222
437,539,26,1224,847,3073,265,856,57,977,944,3099,71,223
289,387,6,939,619,2240,157,578,18,766,831,2350,71,224
1345,411,1,1026,896,3679,482,769,7,876,1713,3847,71,225
1630,485,7,1225,977,4324,559,834,18,1018,1986,4415,71,226
1701,579,3,1282,999,4564,559,937,14,978,1995,4483,71,227
1492,571,3,1203,999,4268,499,974,16,919,1833,4241,71,228
1250,668,36,1200,1018,4172,520,953,104,1048,1602,4227,71,229
391,544,24,1205,814,2978,225,751,79,937,1051,3043,71,230
284,393,6,924,648,2255,162,502,13,746,914,2337,71,231
1392,383,3,1018,848,3644,527,772,13,830,1657,3799,71,232
1648,507,7,1192,1040,4394,608,943,12,911,2038,4512,71,233
1663,607,6,1325,1096,4697,586,925,18,1022,2107,4658,71,234
1598,540,3,1337,1140,4618,624,923,21,1102,1961,4631,71,235
1269,632,29,1233,1155,4318,563,990,72,1015,1641,4281,71,236
460,562,30,1403,939,3394,283,848,71,1007,1095,3304,71,237
310,341,6,1011,602,2270,159,566,26,778,834,2363,71,238
1664,383,8,980,1110,4145,683,762,16,813,2002,4276,71,239
1959,464,6,1091,1104,4624,723,945,18,836,2140,4662,71,240
1930,488,1,1231,1111,4761,719,879,8,996,2208,4810,71,241
1932,378,13,1193,1178,4694,778,793,14,993,2173,4751,71,242
1543,558,40,1308,1274,4723,697,893,64,1225,1810,4689,71,243
412,517,38,1231,886,3084,228,807,57,940,1054,3086,71,244
330,428,7,1007,763,2535,176,649,25,851,960,2661,71,245
224,418,13,949,662,2266,116,551,22,789,968,2446,71,246
2139,534,9,1190,1200,5072,902,942,20,998,2426,5288,71,247
2117,642,5,1379,1135,5278,892,1016,11,997,2626,5542,71,248
2195,606,3,1284,1278,5366,908,982,17,920,2530,5357,71,249
1774,741,28,1299,1341,5183,833,1109,61,1077,2191,5271,71,250
454,603,48,1419,951,3475,314,821,78,1109,1146,3468,71,251
239,374,4,1055,647,2319,131,541,8,820,898,2398,71,252
1998,471,10,1184,1106,4769,884,879,16,854,2286,4919,71,253
2365,685,10,1388,1220,5668,1018,1145,18,1004,2629,5814,71,254
2210,657,5,1348,1247,5467,887,1111,14,1051,2585,5648,71,255
2298,698,6,1380,1331,5713,979,1143,19,993,2655,5789,71,256
1661,636,40,1308,1405,5050,778,1149,74,1100,2052,5153,71,257
466,1632,43,1385,1005,4531,295,1017,72,1071,1462,3917,71,258
334,383,3,1062,675,2457,172,586,18,824,906,2506,71,259
1920,457,4,1208,1185,4774,929,863,11,937,2182,4922,71,260
2314,518,6,1353,1179,5370,915,979,22,1031,2548,5495,71,261
2087,534,8,1408,1100,5137,753,1001,20,1155,2473,5402,71,262
2115,608,8,1314,1263,5308,819,1155,21,967,2395,5357,71,263
1758,780,45,1309,1320,5212,766,1177,92,1092,2080,5207,71,264
496,623,36,1489,1130,3774,316,1039,92,1113,1195,3755,71,265
307,378,8,1083,664,2440,177,552,18,861,974,2582,71,266
1988,476,2,1157,1129,4752,919,883,11,869,2221,4903,71,267
2171,551,4,1249,1160,5135,880,1030,19,888,2571,5388,71,268
2135,701,9,1354,1193,5392,830,1091,14,1052,2664,5651,71,269
2064,595,7,1319,1422,5407,760,1047,13,1120,2554,5494,71,270
1677,659,30,1248,1281,4895,792,1105,73,1096,2112,5178,71,271
461,689,45,1426,1001,3622,273,963,143,1122,1163,3664,71,272
317,341,4,1094,574,2330,184,608,18,788,738,2336,71,273
1944,459,7,1232,1217,4859,864,859,11,931,2268,4933,71,274
2127,648,7,1221,1219,5222,892,1119,20,963,2456,5450,71,275
2200,796,4,1429,1231,5660,902,1060,18,1111,2794,5885,71,276
2015,594,4,1481,1372,5466,854,1081,29,1186,2509,5659,71,277
1716,685,37,1319,1501,5258,784,1025,68,1172,2218,5267,71,278
453,659,42,1428,912,3494,300,898,75,1098,1142,3513,71,279
321,333,5,1072,698,2429,178,572,13,816,920,2499,71,280
1980,497,3,1232,1254,4966,895,898,10,980,2320,5103,71,281
2234,644,7,1375,1315,5575,968,1018,10,1004,2644,5644,71,282
2118,687,2,1435,1294,5536,865,1082,18,1138,2553,5656,71,283
1819,549,4,1334,1306,5012,753,1135,20,1028,2078,5014,71,284
1304,819,40,1479,1346,4988,613,1075,72,1213,1933,4906,71,285
434,575,44,1379,955,3387,232,948,74,1082,1163,3499,71,286
307,396,4,1094,785,2586,153,643,19,840,943,2598,71,287
719,345,5,1067,933,3069,348,743,9,873,1300,3273,71,288
2054,553,7,1319,1347,5280,897,995,13,1032,2557,5494,71,289
2129,528,9,1479,1327,5472,933,963,16,1181,2668,5761,71,290
1991,546,3,1279,1509,5328,865,1010,10,995,2588,5468,71,291
1689,816,44,1336,1545,5430,780,1177,95,1161,2172,5385,71,292
472,821,36,1393,1218,3940,252,1080,138,1123,1436,4029,71,293
297,472,2,1159,824,2754,189,661,12,935,1036,2833,71,294
1872,498,2,1267,1195,4834,870,884,9,919,2343,5025,71,295
2218,571,8,1415,1264,5476,920,986,13,1088,2665,5672,71,296
2221,845,10,1428,1274,5778,878,1101,16,1109,2663,5767,71,297
2034,562,5,1315,1399,5315,834,1079,20,1115,2344,5392,71,298
1637,706,34,1318,972,4667,694,1043,76,1042,1523,4378,71,299
398,573,52,1328,1028,3379,269,940,93,1103,1088,3493,71,300
374,412,13,1159,825,2783,216,664,30,992,1047,2949,71,301
1868,470,2,1233,1303,4876,882,794,13,889,2333,4911,71,302
2097,523,13,1321,1563,5517,864,1250,28,1053,2477,5672,71,303
2161,649,5,1474,1372,5661,838,1061,17,1128,2706,5750,71,304
2055,743,11,1361,1553,5723,862,1176,19,1082,2681,5820,71,305
1570,844,50,1434,1402,5300,674,1091,102,1213,2133,5213,71,306
409,641,37,1497,1156,3740,312,956,77,1121,1240,3706,71,307
329,364,6,1174,757,2630,232,536,22,964,1043,2797,71,308
1719,481,3,1240,1170,4613,841,763,12,1073,2137,4826,71,309
1568,766,19,1463,1081,4897,741,885,43,1066,2182,4917,71,310
1960,505,1,1317,1236,5019,879,843,4,1112,2391,5229,71,311
2096,495,4,1310,1319,5224,883,942,9,1093,2384,5311,71,312
1689,656,43,1235,1482,5105,761,994,74,1129,2175,5133,71,313
436,610,24,1383,973,3426,248,803,83,1064,1201,3399,71,314
307,343,3,1031,693,2377,147,547,13,844,950,2501,71,315
757,350,11,1069,849,3036,306,668,11,830,1282,3097,71,316
2202,568,6,1328,1386,5490,844,1015,17,1104,2630,5610,71,317
2172,529,7,1401,1271,5380,895,957,17,1061,2639,5569,71,318
2089,475,4,1258,1286,5112,761,976,12,1012,2407,5168,71,319
1700,600,41,1243,1375,4959,780,922,69,1055,2070,4896,71,320
2,12,0,6,3,23,1,10,1,7,2,21,71,321
3,9,1,16,8,37,1,10,1,21,9,42,71,322
1756,447,9,1157,1165,4534,827,763,10,882,2215,4697,71,323
2263,494,8,1288,1229,5282,869,945,19,931,2535,5299,71,324
2221,551,4,1352,1204,5332,846,928,8,1108,2544,5434,71,325
2064,527,2,1208,1278,5079,793,958,13,977,2359,5100,71,326
1596,528,53,1110,1214,4501,773,847,67,1147,1917,4751,71,327
377,705,40,1252,911,3285,251,875,72,981,1160,3339,71,328
264,378,8,963,643,2256,138,535,39,795,893,2400,71,329
1646,488,2,1146,1122,4404,720,765,24,965,2079,4553,71,330
1658,463,4,1293,1136,4554,741,810,16,1011,2128,4706,71,331
1128,428,3,1289,1062,3910,466,653,8,1272,1396,3795,71,332
163,208,6,576,355,1308,110,286,12,457,478,1343,71,333
599,375,14,1069,708,2765,318,708,55,883,1022,2986,71,334
343,356,30,1030,792,2551,314,756,68,1175,1072,3385,71,335
282,294,4,957,596,2133,184,551,16,950,917,2618,71,336
1686,367,3,1111,1131,4298,842,841,22,1030,2222,4957,71,337
2036,460,3,1277,1254,5030,886,915,12,1110,2722,5645,71,338
2054,527,5,1376,1125,5087,817,944,21,1103,2408,5293,71,339
1898,534,6,1133,1314,4885,836,1051,23,968,2303,5181,71,340
1606,524,63,1168,1148,4509,699,981,69,1056,1893,4698,71,341
389,581,38,1361,1059,3428,233,987,94,1133,1249,3696,71,342
367,364,11,1184,860,2786,198,776,19,1064,1170,3227,71,343
1872,536,22,1236,1192,4858,970,1025,31,972,2417,5415,71,344
2294,614,2,1332,1273,5515,1045,1201,14,1100,2913,6273,71,345
1910,544,6,1440,1126,5026,712,1110,11,1267,2528,5628,71,346
2107,569,8,1387,1406,5477,892,1332,19,1264,2521,6028,71,347
1702,577,43,1366,1488,5176,813,1122,108,1351,2257,5651,71,348
427,723,54,1539,1351,4094,284,915,94,1341,1677,4311,71,349
292,356,2,1125,684,2459,190,621,18,953,954,2736,71,350
1825,482,3,1213,1197,4720,890,930,16,1016,2353,5205,71,351
2115,600,3,1435,1323,5476,1007,1174,23,1190,2523,5917,71,352
2078,699,2,1609,1261,5649,1001,1055,16,1269,2662,6003,71,353
1957,524,4,1437,1339,5261,922,1042,19,1238,2331,5552,71,354
1564,503,36,1294,1223,4620,759,1000,69,1228,1865,4921,71,355
367,358,25,1212,847,2809,272,721,56,1072,1037,3158,71,356
277,271,4,917,615,2084,175,581,19,717,763,2255,71,357
958,325,5,1205,872,3365,443,744,15,982,1491,3675,71,358
763,238,20,1009,679,2709,408,435,35,993,922,2793,71,359
103,182,9,380,350,1024,103,269,17,360,428,1177,71,360
763,346,3,944,843,2899,381,713,18,876,1266,3254,71,361
882,434,13,1154,950,3433,466,921,47,1054,1373,3861,71,362
300,416,32,920,670,2338,188,749,60,836,907,2740,71,363
278,309,8,916,587,2098,163,518,19,774,917,2391,71,364
914,430,3,1111,966,3424,425,898,13,1044,1555,3935,71,365
903,500,210,1152,795,3560,438,703,180,1129,1161,3611,71,366
123,79,2,277,150,631,29,164,9,265,247,714,72,1
806,165,2,488,472,1933,288,323,21,343,980,1955,72,2
956,162,3,535,550,2206,297,386,13,386,1128,2210,72,3
959,179,1,527,469,2135,317,325,12,405,1068,2127,72,4
645,194,8,537,567,1951,308,398,47,428,786,1967,72,5
145,153,4,407,249,958,70,249,49,287,286,941,72,6
113,127,4,484,262,990,59,226,15,315,384,999,72,7
916,141,2,555,538,2152,333,336,12,397,998,2076,72,8
1041,108,1,444,302,1896,328,265,5,379,913,1890,72,9
1186,179,2,576,531,2474,357,396,13,408,1292,2466,72,10
1067,197,5,584,603,2456,336,495,22,452,1141,2446,72,11
701,201,6,520,545,1973,283,341,43,439,807,1913,72,12
220,173,9,758,411,1571,82,364,67,357,619,1489,72,13
157,121,2,388,263,931,66,204,14,281,378,943,72,14
241,146,12,460,262,1121,139,240,19,320,367,1085,72,15
400,133,5,359,341,1238,209,261,19,287,409,1185,72,16
903,152,1,451,471,1978,284,335,22,372,930,1943,72,17
1115,153,2,523,542,2335,308,521,31,376,1110,2346,72,18
440,134,6,433,352,1365,175,270,38,299,563,1345,72,19
146,177,5,368,371,1067,74,309,46,283,343,1055,72,20
110,130,2,384,238,864,59,195,16,241,314,825,72,21
973,150,3,536,512,2174,355,304,12,423,1019,2113,72,22
1223,161,2,611,564,2561,414,408,13,381,1308,2524,72,23
1225,171,2,557,628,2583,367,475,12,405,1294,2553,72,24
1108,176,3,545,586,2418,367,447,23,404,1145,2386,72,25
739,257,7,580,611,2194,349,417,66,431,880,2143,72,26
185,192,6,724,406,1513,87,376,53,472,562,1550,72,27
162,129,9,485,250,1035,68,207,18,329,397,1019,72,28
964,168,1,609,470,2212,351,312,9,423,1027,2122,72,29
1270,174,4,608,549,2605,420,400,14,445,1326,2605,72,30
1222,189,8,549,573,2541,383,425,17,433,1255,2513,72,31
1139,174,2,572,613,2500,370,463,16,408,1179,2436,72,32
748,227,5,581,587,2148,345,383,57,524,830,2139,72,33
129,182,4,531,343,1189,70,253,51,362,383,1119,72,34
110,111,6,400,235,862,53,188,10,325,288,864,72,35
987,173,3,588,467,2218,358,345,16,467,995,2181,72,36
1260,148,6,553,641,2608,415,456,28,418,1252,2569,72,37
1261,217,2,564,606,2650,364,452,16,444,1275,2551,72,38
1151,190,3,632,518,2494,399,466,23,437,1207,2532,72,39
788,214,8,603,577,2190,323,353,54,483,917,2130,72,40
214,235,11,714,480,1654,77,450,91,458,618,1694,72,41
150,152,3,556,288,1149,64,209,34,290,518,1115,72,42
981,147,2,580,491,2201,387,351,15,392,1026,2171,72,43
1059,187,2,616,582,2446,374,472,14,395,1182,2437,72,44
1236,198,2,637,581,2654,398,402,30,484,1241,2555,72,45
1099,184,1,611,592,2487,402,425,15,460,1187,2489,72,46
755,244,17,562,573,2151,326,391,52,470,889,2128,72,47
150,169,12,548,379,1258,70,294,51,374,433,1222,72,48
158,132,9,481,322,1102,78,218,31,315,465,1107,72,49
310,169,4,598,420,1501,178,259,14,420,513,1384,72,50
1261,171,7,600,574,2613,394,454,24,458,1269,2599,72,51
1288,185,3,604,588,2668,372,440,19,441,1274,2546,72,52
1170,162,2,666,578,2578,384,433,17,456,1158,2448,72,53
758,236,2,594,533,2123,334,381,46,427,927,2115,72,54
127,130,6,467,327,1057,61,201,42,300,305,909,72,55
101,85,4,354,240,784,51,172,13,250,275,761,72,56
996,185,2,571,564,2318,382,413,20,408,1041,2264,72,57
1263,173,3,638,579,2656,440,467,16,483,1221,2627,72,58
1257,173,4,597,505,2536,346,426,26,470,1221,2489,72,59
1119,194,3,628,522,2466,398,424,27,413,1145,2407,72,60
717,242,12,619,680,2270,345,453,58,484,921,2261,72,61
154,202,5,496,359,1216,77,304,59,320,383,1143,72,62
159,141,2,594,309,1205,62,213,21,351,516,1163,72,63
983,173,2,606,549,2313,377,353,23,468,1076,2297,72,64
1275,189,2,730,575,2771,386,446,16,472,1313,2633,72,65
1253,179,14,631,630,2707,386,504,41,443,1258,2632,72,66
1133,227,3,634,600,2597,416,495,49,470,1145,2575,72,67
741,255,8,629,690,2323,349,457,67,513,945,2331,72,68
150,95,8,421,271,945,78,214,33,286,293,904,72,69
103,117,8,375,200,803,49,157,15,259,267,747,72,70
939,180,3,491,462,2075,328,357,17,375,999,2076,72,71
1297,204,4,685,570,2760,384,489,31,434,1355,2693,72,72
1269,213,2,690,559,2733,367,521,28,474,1317,2707,72,73
1161,250,3,698,612,2724,362,580,34,450,1313,2739,72,74
754,211,12,577,631,2185,319,455,82,430,859,2145,72,75
200,191,3,612,364,1370,86,303,57,352,420,1218,72,76
110,127,3,436,249,925,69,208,14,311,321,923,72,77
1030,194,1,614,530,2369,399,397,13,437,1105,2351,72,78
1290,209,4,699,589,2791,419,512,17,479,1366,2793,72,79
1307,215,4,846,726,3098,370,690,24,582,1407,3073,72,80
1227,216,2,728,595,2768,411,563,14,510,1281,2779,72,81
828,242,7,800,675,2552,342,580,62,514,1044,2542,72,82
198,187,10,597,391,1383,80,398,45,330,516,1369,72,83
276,163,5,1044,344,1832,75,414,15,485,798,1787,72,84
941,194,3,854,581,2573,387,463,36,485,1214,2585,72,85
1208,211,3,873,608,2903,421,519,15,494,1413,2862,72,86
1054,198,1,605,543,2401,336,507,22,442,1143,2450,72,87
981,200,1,743,506,2431,344,462,18,451,1146,2421,72,88
708,280,5,899,545,2437,313,509,45,541,1117,2525,72,89
256,189,14,1122,532,2113,91,535,60,521,934,2141,72,90
197,162,3,640,314,1316,83,290,14,454,522,1363,72,91
849,222,4,772,548,2395,315,512,32,439,978,2276,72,92
1234,195,4,631,533,2597,424,428,13,485,1287,2637,72,93
1186,193,4,584,544,2511,387,518,19,377,1200,2501,72,94
1226,240,6,737,631,2840,410,578,24,504,1274,2790,72,95
851,264,21,703,625,2464,355,474,55,495,966,2345,72,96
231,220,7,687,402,1547,90,393,45,446,578,1552,72,97
256,150,4,624,382,1416,103,380,17,439,473,1412,72,98
968,194,5,624,489,2280,376,384,22,454,1028,2264,72,99
1242,235,4,660,598,2739,418,466,52,475,1362,2773,72,100
1220,238,6,667,557,2688,368,498,29,508,1316,2719,72,101
1245,202,4,594,553,2598,392,513,18,490,1168,2581,72,102
815,298,8,694,633,2448,367,548,58,518,940,2431,72,103
227,244,13,776,553,1813,141,530,79,498,618,1866,72,104
206,157,8,707,346,1424,93,284,28,450,544,1399,72,105
1078,231,3,630,614,2556,389,465,18,506,1125,2503,72,106
1375,226,3,670,560,2834,428,507,25,531,1392,2883,72,107
1370,235,4,643,568,2820,394,539,26,457,1337,2753,72,108
1296,249,2,665,631,2843,400,544,32,536,1311,2823,72,109
851,255,9,672,608,2395,342,482,58,550,974,2406,72,110
254,217,5,896,519,1891,109,586,89,478,656,1918,72,111
183,149,1,522,333,1188,63,267,19,405,432,1186,72,112
1009,213,3,619,544,2388,347,390,12,467,1117,2333,72,113
1317,215,1,680,667,2880,417,541,22,467,1302,2749,72,114
1288,274,6,641,664,2873,395,532,27,489,1323,2766,72,115
1379,232,12,697,614,2934,404,573,34,528,1347,2886,72,116
857,257,9,626,725,2474,359,567,76,509,982,2493,72,117
244,245,12,563,447,1511,104,402,91,406,439,1442,72,118
164,199,10,613,386,1372,67,347,38,388,505,1345,72,119
1043,185,1,579,514,2322,376,391,16,457,1064,2304,72,120
1341,208,4,667,568,2788,426,488,12,464,1347,2737,72,121
1279,230,2,675,573,2759,376,510,25,468,1374,2753,72,122
1259,248,4,648,575,2734,394,493,26,498,1257,2668,72,123
815,252,11,669,641,2388,347,503,56,463,977,2346,72,124
239,197,8,632,399,1475,86,420,57,384,514,1461,72,125
150,137,4,512,306,1109,64,276,18,383,373,1114,72,126
1039,216,4,596,523,2378,381,386,16,469,1118,2370,72,127
1265,187,3,663,642,2760,377,538,29,481,1274,2699,72,128
1319,261,7,699,643,2929,383,618,41,522,1294,2858,72,129
1157,272,5,602,616,2652,369,537,21,472,1224,2623,72,130
798,215,22,554,557,2146,341,416,55,460,872,2144,72,131
233,190,8,656,393,1480,89,351,48,429,559,1476,72,132
156,151,7,439,255,1008,51,233,29,353,371,1037,72,133
1061,215,3,572,551,2402,385,362,21,451,1170,2389,72,134
1299,195,2,619,546,2661,400,451,24,451,1308,2634,72,135
1275,204,2,622,572,2675,362,471,41,436,1320,2630,72,136
1210,228,5,709,610,2762,379,533,36,497,1313,2758,72,137
883,235,8,632,615,2373,326,479,53,538,966,2362,72,138
204,257,7,588,377,1433,93,438,77,416,499,1523,72,139
203,149,4,630,323,1309,66,305,24,458,477,1330,72,140
1009,225,5,622,545,2406,413,430,20,412,1188,2463,72,141
1382,207,3,630,657,2879,408,551,27,461,1442,2889,72,142
1322,257,5,674,617,2875,396,507,30,503,1426,2862,72,143
1183,203,5,604,566,2561,352,488,26,465,1259,2590,72,144
770,258,22,654,649,2353,345,503,105,583,837,2373,72,145
219,246,14,665,439,1583,102,465,81,454,525,1627,72,146
179,232,2,634,365,1412,60,364,39,422,546,1431,72,147
155,132,4,517,302,1110,78,241,18,373,430,1140,72,148
1265,228,3,694,579,2769,405,495,29,529,1285,2743,72,149
1326,232,5,737,538,2838,392,468,20,548,1364,2792,72,150
1255,241,2,667,620,2785,367,517,23,471,1332,2710,72,151
937,286,9,675,634,2541,390,503,68,544,1072,2577,72,152
250,274,9,751,433,1717,100,479,93,468,542,1682,72,153
178,179,6,576,393,1332,72,290,12,476,516,1366,72,154
1193,224,2,656,622,2697,413,498,19,476,1297,2703,72,155
1552,239,11,717,666,3185,480,622,31,503,1577,3213,72,156
1478,226,2,690,624,3020,386,583,18,532,1567,3086,72,157
1451,247,4,710,712,3124,410,652,30,558,1439,3089,72,158
1008,343,8,714,792,2865,340,694,108,584,1160,2886,72,159
304,276,12,1190,648,2430,134,849,106,558,774,2421,72,160
194,189,10,773,380,1546,77,484,32,455,596,1644,72,161
1325,205,1,670,566,2767,393,413,8,493,1317,2624,72,162
1568,218,2,673,667,3128,461,589,15,499,1611,3175,72,163
1531,275,5,709,721,3241,398,639,46,527,1541,3151,72,164
1418,239,2,738,678,3075,443,647,17,555,1426,3088,72,165
961,289,11,700,799,2760,338,557,44,516,1106,2561,72,166
235,293,22,786,518,1854,109,576,65,479,642,1871,72,167
185,204,20,629,379,1417,80,298,35,485,563,1461,72,168
1228,289,3,652,562,2734,431,460,17,537,1251,2696,72,169
1441,235,9,687,693,3065,380,605,32,553,1442,3012,72,170
499,218,11,741,491,1960,224,522,26,557,652,1981,72,171
1353,359,5,807,695,3219,2803,672,29,535,1467,5506,72,172
934,344,16,741,656,2691,333,531,86,555,980,2485,72,173
262,254,4,666,551,1737,123,565,87,426,458,1659,72,174
175,187,6,491,360,1219,50,263,39,425,473,1250,72,175
1172,269,12,689,600,2742,424,481,34,467,1270,2676,72,176
1499,250,8,709,600,3066,418,548,21,547,1527,3061,72,177
1517,252,8,661,600,3038,433,592,28,544,1510,3107,72,178
1394,273,0,775,691,3133,419,607,31,550,1499,3106,72,179
956,319,8,742,614,2639,365,543,68,565,1227,2768,72,180
246,297,7,792,505,1847,134,531,85,563,567,1880,72,181
185,213,10,550,327,1285,92,325,33,374,470,1294,72,182
1163,251,3,732,670,2819,399,530,29,502,1384,2844,72,183
1378,233,3,723,675,3012,415,565,37,608,1461,3086,72,184
1148,259,4,726,779,2916,409,591,36,644,1177,2857,72,185
265,654,12,775,792,2498,66,1286,116,493,558,2519,72,186
582,274,10,586,501,1953,258,424,61,502,699,1944,72,187
211,215,11,574,370,1381,88,415,57,370,441,1371,72,188
173,185,6,588,317,1269,85,306,8,353,511,1263,72,189
1141,224,2,662,559,2588,397,506,10,491,1155,2559,72,190
1384,236,0,677,617,2914,429,552,24,458,1447,2910,72,191
1342,223,6,614,628,2813,414,497,17,487,1394,2809,72,192
1239,277,8,781,638,2943,434,619,26,517,1341,2937,72,193
876,241,11,639,692,2459,367,519,55,482,999,2422,72,194
261,309,9,734,568,1881,98,580,79,460,555,1772,72,195
215,162,6,578,314,1275,95,314,30,420,468,1327,72,196
1186,237,15,674,518,2630,413,428,32,465,1204,2542,72,197
1425,221,5,666,581,2898,440,516,24,518,1420,2918,72,198
1438,238,13,705,543,2937,411,486,19,540,1496,2952,72,199
1332,316,3,707,621,2979,415,577,19,491,1394,2896,72,200
891,272,13,682,710,2568,340,493,131,553,994,2511,72,201
217,249,12,676,499,1653,96,529,88,441,527,1681,72,202
187,174,16,641,328,1346,83,382,24,406,470,1365,72,203
1131,206,4,539,609,2489,368,496,17,408,1164,2453,72,204
1455,201,4,704,643,3007,457,547,14,479,1489,2986,72,205
1357,198,5,709,709,2978,405,600,35,544,1364,2948,72,206
1288,221,2,680,592,2783,382,547,15,486,1321,2751,72,207
858,233,12,610,596,2309,338,444,90,497,1022,2391,72,208
264,243,6,720,443,1676,122,470,85,465,583,1725,72,209
198,157,5,609,313,1282,88,278,36,371,486,1259,72,210
1094,176,2,602,641,2515,382,458,80,436,1144,2500,72,211
1424,150,2,649,611,2836,429,507,13,471,1408,2828,72,212
1393,180,2,579,560,2714,436,464,13,468,1341,2722,72,213
1308,200,3,647,569,2727,402,490,33,469,1311,2705,72,214
909,233,11,620,669,2442,327,610,99,483,883,2402,72,215
274,209,4,749,358,1594,103,520,80,444,510,1657,72,216
178,134,3,620,286,1221,87,287,10,404,576,1364,72,217
1035,169,2,609,483,2298,362,394,16,410,1083,2265,72,218
1374,190,8,633,578,2783,381,508,19,439,1364,2711,72,219
1317,184,2,623,566,2692,350,526,20,497,1304,2697,72,220
1143,154,2,580,506,2385,349,375,20,418,1164,2326,72,221
686,210,12,488,527,1923,269,392,66,366,772,1865,72,222
221,269,13,609,484,1596,90,409,58,422,546,1525,72,223
187,160,4,585,277,1213,75,336,19,389,471,1290,72,224
1064,183,3,654,490,2394,335,385,17,488,1085,2310,72,225
1319,205,11,655,540,2730,391,492,21,490,1324,2718,72,226
1316,194,14,606,566,2696,384,484,35,475,1314,2692,72,227
1200,209,6,605,540,2560,374,494,30,450,1195,2543,72,228
800,230,7,564,579,2180,314,438,65,486,821,2124,72,229
230,229,8,613,342,1422,101,339,75,384,526,1425,72,230
162,138,2,493,271,1066,72,225,20,370,444,1131,72,231
1021,129,2,595,499,2246,330,397,17,453,1042,2239,72,232
1293,173,1,597,580,2644,376,541,30,456,1341,2744,72,233
1328,223,10,662,590,2813,388,572,42,516,1334,2852,72,234
1145,195,12,668,548,2568,369,502,39,464,1251,2625,72,235
798,225,8,666,596,2293,310,500,71,471,952,2304,72,236
297,282,7,672,442,1700,91,467,70,448,575,1651,72,237
170,141,5,603,299,1218,74,302,31,392,472,1271,72,238
1076,144,5,509,559,2293,345,478,16,423,1087,2349,72,239
1423,172,2,612,623,2832,415,599,20,440,1439,2913,72,240
1416,169,1,544,571,2701,377,558,19,446,1362,2762,72,241
1227,178,2,611,567,2585,373,458,29,430,1265,2555,72,242
695,208,7,564,659,2133,324,436,62,541,820,2183,72,243
253,216,5,870,395,1739,88,510,56,428,630,1712,72,244
147,164,5,634,314,1264,65,287,33,405,475,1265,72,245
180,156,5,454,220,1015,88,240,10,338,428,1104,72,246
1331,186,1,658,546,2722,448,467,12,473,1309,2709,72,247
1343,200,1,599,569,2712,447,425,16,475,1377,2740,72,248
1222,213,2,624,551,2612,403,449,12,454,1282,2600,72,249
794,231,5,565,581,2176,362,380,59,487,968,2256,72,250
247,209,8,648,460,1572,93,403,116,395,519,1526,72,251
164,145,4,517,300,1130,69,276,21,386,486,1238,72,252
1113,165,3,629,576,2486,452,433,30,482,1159,2556,72,253
1423,159,3,643,595,2823,472,496,29,447,1385,2829,72,254
1396,192,3,642,684,2917,419,521,27,479,1429,2875,72,255
1215,214,4,627,650,2710,402,641,21,432,1284,2780,72,256
816,326,12,642,651,2447,363,491,69,545,976,2444,72,257
179,149,1,612,394,1335,81,364,76,337,382,1240,72,258
148,91,3,523,236,1001,56,172,17,293,414,952,72,259
1133,154,3,554,556,2400,420,393,26,444,1147,2430,72,260
1459,156,5,623,561,2804,443,452,28,499,1425,2847,72,261
1499,182,1,596,577,2855,417,500,16,462,1326,2721,72,262
1289,194,2,641,667,2793,414,572,37,469,1310,2802,72,263
824,294,18,647,611,2394,372,435,92,526,1014,2439,72,264
235,214,7,814,594,1864,116,438,128,652,501,1835,72,265
155,163,3,474,320,1115,60,252,15,330,478,1135,72,266
1132,145,2,623,528,2430,388,343,27,481,1173,2412,72,267
1439,178,1,595,625,2838,444,501,29,489,1424,2887,72,268
1324,202,2,574,590,2692,426,538,14,452,1357,2787,72,269
1399,182,3,724,530,2838,571,499,29,463,1280,2842,72,270
806,194,11,613,616,2240,326,488,85,455,948,2302,72,271
230,242,7,885,653,2017,106,605,93,649,572,2025,72,272
141,138,3,598,255,1135,77,285,19,298,455,1134,72,273
1027,133,2,542,502,2206,379,412,28,462,1049,2330,72,274
1366,161,17,585,539,2668,441,439,45,455,1363,2743,72,275
1336,178,2,676,627,2819,448,510,22,543,1387,2910,72,276
1172,189,7,642,539,2549,380,463,32,487,1187,2549,72,277
859,229,8,613,552,2261,383,427,64,464,945,2283,72,278
223,218,3,691,488,1623,99,428,70,408,614,1619,72,279
175,148,7,528,295,1153,74,300,18,380,470,1242,72,280
1098,156,4,616,502,2376,403,377,17,465,1095,2357,72,281
1465,162,3,665,594,2889,485,490,15,504,1436,2930,72,282
1406,222,3,611,584,2826,439,461,23,497,1373,2793,72,283
1253,209,3,649,626,2740,434,528,18,464,1280,2724,72,284
755,224,8,644,558,2189,327,433,67,543,976,2346,72,285
18,6,0,13,17,54,12,6,1,14,16,49,72,286
8,5,1,18,4,36,8,4,2,17,5,36,72,287
1,0,1,0,0,2,0,0,2,0,0,2,72,288
1412,182,1,628,603,2826,435,469,16,452,1433,2805,72,289
1359,191,3,663,583,2799,413,478,32,563,1460,2946,72,290
1224,223,3,665,669,2784,421,627,19,475,1265,2807,72,291
833,224,14,700,640,2411,326,496,63,495,1020,2400,72,292
202,195,16,701,558,1672,90,454,94,490,559,1687,72,293
139,150,15,568,361,1233,63,354,28,382,463,1290,72,294
1087,154,1,639,510,2391,400,388,16,429,1120,2353,72,295
1454,177,3,586,544,2764,421,464,18,454,1486,2843,72,296
1378,195,2,687,673,2935,456,534,24,527,1455,2996,72,297
1300,246,3,640,694,2883,457,580,19,542,1348,2946,72,298
926,246,7,615,594,2388,330,393,66,545,973,2307,72,299
254,236,7,705,518,1720,110,398,105,513,514,1640,72,300
246,151,6,535,369,1307,82,282,38,444,511,1357,72,301
1063,160,2,646,538,2409,418,413,20,454,1143,2448,72,302
1353,194,5,751,799,3102,468,746,32,525,1354,3125,72,303
1385,222,6,700,634,2947,462,551,21,576,1405,3015,72,304
1163,250,7,607,607,2634,440,452,44,486,1286,2708,72,305
822,263,13,632,550,2280,386,427,62,476,974,2325,72,306
240,228,20,712,481,1681,90,484,72,465,533,1644,72,307
167,132,6,508,336,1149,83,281,22,411,428,1225,72,308
1101,153,10,595,548,2407,398,428,22,460,1153,2461,72,309
1023,188,5,558,483,2257,316,316,26,472,1153,2283,72,310
1162,175,4,579,593,2513,410,398,22,454,1244,2528,72,311
1246,177,1,599,589,2612,381,407,11,452,1306,2557,72,312
918,244,13,639,689,2503,347,435,80,611,971,2444,72,313
236,152,8,512,334,1242,106,233,46,368,366,1119,72,314
146,107,5,384,210,852,61,193,27,295,306,882,72,315
468,116,6,471,335,1396,239,226,18,308,544,1335,72,316
1388,168,5,666,550,2777,452,421,30,477,1504,2884,72,317
1444,173,8,627,618,2870,398,530,24,500,1434,2886,72,318
1253,157,3,614,552,2579,392,436,17,495,1301,2641,72,319
840,232,10,623,593,2298,366,382,70,472,1061,2351,72,320
250,200,9,687,418,1564,124,361,69,505,586,1645,72,321
151,139,6,519,386,1201,61,289,18,386,472,1226,72,322
1159,151,3,628,510,2451,389,380,17,528,1230,2544,72,323
1449,168,1,625,530,2773,443,418,24,458,1433,2776,72,324
1396,163,2,672,596,2829,436,497,18,535,1379,2865,72,325
1263,173,4,626,662,2728,384,546,24,466,1288,2708,72,326
813,164,15,613,583,2188,363,395,51,432,958,2199,72,327
214,237,8,595,478,1532,107,400,95,428,527,1557,72,328
133,140,7,559,338,1177,65,240,19,379,479,1182,72,329
960,143,7,666,459,2235,388,345,30,460,1105,2328,72,330
1014,200,3,624,611,2452,378,489,17,476,1231,2591,72,331
705,176,2,660,537,2080,296,425,23,632,839,2215,72,332
78,136,1,225,132,572,38,104,4,294,287,727,72,333
320,150,6,668,354,1498,132,335,30,420,612,1529,72,334
152,155,3,584,388,1282,85,328,50,351,490,1304,72,335
130,120,4,470,311,1035,58,235,11,294,431,1029,72,336
1054,120,4,536,447,2161,370,312,15,381,1083,2161,72,337
1437,163,3,602,584,2789,436,508,18,474,1427,2863,72,338
1344,159,9,641,568,2721,401,494,20,515,1352,2782,72,339
1214,172,2,546,619,2553,373,473,14,434,1210,2504,72,340
818,215,7,551,518,2109,307,379,55,460,933,2134,72,341
190,210,16,609,558,1583,83,508,58,381,497,1527,72,342
133,132,2,597,343,1207,58,274,31,376,474,1213,72,343
1075,145,4,499,479,2202,363,384,20,369,1108,2244,72,344
1431,187,4,628,513,2763,430,544,10,449,1457,2890,72,345
1366,151,12,539,503,2571,410,475,24,444,1283,2636,72,346
1307,173,3,661,668,2812,389,561,31,478,1371,2830,72,347
808,198,5,561,583,2155,328,433,59,449,928,2197,72,348
199,225,13,668,561,1666,86,440,82,421,640,1669,72,349
140,114,3,472,316,1045,54,263,17,354,440,1128,72,350
971,153,4,484,456,2068,355,322,12,382,1099,2170,72,351
1310,171,1,627,668,2777,432,489,74,443,1414,2852,72,352
1237,173,1,610,542,2563,388,442,37,471,1305,2643,72,353
1043,176,2,653,591,2465,343,520,27,397,1155,2442,72,354
674,193,11,524,655,2057,280,481,54,453,841,2109,72,355
194,193,4,543,416,1350,70,389,50,363,431,1303,72,356
130,102,1,493,331,1057,58,320,11,289,408,1086,72,357
516,129,4,555,506,1710,239,343,16,437,730,1765,72,358
259,117,3,404,212,995,142,153,9,327,400,1031,72,359
34,65,3,167,118,387,19,94,11,195,140,459,72,360
400,120,2,595,395,1512,179,327,10,379,631,1526,72,361
416,212,8,587,391,1614,215,343,36,384,659,1637,72,362
138,189,4,516,311,1158,60,369,53,293,391,1166,72,363
132,118,4,552,269,1075,50,231,21,293,475,1070,72,364
533,164,4,702,445,1848,205,401,11,415,849,1881,72,365
474,307,79,604,450,1914,218,285,209,460,666,1838,72,366
340,1603,14,1734,1508,5199,418,216,11,1271,600,2516,73,1
538,1546,16,1974,1551,5625,944,239,11,1354,724,3272,73,2
547,1408,8,2065,1855,5883,948,218,9,1422,800,3397,73,3
542,1168,10,1769,1602,5091,985,281,7,1469,860,3602,73,4
427,1284,28,1499,1548,4786,949,252,15,1455,1092,3763,73,5
341,1252,44,1532,1321,4490,448,157,29,1241,426,2301,73,6
364,1667,32,1848,1583,5494,393,261,30,1416,750,2850,73,7
623,1342,12,1822,1686,5485,1089,274,13,1395,738,3509,73,8
522,1048,16,1306,1129,4021,863,251,15,1263,676,3068,73,9
459,1131,46,1444,1464,4544,1061,324,40,2052,1540,5017,73,10
452,1289,11,1507,1529,4788,1371,482,14,2400,1934,6201,73,11
543,1304,59,1743,1448,5097,1307,393,20,1891,1442,5053,73,12
341,974,46,1536,1076,3973,554,209,17,1430,695,2905,73,13
213,1289,19,1315,1417,4253,387,230,23,1295,710,2645,73,14
360,1743,46,1481,1438,5068,732,282,26,1462,757,3259,73,15
492,1165,45,1399,1190,4291,991,268,36,1325,538,3158,73,16
615,1364,14,2100,1902,5995,898,269,16,1446,908,3537,73,17
531,1309,20,1939,1777,5576,947,402,25,1566,1518,4458,73,18
303,1227,69,1223,1084,3906,1034,348,26,1731,1161,4300,73,19
255,816,22,983,946,3022,690,248,15,1739,773,3465,73,20
193,1474,17,1231,1478,4393,582,244,15,1713,1014,3568,73,21
567,1359,12,1722,1549,5209,1052,221,12,1393,684,3362,73,22
523,1037,41,1257,1407,4265,826,237,37,1326,726,3152,73,23
449,1067,19,1171,1150,3856,879,313,22,1492,1165,3871,73,24
446,809,23,1189,1333,3800,1114,416,23,1731,1607,4891,73,25
528,1203,28,1545,1527,4831,1372,415,39,2174,1468,5468,73,26
256,812,55,1109,1020,3252,371,206,13,1301,465,2356,73,27
276,1476,31,1463,1397,4643,346,249,30,1353,690,2668,73,28
664,1337,33,1734,1553,5321,974,241,19,1346,705,3285,73,29
564,992,26,1383,1332,4297,836,258,20,1285,887,3286,73,30
495,996,22,1186,1118,3817,884,280,22,1554,1255,3995,73,31
370,1092,17,1445,1356,4280,1077,421,10,1811,1609,4928,73,32
455,1113,21,1574,1315,4478,1304,358,9,2015,1541,5227,73,33
220,808,30,990,947,2995,450,163,20,1200,528,2361,73,34
224,1638,14,1519,1594,4989,350,236,12,1346,818,2762,73,35
703,1405,14,1833,1570,5525,1056,222,8,1463,782,3531,73,36
588,1089,11,1303,1542,4533,872,245,8,1326,914,3365,73,37
457,1039,9,1306,1212,4023,981,297,7,1631,1262,4178,73,38
430,1162,5,1396,1380,4373,1137,407,16,1964,1669,5193,73,39
543,1190,29,1687,1541,4990,1412,374,13,2229,1749,5777,73,40
303,911,29,1137,981,3361,510,174,20,1275,495,2474,73,41
297,1540,14,1493,1683,5027,403,296,12,1467,817,2995,73,42
700,1500,7,1857,1569,5633,1079,240,4,1538,787,3648,73,43
419,1107,16,1237,1174,3953,800,259,17,1313,904,3293,73,44
449,1042,10,1457,1414,4372,940,308,12,1718,1327,4305,73,45
553,1315,25,1820,1681,5394,1251,471,23,1913,1826,5484,73,46
628,1372,73,1956,1842,5871,1425,519,27,2340,2073,6384,73,47
267,912,28,1340,1025,3572,567,196,16,1594,549,2922,73,48
227,1629,15,1301,1348,4520,464,326,9,1576,1142,3517,73,49
524,1986,12,1945,2002,6469,955,322,6,1825,1198,4306,73,50
869,1498,15,1921,1686,5989,1207,237,8,1608,1008,4068,73,51
538,1181,36,1645,1557,4957,1021,325,32,1716,1197,4291,73,52
511,1249,9,1627,1603,4999,1195,416,10,1831,1581,5033,73,53
562,1203,41,1775,1638,5219,1382,335,19,2121,1491,5348,73,54
317,1020,29,1223,1115,3704,498,175,15,1338,556,2582,73,55
352,1583,13,1748,1673,5369,456,257,13,1474,957,3157,73,56
737,1504,23,1877,1792,5933,1263,297,16,1755,1013,4344,73,57
614,1157,27,1573,1529,4900,1039,278,14,1475,1022,3828,73,58
473,1121,11,1498,1401,4504,1073,399,14,1695,1492,4673,73,59
489,1237,18,1614,1659,5017,1322,475,19,1985,1614,5415,73,60
618,1420,43,1863,1750,5694,1395,467,18,2190,1667,5737,73,61
313,1122,16,1288,1150,3889,503,198,10,1462,718,2891,73,62
400,1536,55,1967,1544,5502,486,328,50,1686,1016,3566,73,63
865,1599,40,1876,1821,6201,1172,264,28,1743,942,4149,73,64
716,1202,42,1666,1649,5275,952,279,31,1441,1047,3750,73,65
574,1335,54,1574,1699,5236,1076,416,32,1953,1481,4958,73,66
586,1458,28,1906,1875,5853,1297,588,19,2069,1974,5947,73,67
699,1520,76,2076,1930,6301,1765,577,20,2673,1994,7029,73,68
365,1126,56,1519,1362,4428,698,281,17,1829,879,3704,73,69
457,1790,20,1817,1668,5752,481,377,18,1676,990,3542,73,70
899,1764,66,2434,1928,7091,1283,319,33,1898,1046,4579,73,71
728,1464,15,2190,2114,6511,1173,379,12,1873,1326,4763,73,72
654,1457,4,2267,2140,6522,1377,440,7,2257,1823,5904,73,73
594,1494,32,2299,1935,6354,1455,579,40,2343,2004,6421,73,74
701,1540,87,2271,1986,6585,1693,443,39,2614,1898,6687,73,75
468,1747,65,1958,1664,5902,867,289,12,2211,1093,4472,73,76
631,2248,22,2318,1895,7114,768,397,12,2239,1221,4637,73,77
964,1774,41,2499,2030,7308,1472,377,15,2205,1395,5464,73,78
813,1358,29,2053,1742,5995,1144,347,35,2082,1436,5044,73,79
636,1453,16,2053,2088,6246,1335,489,17,2401,2039,6281,73,80
787,1517,55,2378,2150,6887,1444,656,57,2428,1905,6490,73,81
740,1412,58,2478,1889,6577,1540,542,17,2397,1759,6255,73,82
424,1305,35,1797,1218,4779,484,338,19,1654,878,3373,73,83
423,2050,52,2140,1836,6501,501,529,44,1960,1525,4559,73,84
786,1512,35,2229,1672,6234,1310,447,30,2482,1561,5830,73,85
728,1421,17,2160,1733,6059,1223,513,19,2387,1626,5768,73,86
666,1292,12,1963,1808,5741,1332,519,9,2266,1583,5709,73,87
811,1459,31,2058,1695,6054,1423,603,24,2319,1784,6153,73,88
840,1365,62,2306,1737,6310,1502,503,17,2448,1758,6228,73,89
455,916,38,1582,1016,4007,709,233,17,1977,1038,3974,73,90
435,1788,9,1825,1735,5792,654,461,10,1896,1139,4160,73,91
982,1702,9,2183,1864,6740,1252,355,5,2079,1265,4956,73,92
828,1543,10,2211,1564,6156,1223,352,6,2026,1114,4721,73,93
612,1345,7,1714,1607,5285,1172,430,7,1730,1317,4656,73,94
667,1464,8,1966,1791,5896,1468,631,8,2231,2134,6472,73,95
747,1365,35,2015,1811,5973,1564,559,16,2616,1910,6665,73,96
392,1090,21,1666,1111,4280,852,238,19,2120,914,4143,73,97
437,1764,44,1918,1525,5688,980,381,36,2157,1435,4989,73,98
750,1774,10,1962,1814,6310,1455,317,12,2070,1301,5155,73,99
945,1757,15,2359,1956,7032,1083,321,6,1856,1270,4536,73,100
649,1634,15,1961,1784,6043,1148,453,8,2081,1632,5322,73,101
647,1446,18,1932,1730,5773,1301,478,8,2171,1664,5622,73,102
634,1554,23,2051,1709,5971,1614,508,17,2461,1732,6332,73,103
421,1252,30,1650,1349,4702,749,284,17,1944,860,3854,73,104
502,1966,11,2022,1892,6393,575,378,11,1919,1286,4169,73,105
829,1762,23,2018,1559,6191,1370,344,22,2035,1170,4941,73,106
834,1473,43,1695,1780,5825,1356,360,34,1875,1312,4937,73,107
592,1425,17,1877,1644,5555,1291,375,13,2031,1508,5218,73,108
602,1488,17,1841,1757,5705,1375,552,9,2096,1811,5843,73,109
690,1471,19,2019,1600,5799,1565,473,15,2359,1751,6163,73,110
387,1303,31,1556,1240,4517,628,261,18,1819,804,3530,73,111
412,1860,22,1728,1491,5513,537,427,15,1924,1053,3956,73,112
851,1608,17,2047,1840,6363,1317,383,12,2019,1225,4956,73,113
731,1459,41,1778,1821,5830,1184,329,34,1799,1049,4395,73,114
565,1526,12,1825,1581,5509,1193,449,9,2038,1437,5126,73,115
638,1442,18,1774,1708,5580,1277,556,21,2174,1825,5853,73,116
713,1423,39,1961,1724,5860,1437,468,20,2313,1739,5977,73,117
369,1152,33,1306,1272,4132,672,214,19,1681,736,3322,73,118
468,1916,11,1793,1796,5984,540,378,12,1770,1086,3786,73,119
782,1846,14,1991,1753,6386,1407,291,6,2036,1117,4857,73,120
718,1378,12,1734,1718,5560,1199,340,9,1810,1262,4620,73,121
601,1316,6,1679,1673,5275,1226,412,2,2014,1563,5217,73,122
590,1330,8,1736,1582,5246,1376,535,11,2100,1766,5788,73,123
630,1465,27,1940,1629,5691,1541,503,11,2373,1871,6299,73,124
323,1180,27,1478,1206,4214,665,246,19,1832,770,3532,73,125
248,1871,17,1932,1627,5695,486,365,12,1586,957,3406,73,126
801,1871,26,1990,1778,6466,1314,308,19,1991,1118,4750,73,127
853,1519,12,1866,1596,5846,1279,397,7,1858,1274,4815,73,128
662,1433,16,1820,1643,5574,1377,513,9,1938,1675,5512,73,129
593,1394,18,1783,1679,5467,1458,636,17,2113,1786,6010,73,130
705,1566,57,1887,1772,5987,1628,510,14,2462,1695,6309,73,131
421,1342,26,1450,1568,4807,805,243,16,1976,873,3913,73,132
441,2071,10,1899,2080,6501,569,355,7,1649,1043,3623,73,133
930,1737,12,2191,1959,6829,1356,328,7,2022,1033,4746,73,134
863,1555,23,1868,1763,6072,1294,365,7,1974,1217,4857,73,135
721,1608,9,1812,1638,5788,1292,504,7,2148,1693,5644,73,136
800,1598,13,1960,1796,6167,1454,627,6,2564,1931,6582,73,137
717,1635,36,2252,1880,6520,1559,546,17,2480,1880,6482,73,138
374,1378,52,1673,1391,4868,720,224,18,1766,808,3536,73,139
520,1850,13,2074,1844,6301,560,429,10,1780,1049,3828,73,140
900,1832,11,2030,1983,6756,1441,453,4,2260,1325,5483,73,141
815,1421,15,2027,1908,6186,1385,431,8,2216,1448,5488,73,142
593,1516,15,1799,1592,5515,1460,440,12,2411,1738,6061,73,143
563,1567,8,1904,1643,5685,1656,603,10,2231,1903,6403,73,144
696,1811,44,2013,1820,6384,1738,611,20,2508,2103,6980,73,145
474,1349,33,1839,1428,5123,870,271,22,2014,780,3957,73,146
428,1607,8,1861,1404,5308,601,281,9,1888,967,3746,73,147
612,1953,23,2347,2192,7127,643,335,13,2154,1122,4267,73,148
1053,1943,21,2238,1854,7109,1473,346,17,2182,1186,5204,73,149
722,1901,18,1743,1737,6121,1202,384,14,1960,1162,4722,73,150
521,1633,10,1867,1661,5692,1466,515,4,2093,1597,5675,73,151
666,1725,20,1953,1768,6132,1545,480,13,2335,1836,6209,73,152
362,1312,22,1609,1502,4807,740,256,8,1752,778,3534,73,153
588,1931,15,1974,1674,6182,556,298,12,1748,976,3590,73,154
768,1848,27,2257,1943,6843,1308,308,17,1882,1094,4609,73,155
728,1615,14,2118,1772,6247,1188,361,10,1904,1163,4626,73,156
604,1582,7,1916,1899,6008,1345,406,4,2026,1406,5187,73,157
688,1440,10,1950,1786,5874,1342,520,11,2108,1735,5716,73,158
629,1737,18,2231,1821,6436,1463,550,16,2400,1911,6340,73,159
486,1339,29,1879,1614,5347,731,327,13,2131,1193,4395,73,160
472,1965,10,2117,1958,6522,642,330,5,2008,1277,4262,73,161
1012,1921,11,2038,1902,6884,1400,329,12,2240,1282,5263,73,162
836,1413,5,2020,1876,6150,1362,404,3,1989,1482,5240,73,163
714,1510,7,1833,1725,5789,1503,507,11,2189,1608,5818,73,164
661,1399,7,1800,1559,5426,1538,563,4,2464,1906,6475,73,165
682,1553,25,2040,1716,6016,1731,515,23,2577,1978,6824,73,166
458,1245,29,1639,1311,4682,899,281,17,2186,902,4285,73,167
547,2074,9,2167,1923,6720,660,300,7,1848,1030,3845,73,168
788,1646,9,2061,1692,6196,1237,352,9,1857,1001,4456,73,169
678,1417,21,1845,1462,5423,1348,457,15,2168,1742,5730,73,170
534,1637,15,1792,1740,5718,1507,370,20,2225,1205,5327,73,171
593,1269,13,1628,1649,5152,1446,485,9,2032,1477,5449,73,172
616,1359,37,2065,1663,5740,1512,429,14,2238,1606,5799,73,173
431,1443,51,1488,1286,4699,719,213,18,1804,785,3539,73,174
459,2119,24,1923,1596,6121,599,372,13,1717,981,3682,73,175
827,1983,14,2268,1889,6981,1471,375,16,2009,1049,4920,73,176
879,1683,14,1987,1870,6433,1520,352,13,2016,1272,5173,73,177
655,1244,11,2035,1820,5765,1291,409,15,1970,1552,5237,73,178
658,1593,14,2201,2058,6524,1597,582,9,2301,1929,6418,73,179
629,1497,28,2025,1804,5983,1619,500,15,2500,1926,6560,73,180
396,1261,14,1398,1298,4367,770,227,15,1902,820,3734,73,181
403,1801,49,1806,1622,5681,622,369,53,1871,959,3874,73,182
826,1677,29,2053,2032,6617,1331,349,20,2358,1409,5467,73,183
633,1574,11,2006,1836,6060,1519,491,15,2296,1801,6122,73,184
573,1839,8,2151,2113,6684,1589,660,11,2707,2752,7719,73,185
847,1541,11,2453,1519,6371,903,1078,8,2215,1033,5237,73,186
518,1407,32,1732,1496,5185,1333,338,15,2474,1303,5463,73,187
401,1608,24,1627,1315,4975,708,268,17,1991,936,3920,73,188
711,2444,13,2241,1930,7339,657,350,6,1919,1226,4158,73,189
1061,1935,21,2218,1984,7219,1404,348,10,1968,1186,4916,73,190
1014,1730,6,2093,2026,6869,1243,335,8,1896,1180,4662,73,191
626,1173,8,1837,1728,5372,1340,387,7,1940,1496,5170,73,192
678,1541,14,1829,1755,5817,1484,564,8,2204,1842,6102,73,193
589,1400,58,1878,1770,5695,1521,507,16,2493,1690,6227,73,194
352,1303,31,1541,1285,4512,684,241,20,1820,769,3534,73,195
484,1954,8,1916,1816,6178,700,328,4,1859,984,3875,73,196
814,1576,18,2208,1774,6390,1301,355,11,1899,997,4563,73,197
721,1289,5,1902,1661,5578,1209,354,10,1790,1071,4434,73,198
586,1374,6,1648,1302,4916,1429,404,7,1888,1416,5144,73,199
606,1441,10,1931,1669,5657,1358,560,6,2329,1865,6118,73,200
671,1705,36,1729,1645,5786,1467,632,18,2549,1635,6301,73,201
535,1238,37,1598,1273,4681,807,268,18,1970,837,3900,73,202
554,1762,10,2096,1630,6052,595,393,7,1840,1124,3959,73,203
910,1762,16,1915,1623,6226,1315,448,17,1956,1061,4797,73,204
765,1469,14,1919,1835,6002,1263,356,12,2068,1412,5111,73,205
679,1530,14,1844,1743,5810,1321,488,10,2058,1609,5486,73,206
592,1433,10,1620,1850,5505,1308,585,6,2179,1907,5985,73,207
658,1645,26,1929,1761,6019,1462,470,14,2550,1787,6283,73,208
414,1238,19,1570,1220,4461,501,224,19,2053,797,3594,73,209
541,1983,24,1942,1671,6161,684,426,17,2045,1061,4233,73,210
833,1895,18,2210,1721,6677,1199,323,17,2083,1126,4748,73,211
729,1321,17,1906,1480,5453,1310,342,15,2029,1034,4730,73,212
562,1537,16,1606,1280,5001,1249,468,16,1990,1578,5301,73,213
584,1404,13,1880,1714,5595,1455,585,4,2316,1710,6070,73,214
599,1438,52,1923,1710,5722,1526,529,22,2325,1664,6066,73,215
408,1153,77,1520,1015,4173,577,272,24,1907,781,3561,73,216
451,1748,14,1781,1621,5615,610,389,16,1913,975,3903,73,217
766,1822,20,2074,1897,6579,1391,412,15,2274,1277,5369,73,218
685,1336,7,1930,1906,5864,1348,354,6,1939,1207,4854,73,219
563,1293,22,1702,1726,5306,1451,413,11,2123,1433,5431,73,220
579,1401,8,1540,1635,5163,1385,480,11,2102,1675,5653,73,221
386,846,19,1812,1405,4468,1331,327,16,2091,1320,5085,73,222
442,1207,37,1511,1283,4480,702,255,14,1817,908,3696,73,223
489,1956,11,1798,1839,6093,561,316,9,1874,951,3711,73,224
886,1767,5,2067,1983,6708,1371,322,5,2026,1052,4776,73,225
685,1400,9,1926,1833,5853,1218,320,8,1742,1073,4361,73,226
575,1401,11,1715,1935,5637,1289,377,8,2091,1465,5230,73,227
631,1451,45,1788,1720,5635,1478,549,37,2151,1835,6050,73,228
662,1483,51,1897,1789,5882,1516,489,31,2384,1679,6099,73,229
426,1225,51,1590,1245,4537,648,246,21,1814,799,3528,73,230
586,1865,56,1899,1690,6096,585,332,55,1885,1055,3912,73,231
882,1724,11,2264,1929,6810,1516,303,5,1991,1058,4873,73,232
785,1558,7,1895,1793,6038,1229,310,10,1711,956,4216,73,233
573,1428,10,1676,1654,5341,1176,371,8,1892,1405,4852,73,234
603,1441,12,1713,1630,5399,1287,465,13,2038,1856,5659,73,235
607,1602,29,1978,1816,6032,1540,414,18,2594,1649,6215,73,236
463,1281,31,1630,1256,4661,644,229,17,1696,617,3203,73,237
470,2196,9,1875,1848,6398,584,324,8,1815,996,3727,73,238
875,1747,6,1777,1956,6361,1319,334,3,1789,903,4348,73,239
589,1204,14,1532,1512,4851,1111,291,16,1466,1069,3953,73,240
498,1316,10,1604,1537,4965,1286,418,5,1822,1647,5178,73,241
564,1405,16,1680,1446,5111,1643,509,18,2487,1931,6588,73,242
774,1751,51,2305,1958,6839,1791,692,17,2993,2556,8049,73,243
483,1070,33,1754,1290,4630,979,249,18,1904,691,3841,73,244
369,1828,12,1561,1655,5425,626,309,9,1720,956,3620,73,245
753,2515,13,2460,2403,8144,656,301,7,2196,1222,4382,73,246
1070,1815,11,2603,2204,7703,1275,288,9,1829,1017,4418,73,247
583,1261,9,1759,1613,5225,1038,266,7,1596,1132,4039,73,248
498,1274,13,1550,1511,4846,1300,437,8,1996,1798,5539,73,249
549,1392,37,1814,1699,5491,1441,395,16,2358,1774,5984,73,250
328,1267,25,1566,1248,4434,653,233,17,1664,576,3143,73,251
538,1857,11,1944,1980,6330,584,281,10,1884,1115,3874,73,252
943,1791,7,2101,1971,6813,1276,259,7,1746,941,4229,73,253
726,1265,10,1715,1567,5283,1153,332,7,1614,1102,4208,73,254
602,1237,35,1586,1451,4911,1097,335,32,1858,1519,4841,73,255
593,1321,11,1779,1912,5616,1442,466,14,2243,1980,6145,73,256
709,1534,30,2131,2033,6437,1652,476,20,2748,2038,6934,73,257
377,1112,64,1767,1402,4722,749,227,49,1880,706,3611,73,258
559,2062,17,2238,1723,6599,501,315,8,1864,1222,3910,73,259
982,1853,7,2228,1957,7027,1516,314,6,2401,1170,5407,73,260
762,1184,5,1883,1643,5477,1222,271,7,1903,1235,4638,73,261
630,1264,3,1859,1714,5470,1315,404,4,2247,1650,5620,73,262
616,1469,9,1931,2038,6063,1507,588,15,2475,2148,6733,73,263
711,1591,50,2303,2063,6718,1678,553,16,2645,2022,6914,73,264
346,1196,31,1675,1381,4629,688,241,15,1877,840,3661,73,265
522,2342,13,2211,1960,7048,586,379,7,2012,1283,4267,73,266
961,1846,19,2152,2003,6981,1441,283,15,2161,1145,5045,73,267
812,1360,11,1947,1795,5925,1286,354,8,1810,1350,4808,73,268
651,1418,9,1793,1721,5592,1360,393,9,2017,1690,5469,73,269
591,1357,12,2083,1915,5958,1500,539,8,2359,1839,6245,73,270
667,1635,51,1978,1813,6144,1527,558,27,2554,1903,6569,73,271
375,1248,21,1856,1435,4935,863,228,13,1973,830,3907,73,272
502,1950,9,2037,1841,6339,601,372,9,1961,1223,4166,73,273
868,1813,13,2124,1874,6692,1377,347,11,2286,1178,5199,73,274
710,1196,6,1585,1536,5033,1271,322,4,1746,1351,4694,73,275
486,1283,16,1715,1702,5202,1203,350,17,2192,1662,5424,73,276
588,1350,20,1797,1791,5546,1522,535,15,2374,2145,6591,73,277
615,1613,24,2330,2046,6628,1593,499,27,2574,2245,6938,73,278
454,1422,25,1975,1650,5526,695,258,34,1808,843,3638,73,279
654,2123,19,2298,1990,7084,559,364,17,1849,1214,4003,73,280
1034,1962,10,2291,1958,7255,1418,312,9,2219,1320,5278,73,281
762,1289,9,1823,1852,5735,1204,328,8,1865,1393,4798,73,282
667,1485,8,1743,1816,5719,1316,582,5,2581,2224,6708,73,283
636,1636,11,2345,2253,6881,1656,646,13,2640,2141,7096,73,284
841,1937,21,2385,2230,7414,1672,707,19,2829,2468,7695,73,285
575,1354,42,2207,1720,5898,916,275,17,2295,1017,4520,73,286
613,2408,5,2492,2200,7718,754,398,4,2431,1230,4817,73,287
933,2094,15,2522,2122,7686,1326,338,8,2481,1438,5591,73,288
1315,1751,7,2374,2226,7673,1517,394,7,2609,1768,6295,73,289
857,1548,11,2064,2105,6585,1524,456,9,2609,2106,6704,73,290
696,1614,15,2316,1977,6618,1540,622,18,2625,2236,7041,73,291
843,1764,30,2372,2222,7231,1739,590,23,2970,2255,7577,73,292
424,1237,22,1810,1427,4920,706,289,18,1959,920,3892,73,293
748,2376,16,2209,2123,7472,690,434,16,2174,1494,4808,73,294
1145,2008,27,2323,2174,7677,1604,338,17,2503,1616,6078,73,295
961,1414,13,1981,2039,6408,1225,345,8,2085,1409,5072,73,296
705,1462,10,1896,2026,6099,1313,416,8,2238,1904,5879,73,297
669,1741,9,2089,2169,6677,1629,563,6,2658,2177,7033,73,298
1018,1971,49,2809,2305,8152,1683,629,16,2924,2286,7538,73,299
529,1344,25,1996,1463,5357,826,244,18,2216,847,4151,73,300
740,2084,32,2439,2241,7536,1179,471,21,2656,1677,6004,73,301
1043,1907,16,2287,2347,7600,1932,389,19,2807,1983,7130,73,302
786,1320,23,1734,1782,5645,1428,396,15,2001,1535,5375,73,303
528,1404,19,1692,1734,5377,1497,441,16,2264,1773,5991,73,304
534,1213,32,1985,1749,5513,1745,375,29,2504,1773,6426,73,305
645,1458,31,2082,2112,6328,1559,521,16,2784,2110,6990,73,306
313,1131,36,1597,1314,4391,687,290,17,1687,769,3450,73,307
564,2301,13,2024,2185,7087,760,348,8,1906,1184,4206,73,308
985,1674,6,2030,1967,6662,1474,279,3,1969,1129,4854,73,309
632,1313,9,1736,1679,5369,1165,226,7,1698,997,4093,73,310
584,1340,12,1613,1693,5242,1256,299,12,1802,1400,4769,73,311
524,1588,11,1826,1908,5857,1446,568,9,2390,2248,6661,73,312
705,1525,46,2336,2024,6636,1739,642,19,2566,2284,7250,73,313
390,1163,25,1691,1321,4590,802,206,16,1968,682,3674,73,314
512,1870,12,1912,1763,6069,588,317,6,1795,1268,3974,73,315
756,2145,8,2365,2127,7401,1250,293,5,2243,1322,5113,73,316
981,1659,9,2306,2093,7048,1514,253,8,1994,1094,4863,73,317
573,1419,11,1862,1927,5792,1235,364,8,1915,1492,5014,73,318
663,1506,15,1812,1748,5744,1473,553,9,2273,2048,6356,73,319
710,1517,30,2445,1931,6633,1584,506,15,2589,2134,6828,73,320
365,1115,25,1501,1360,4366,653,217,16,1699,787,3372,73,321
416,2031,19,2050,1976,6492,586,335,15,1932,1328,4196,73,322
883,1757,16,2154,2020,6830,1367,251,16,1968,1182,4784,73,323
749,1306,18,1670,1587,5330,1204,302,15,1871,1261,4653,73,324
615,1072,17,1859,1654,5217,1269,386,9,2009,1816,5489,73,325
578,1440,14,1771,1717,5520,1758,687,18,2403,2083,6949,73,326
590,1737,70,1906,2058,6361,1938,720,15,2881,2500,8054,73,327
387,1143,32,1585,1277,4424,756,306,25,2933,1398,5418,73,328
320,1717,18,1769,1505,5329,754,410,15,2242,1453,4874,73,329
509,1413,14,1948,1668,5552,1631,566,10,2999,2415,7621,73,330
555,1487,10,1739,1937,5728,1881,748,13,3003,2954,8599,73,331
591,1657,16,2133,2020,6417,2200,744,17,3967,3048,9976,73,332
451,328,7,1571,876,3233,762,146,7,1199,217,2331,73,333
485,2325,68,2361,2109,7348,928,215,15,1780,815,3753,73,334
811,2158,71,2554,2163,7757,451,182,20,1566,764,2983,73,335
1041,4741,23,3588,3929,13322,541,588,6,1659,1657,4451,73,336
1144,2470,31,3038,2360,9043,1395,355,22,1968,1244,4984,73,337
1095,2570,13,2946,2648,9272,1255,299,10,1909,1241,4714,73,338
669,1645,16,2043,1891,6264,1120,331,16,1874,1477,4818,73,339
479,1418,19,1858,1778,5552,1299,531,14,2113,2055,6012,73,340
599,1441,33,1970,1824,5867,1440,399,22,2446,1944,6251,73,341
313,1203,44,1532,1676,4768,563,196,20,1550,747,3076,73,342
510,2150,16,2708,2436,7820,655,379,10,1978,1208,4230,73,343
992,1840,31,2461,2104,7428,1459,296,13,1805,1112,4685,73,344
825,1345,16,1879,1699,5764,1139,352,9,1716,1292,4508,73,345
660,1435,8,1367,1626,5096,1370,455,11,1980,1640,5456,73,346
652,1713,8,2198,1953,6524,1603,716,8,2615,2326,7268,73,347
735,1642,35,2290,2191,6893,1822,706,25,3322,2900,8775,73,348
404,1212,26,1494,1131,4267,892,252,18,2797,1160,5119,73,349
312,1630,12,1719,1973,5646,757,373,10,2506,1416,5062,73,350
756,1412,12,1585,1919,5684,1583,353,13,2377,1467,5793,73,351
611,1196,8,1705,1507,5027,1698,421,11,2523,1982,6635,73,352
508,1122,16,1383,1544,4573,1880,517,18,3029,2428,7872,73,353
465,1180,17,1318,1500,4480,1709,591,16,2396,2270,6982,73,354
538,1437,62,1536,1545,5118,1555,725,22,2531,2330,7163,73,355
274,996,51,1227,1092,3640,704,285,21,2297,1372,4679,73,356
324,1251,21,1235,1365,4196,684,487,17,2218,1694,5100,73,357
491,1172,12,1420,1340,4435,1423,533,8,2647,2046,6657,73,358
296,730,13,1326,1102,3467,1575,235,10,2181,1069,5070,73,359
205,899,9,1187,1183,3483,504,161,8,1148,395,2216,73,360
584,1608,25,2125,1499,5841,833,308,15,1374,679,3209,73,361
657,1553,91,1969,1689,5959,906,298,27,1577,847,3655,73,362
419,1657,68,1836,1408,5388,397,216,27,1313,606,2559,73,363
551,1865,27,1986,1726,6155,433,303,11,1525,710,2982,73,364
715,1660,17,2174,1804,6370,1088,282,7,1734,1034,4145,73,365
699,1069,62,2073,1417,5320,1065,405,35,1674,664,3843,73,366
104,270,11,748,501,1634,118,354,19,639,589,1719,74,1
1269,481,20,1110,2127,5007,1736,518,18,995,1594,4861,74,2
1436,538,18,1348,2609,5949,2113,676,31,1128,1918,5866,74,3
1503,533,20,1267,2590,5913,2127,608,28,1069,1851,5683,74,4
1035,606,37,1340,1972,4990,1309,758,58,1160,1486,4771,74,5
240,399,31,931,544,2145,196,518,51,689,645,2099,74,6
249,315,13,1220,813,2610,161,502,29,926,981,2599,74,7
1434,547,18,1236,2250,5485,1845,698,29,1119,1709,5400,74,8
1796,470,13,1474,2400,6153,2539,604,19,1204,1780,6146,74,9
1954,766,21,1546,3299,7586,2820,854,32,1404,2219,7329,74,10
1815,819,25,1591,3378,7628,2766,924,29,1476,2220,7415,74,11
52,25,18,22,5,122,18,25,30,12,9,94,74,12
12,0,0,2,1,15,14,4,1,8,7,34,74,13
1,1,3,3,1,9,4,1,2,6,5,18,74,14
0,4,1,5,1,11,12,3,3,10,7,35,74,15
691,502,12,858,1352,3415,884,578,21,873,1049,3405,74,16
1729,722,26,1359,2835,6671,2094,861,31,1507,2135,6628,74,17
1883,903,17,1659,3504,7966,2627,1252,31,1544,2375,7829,74,18
983,763,47,1356,1449,4598,816,850,94,1021,1550,4331,74,19
353,550,27,1565,1148,3643,203,750,72,1032,1221,3278,74,20
266,338,17,1254,955,2830,125,552,22,912,998,2609,74,21
1587,674,16,1311,2390,5978,1889,788,24,1200,1940,5841,74,22
2079,862,14,1572,3399,7926,2877,959,22,1457,2307,7622,74,23
2105,825,29,1729,3447,8135,2839,999,42,1580,2340,7800,74,24
1917,889,15,1670,3500,7991,2709,1003,17,1488,2281,7498,74,25
1286,989,53,1691,2351,6370,1491,971,107,1398,1839,5806,74,26
302,698,37,1788,1524,4349,246,864,67,1515,1320,4012,74,27
223,407,8,1298,787,2723,136,521,11,940,945,2553,74,28
1598,674,14,1414,2377,6077,1873,833,16,1261,1908,5891,74,29
2130,834,10,1628,3313,7915,2927,895,25,1380,2368,7595,74,30
2094,887,16,1816,3621,8434,3041,1085,18,1610,2382,8136,74,31
2142,889,11,1839,3572,8453,2812,1008,19,1543,2419,7801,74,32
1299,858,51,1636,2420,6264,1533,1060,78,1376,1842,5889,74,33
381,657,35,1989,1335,4397,230,867,75,1596,1381,4149,74,34
262,441,7,1556,1007,3273,159,612,10,1209,1174,3164,74,35
1683,638,14,1401,2439,6175,1939,853,22,1295,1945,6054,74,36
2232,858,14,1592,3407,8103,2912,1019,18,1419,2528,7896,74,37
2223,916,10,1760,3540,8449,2890,1174,15,1566,2488,8133,74,38
2065,927,13,1805,3570,8380,2893,1066,17,1565,2470,8011,74,39
1333,848,37,1642,2459,6319,1530,1059,101,1341,1826,5857,74,40
345,700,59,1696,1444,4244,209,916,101,1351,1359,3936,74,41
248,553,28,1266,912,3007,150,625,48,961,1195,2979,74,42
1576,654,9,1466,2500,6205,1884,854,20,1257,1939,5954,74,43
1974,822,11,1582,3135,7524,2520,1063,20,1365,2327,7295,74,44
2087,753,15,1691,3566,8112,2777,1025,25,1642,2429,7898,74,45
1932,914,10,1816,3286,7958,2653,1043,43,1460,2559,7758,74,46
1186,806,41,1678,2347,6058,1337,987,108,1270,1814,5516,74,47
342,636,35,1670,1193,3876,210,793,108,1164,1309,3584,74,48
300,466,50,1525,1050,3391,156,614,50,1249,1192,3261,74,49
499,477,20,1544,1548,4088,728,656,23,1325,1390,4122,74,50
2033,783,17,1645,3423,7901,2867,964,16,1487,2353,7687,74,51
2058,806,10,1636,3499,8009,2839,988,21,1554,2387,7789,74,52
2041,880,11,1700,3558,8190,2835,1041,22,1443,2350,7691,74,53
1386,872,42,1609,2392,6301,1577,998,84,1365,1789,5813,74,54
338,787,62,1904,1419,4510,274,893,101,1432,1449,4149,74,55
246,464,11,1420,1067,3208,145,601,12,1153,1210,3121,74,56
1684,743,19,1526,2574,6546,1979,971,15,1323,2084,6372,74,57
2194,821,19,1757,3419,8210,2858,1033,21,1547,2418,7877,74,58
2063,768,8,1734,3386,7959,2873,1012,18,1567,2317,7787,74,59
2106,963,16,1877,3442,8404,2797,1127,21,1595,2383,7923,74,60
1333,847,48,1909,2578,6715,1592,1048,106,1370,1820,5936,74,61
306,679,43,1607,1131,3766,195,836,90,1022,1276,3419,74,62
286,489,17,1716,1266,3774,170,618,34,1429,1320,3571,74,63
1720,661,17,1542,2534,6474,2006,981,14,1251,2087,6339,74,64
2238,817,22,1733,3296,8106,2801,1088,20,1309,2677,7895,74,65
2251,782,11,1684,3386,8114,2809,1083,11,1420,2474,7797,74,66
2165,893,18,1896,3472,8444,2706,1201,50,1494,2558,8009,74,67
1430,909,35,1686,2296,6356,1538,1098,89,1368,1920,6013,74,68
374,528,37,1550,975,3464,212,763,82,1077,1186,3320,74,69
295,478,8,1552,1047,3380,133,811,15,1211,1272,3442,74,70
1661,767,20,1541,2491,6480,1994,1008,28,1193,2143,6366,74,71
2235,956,9,1846,3619,8665,2819,1210,23,1646,2698,8396,74,72
2207,1102,21,1974,3661,8965,2849,1227,38,1695,2652,8461,74,73
2008,1009,13,2012,3605,8647,2660,1336,124,1700,2527,8347,74,74
1386,883,65,2039,2623,6996,1543,1100,161,1464,2023,6291,74,75
748,997,72,2531,1826,6174,295,1342,115,1977,1877,5606,74,76
352,609,10,1855,1300,4126,186,1002,29,1348,1368,3933,74,77
1822,784,18,1638,2718,6980,1983,1064,20,1426,2296,6789,74,78
2284,950,38,1847,3707,8826,3000,1250,34,1553,2665,8502,74,79
2351,1069,19,2082,3985,9506,2988,1560,26,1813,2887,9274,74,80
2163,1099,35,2287,4009,9593,2918,1632,37,1805,2924,9316,74,81
1790,1139,37,2355,2929,8250,1658,1563,95,1937,2511,7764,74,82
577,932,47,1715,1415,4686,225,1260,104,1092,1705,4386,74,83
451,715,22,2719,1656,5563,193,996,17,1882,2085,5173,74,84
1769,867,32,1976,2975,7619,1887,1249,59,1491,2621,7307,74,85
2154,953,27,2078,3646,8858,2715,1313,25,1710,2749,8512,74,86
2109,939,24,1919,3365,8356,2545,1222,31,1573,2513,7884,74,87
1899,965,29,2281,3322,8496,2371,1313,31,1707,2466,7888,74,88
1258,1066,50,2410,2526,7310,1246,1425,87,1817,2322,6897,74,89
491,857,59,3036,1856,6299,266,1374,85,1779,2061,5565,74,90
376,534,34,1915,1047,3906,152,814,39,1358,1575,3938,74,91
1526,651,22,1825,2451,6475,1683,1309,30,1362,2243,6627,74,92
2090,950,13,2022,3413,8488,2740,1123,14,1576,2747,8200,74,93
2062,929,24,1905,3488,8408,2856,1207,38,1527,2524,8152,74,94
2227,1023,15,2283,3702,9250,2835,1399,33,1880,2774,8921,74,95
1519,1099,58,2306,2916,7898,1605,1400,90,1837,2319,7251,74,96
598,800,66,2365,1538,5367,265,1304,103,1780,1620,5072,74,97
831,535,10,2115,1303,4794,273,889,15,1859,1370,4406,74,98
1654,813,8,1653,2735,6863,1925,1113,21,1586,2088,6733,74,99
2227,971,22,1833,3371,8424,2780,1100,48,1577,2566,8071,74,100
2216,1014,12,1992,3549,8783,2686,1234,27,1796,2548,8291,74,101
2126,918,17,2010,3567,8638,2853,1320,23,1587,2429,8212,74,102
1448,1027,48,1981,2625,7129,1610,1286,83,1510,2104,6593,74,103
495,830,48,2400,1777,5550,275,1275,115,1708,1714,5087,74,104
551,666,16,2014,1419,4666,233,872,20,1676,1492,4293,74,105
1771,840,18,1745,2690,7064,1882,1168,26,1502,2308,6886,74,106
2379,1059,37,1951,3642,9068,2958,1275,31,1709,2783,8756,74,107
2410,1045,19,2054,3536,9064,2917,1306,32,1943,2570,8768,74,108
2295,1209,30,2357,3724,9615,2901,1433,43,1795,2763,8935,74,109
1587,1020,47,1871,2596,7121,1548,1388,93,1446,2045,6520,74,110
456,912,58,2418,2102,5946,251,1475,110,1613,1912,5361,74,111
317,531,10,1689,991,3538,194,693,24,1283,1220,3414,74,112
1682,728,15,1712,2713,6850,1943,922,28,1430,2113,6436,74,113
2172,943,20,1812,3800,8747,2829,1446,25,1672,2583,8555,74,114
2123,1026,9,1844,3972,8974,2937,1390,28,1819,2444,8618,74,115
2103,1021,17,2174,3722,9037,2837,1374,18,1781,2465,8475,74,116
1412,1013,44,1980,2621,7070,1573,1299,88,1551,1993,6504,74,117
443,818,48,1939,1536,4784,270,1262,195,1654,1307,4688,74,118
305,642,17,1814,1716,4494,165,907,110,1914,1398,4494,74,119
1628,848,25,1638,2525,6664,1911,952,31,1435,2061,6390,74,120
2166,1041,14,1806,3556,8583,2837,1259,28,1518,2418,8060,74,121
2143,1068,12,1915,3651,8789,2830,1289,18,1736,2564,8437,74,122
2102,1093,22,1885,3491,8593,2801,1183,39,1684,2407,8114,74,123
1399,1009,45,1961,2664,7078,1575,1225,110,1562,1915,6387,74,124
382,637,38,1986,1122,4165,276,937,69,1329,1278,3889,74,125
273,495,8,1490,1072,3338,149,785,20,1098,1190,3242,74,126
1635,726,19,1635,2606,6621,1857,984,17,1332,2055,6245,74,127
2099,963,7,1920,3646,8635,2700,1266,15,1558,2589,8128,74,128
2203,1002,8,1984,3723,8920,2764,1375,19,1718,2485,8361,74,129
1966,976,14,1984,3366,8306,2622,1175,29,1534,2347,7707,74,130
1347,803,62,1736,2364,6312,1482,1049,77,1383,1761,5752,74,131
440,724,33,2040,1480,4717,247,855,71,1590,1567,4330,74,132
290,521,8,1600,970,3389,154,717,21,1283,1235,3410,74,133
1462,866,12,1698,2692,6730,1885,999,19,1452,2037,6392,74,134
2004,818,47,1800,3493,8162,2839,1005,55,1503,2328,7730,74,135
1955,978,38,1909,3782,8662,2920,1194,63,1686,2416,8279,74,136
1968,1287,29,2204,3576,9064,2717,1272,27,1961,2596,8573,74,137
1331,1061,42,1851,2484,6769,1496,1097,67,1575,2033,6268,74,138
312,805,42,1696,1184,4039,268,958,98,1226,1208,3758,74,139
443,724,7,1832,1275,4281,201,832,20,1529,1328,3910,74,140
1697,815,13,1692,2772,6989,1971,1092,12,1433,2067,6575,74,141
2211,961,26,1837,3642,8677,2860,1130,22,1685,2537,8234,74,142
2118,920,11,1971,3569,8589,2842,1072,20,1669,2459,8062,74,143
1855,854,17,1886,3134,7746,2546,1025,26,1476,2244,7317,74,144
1169,872,36,1922,2298,6297,1317,1237,79,1463,1635,5731,74,145
415,804,38,1922,1454,4633,278,1156,88,1506,1343,4371,74,146
408,711,5,2063,1209,4396,160,997,32,1601,1453,4243,74,147
357,450,11,1511,907,3236,232,645,13,1183,1137,3210,74,148
2025,767,11,1597,3132,7532,2471,918,34,1422,2335,7180,74,149
2140,976,24,1784,3254,8178,2834,1118,32,1542,2330,7856,74,150
2058,1014,15,1820,3642,8549,2819,1196,24,1607,2541,8187,74,151
1417,1081,37,1648,2416,6599,1523,1122,97,1421,1863,6026,74,152
364,894,43,1885,1443,4629,303,1009,83,1535,1393,4323,74,153
262,536,13,1736,1147,3694,213,714,16,1498,1273,3714,74,154
1787,772,9,1524,2846,6938,2107,1014,17,1329,2208,6675,74,155
2360,890,11,1800,3894,8955,3056,1225,17,1569,2577,8444,74,156
2341,940,14,1902,3698,8895,3080,1127,16,1640,2541,8404,74,157
2191,1134,6,1929,3827,9087,2982,1421,24,1612,2467,8506,74,158
1568,1186,43,2100,3148,8045,1932,1613,164,1661,2105,7475,74,159
500,1057,57,2704,2158,6476,345,1857,132,1580,1959,5873,74,160
308,674,27,2014,1332,4355,195,945,38,1549,1498,4225,74,161
1811,814,12,1683,2899,7219,2205,1020,23,1433,2240,6921,74,162
2464,1181,6,1887,3881,9419,3106,1339,14,1682,2768,8909,74,163
2382,1025,14,1976,4144,9541,3257,1445,54,1769,2575,9100,74,164
2218,1102,8,1908,3618,8854,2971,1369,26,1608,2507,8481,74,165
1458,956,44,1886,2719,7063,1584,1409,96,1549,1928,6566,74,166
448,959,52,2044,1613,5116,267,1203,104,1476,1511,4561,74,167
291,559,25,1673,1013,3561,189,757,31,1338,1210,3525,74,168
1765,751,15,1574,2659,6764,2061,965,20,1384,2163,6593,74,169
2356,1071,12,1900,3745,9084,3009,1249,32,1666,2614,8570,74,170
718,913,24,1775,2226,5656,1242,1099,32,1570,1431,5374,74,171
2129,1090,33,1894,3320,8466,2846,1175,50,1535,2493,8099,74,172
1486,1146,23,1770,2403,6828,1690,1238,109,1416,2057,6510,74,173
464,1009,54,1777,1380,4684,303,1428,122,1359,1210,4422,74,174
334,606,25,1518,963,3446,187,716,43,1251,1198,3395,74,175
1738,816,12,1673,2690,6929,2040,987,24,1469,2221,6741,74,176
2477,1015,40,1670,3743,8945,3040,1157,63,1610,2709,8579,74,177
2369,900,9,1795,3764,8837,2992,1158,19,1734,2538,8441,74,178
2191,1225,26,1906,3773,9121,2974,1380,36,1671,2585,8646,74,179
1501,1095,44,1859,2478,6977,1656,1230,91,1504,1990,6471,74,180
408,892,35,1920,1237,4492,280,1052,103,1446,1455,4336,74,181
330,554,23,1622,939,3468,218,718,37,1248,1137,3358,74,182
1749,809,60,1633,2665,6916,1960,1147,81,1357,2227,6772,74,183
2173,864,21,1766,3267,8091,2537,1244,42,1576,2545,7944,74,184
1720,872,8,2081,2887,7568,1991,1286,51,1628,2197,7153,74,185
489,6509,37,2512,2063,11610,276,6408,55,1908,2273,10920,74,186
808,789,38,2076,1658,5369,861,1122,79,1465,1532,5059,74,187
463,750,48,1678,1089,4028,275,947,56,1278,1325,3881,74,188
307,602,15,1522,897,3343,184,677,24,1274,1238,3397,74,189
1736,692,20,1542,2534,6524,2036,940,26,1340,2193,6535,74,190
2261,975,17,1727,3469,8449,2839,1096,28,1529,2676,8168,74,191
2173,886,11,1803,3441,8314,2889,1115,15,1574,2546,8139,74,192
2071,1022,32,1863,3503,8491,2805,1279,32,1636,2489,8241,74,193
1327,876,35,1579,2192,6009,1449,1044,77,1254,1976,5800,74,194
420,917,42,1836,1408,4623,273,1163,65,1425,1524,4450,74,195
270,500,23,1458,927,3178,183,645,26,1275,1049,3178,74,196
1700,670,19,1519,2550,6458,2028,869,33,1324,2038,6292,74,197
2198,866,5,1679,3327,8075,2892,1082,17,1435,2498,7924,74,198
2269,885,21,1798,3344,8317,2947,958,26,1571,2700,8202,74,199
2063,1143,26,1780,3408,8420,2880,1238,23,1519,2578,8238,74,200
1355,993,35,1734,2613,6730,1523,1293,221,1426,1916,6379,74,201
370,814,39,1978,1582,4783,303,1207,81,1538,1414,4543,74,202
279,561,20,1705,1143,3708,181,757,17,1423,1305,3683,74,203
1728,704,29,1491,2571,6523,2028,908,23,1399,2092,6450,74,204
2337,961,12,1783,3715,8808,3025,1230,25,1573,2688,8541,74,205
2128,982,16,1981,3958,9065,2933,1329,14,1830,2703,8809,74,206
2123,967,26,1954,3659,8729,2874,1196,34,1689,2728,8521,74,207
1423,977,60,1927,2466,6853,1615,1192,128,1472,2019,6426,74,208
420,915,46,1908,1413,4702,249,1082,184,1463,1526,4504,74,209
325,528,9,1713,1147,3722,208,718,34,1552,1246,3758,74,210
1767,667,5,1557,2601,6597,2000,933,41,1322,2196,6492,74,211
2261,838,16,1777,3459,8351,2878,1060,19,1502,2704,8163,74,212
2223,856,19,1811,3457,8366,2947,1006,24,1527,2590,8094,74,213
1988,937,15,1900,3433,8273,2794,1109,20,1511,2509,7943,74,214
1382,918,45,1949,2423,6717,1591,1351,117,1408,1833,6300,74,215
433,568,43,1915,1286,4245,185,928,88,1336,1403,3940,74,216
366,551,19,1615,973,3524,151,721,25,1271,1265,3433,74,217
1553,711,35,1528,2509,6336,1844,841,37,1255,2123,6100,74,218
2050,890,29,1760,3533,8262,2874,1052,36,1372,2542,7876,74,219
2005,764,16,1721,3492,7998,2799,1036,28,1590,2372,7825,74,220
1705,676,15,1631,2966,6993,2496,807,27,1343,2168,6841,74,221
974,847,38,1487,1986,5332,1255,1019,116,1236,1418,5044,74,222
350,827,46,1756,1347,4326,262,997,84,1403,1296,4042,74,223
285,458,18,1610,1051,3422,170,624,22,1318,1154,3288,74,224
1521,674,16,1451,2385,6047,1926,810,21,1284,1952,5993,74,225
1911,929,9,1586,3347,7782,2736,977,14,1408,2396,7531,74,226
1834,870,5,1765,3336,7810,2706,998,12,1642,2327,7685,74,227
1792,869,9,1755,3288,7713,2578,1055,25,1502,2113,7273,74,228
1130,893,33,1649,2260,5965,1377,1076,86,1401,1656,5596,74,229
307,723,41,1613,1270,3954,240,908,84,1309,1193,3734,74,230
246,452,16,1580,975,3269,279,632,20,1236,1106,3273,74,231
1455,643,10,1547,2555,6210,1886,819,13,1424,1952,6094,74,232
1961,994,9,1685,3625,8274,2802,1216,20,1510,2461,8009,74,233
1900,872,14,1765,3681,8232,2911,1104,27,1650,2457,8149,74,234
1775,1082,19,1822,3345,8043,2554,1116,32,1589,2437,7728,74,235
1203,1078,51,1815,2438,6585,1538,1158,81,1492,1897,6166,74,236
402,848,55,2036,1468,4809,303,1163,89,1535,1494,4584,74,237
270,506,18,1635,1199,3628,164,726,39,1427,1245,3601,74,238
1666,667,14,1539,2876,6762,1992,1079,12,1402,2153,6638,74,239
2131,838,25,1869,3789,8652,3056,1276,28,1677,2466,8503,74,240
1969,949,8,1752,3719,8397,3011,1158,16,1571,2426,8182,74,241
1888,798,11,1855,3393,7945,2667,911,15,1604,2242,7439,74,242
1156,822,42,1973,2292,6285,1381,1049,111,1466,1586,5593,74,243
397,777,46,1860,1423,4503,255,1037,83,1379,1477,4231,74,244
275,706,8,1782,1235,4006,154,911,26,1277,1400,3768,74,245
239,524,26,1651,1150,3590,213,689,31,1460,1289,3682,74,246
2067,863,11,1729,3302,7972,2716,1056,15,1481,2439,7707,74,247
2141,946,23,1787,3656,8553,2945,1021,37,1614,2504,8121,74,248
1978,1011,9,1996,3553,8547,2914,1166,15,1619,2383,8097,74,249
1366,1034,50,1735,2505,6690,1656,1111,92,1483,1891,6233,74,250
404,1109,53,2280,1889,5735,311,1105,120,1846,1987,5369,74,251
277,515,22,1643,1192,3649,178,775,24,1475,1265,3717,74,252
1846,814,11,1675,2752,7098,2133,1048,19,1391,2227,6818,74,253
2346,1077,34,1933,3813,9203,3107,1397,41,1620,2706,8871,74,254
2313,1027,23,2097,3912,9372,3079,1420,30,1646,2727,8902,74,255
2208,1030,12,2105,4012,9367,3018,1571,19,1730,2608,8946,74,256
1462,1107,76,1919,2868,7432,1562,1494,100,1639,2088,6883,74,257
483,911,54,2156,1745,5349,319,1298,162,1604,1545,4928,74,258
348,552,38,1896,1258,4092,209,781,37,1412,1469,3908,74,259
1921,759,22,1636,2826,7164,2164,1060,28,1509,2255,7016,74,260
2457,884,15,1885,3879,9120,3302,1197,24,1570,2756,8849,74,261
2227,970,9,1977,3867,9050,3118,1314,17,1719,2627,8795,74,262
2262,1238,36,2074,3938,9548,3083,2091,37,1870,2582,9663,74,263
1515,1104,46,2019,2648,7332,1642,1307,112,1757,2043,6861,74,264
418,875,44,2131,1564,5032,291,1111,148,1550,1522,4622,74,265
300,502,14,1644,1052,3512,165,795,20,1236,1219,3435,74,266
1834,724,32,1726,2705,7021,2098,962,35,1469,2294,6858,74,267
2356,877,26,1950,3809,9018,3162,1130,31,1695,2611,8629,74,268
2319,947,13,1939,3853,9071,3076,1289,24,1680,2720,8789,74,269
2169,1100,8,2152,3709,9138,2948,1253,24,1794,2620,8639,74,270
1386,1065,78,1949,2786,7264,1673,1451,104,1503,2041,6772,74,271
420,952,54,2253,1825,5504,294,1428,134,1598,1709,5163,74,272
326,434,47,1636,1014,3457,176,695,45,1133,1311,3360,74,273
1802,787,28,1574,2586,6777,2101,957,26,1424,2115,6623,74,274
2290,913,24,1670,3634,8531,3076,1048,28,1587,2501,8240,74,275
2283,914,21,2076,3874,9168,3170,1242,32,1797,2572,8813,74,276
2011,1075,10,1884,3781,8761,2771,1306,28,1787,2405,8297,74,277
1431,1144,54,1989,2616,7234,1706,1173,103,1556,2101,6639,74,278
394,996,58,2163,1930,5541,289,1245,86,1876,1929,5425,74,279
293,503,28,1735,1215,3774,182,793,29,1409,1382,3795,74,280
1909,743,24,1700,2782,7158,2220,1026,35,1414,2226,6921,74,281
2451,945,16,2068,3970,9450,3232,1215,21,1831,2734,9033,74,282
2295,1064,36,2119,4107,9621,3282,1261,47,1742,2733,9065,74,283
2233,1049,16,2058,3994,9350,3020,1360,27,1943,2483,8833,74,284
1402,1027,66,2070,2791,7356,1570,1332,89,1680,2127,6798,74,285
566,840,39,2466,1825,5736,326,1372,76,1743,1874,5391,74,286
978,675,4,2263,1421,5341,393,1008,17,2041,1661,5120,74,287
1009,689,12,1839,2043,5592,1065,963,17,1552,1907,5504,74,288
2413,888,10,2082,4014,9407,3143,1294,20,1851,2728,9036,74,289
2376,1012,9,2011,4108,9516,3232,1275,19,1839,2794,9159,74,290
2177,1116,13,2116,4067,9489,3067,1457,37,1812,2659,9032,74,291
1422,1400,61,2085,2868,7836,1654,1533,130,1761,2256,7334,74,292
466,1046,55,2174,1752,5493,307,1303,126,1701,1685,5122,74,293
310,518,14,1986,1438,4266,194,964,24,1573,1296,4051,74,294
1824,791,21,1862,2955,7453,2187,1149,27,1508,2252,7123,74,295
2385,967,13,2013,3993,9371,3260,1236,18,1747,2804,9065,74,296
2397,1079,20,2049,4412,9957,3379,1428,22,1918,2738,9485,74,297
2324,1087,15,2162,4279,9867,3256,1564,18,1840,2717,9395,74,298
1484,1231,56,2235,2885,7891,1759,1348,102,1835,2310,7354,74,299
560,1000,87,2451,1823,5921,351,1148,149,2037,1824,5509,74,300
3749,568,9,19233,5362,28921,3704,881,15,12979,1455,19034,74,301
1851,855,20,2036,3094,7856,2264,1067,31,1617,2550,7529,74,302
2420,1019,9,2282,4984,10714,3349,1988,15,1912,2690,9954,74,303
2370,1056,18,2180,4371,9995,3341,1286,23,1917,2774,9341,74,304
2009,1232,15,1996,3692,8944,2761,1315,35,1661,2454,8226,74,305
1302,1113,63,1967,2555,7000,1616,1267,113,1567,1959,6522,74,306
351,906,88,2020,1637,5002,276,1229,151,1448,1483,4587,74,307
329,436,23,1763,1185,3736,230,616,35,1471,1236,3588,74,308
1768,665,25,1711,2855,7024,2184,937,32,1395,2188,6736,74,309
1856,827,18,1889,3319,7909,2658,859,56,1652,2171,7396,74,310
1891,780,16,1843,3444,7974,2699,1065,19,1626,2341,7750,74,311
2154,1049,20,1992,3833,9048,3129,1123,22,1702,2594,8570,74,312
1381,1027,50,1968,2647,7073,1526,1191,93,1728,1966,6504,74,313
396,763,48,2189,1605,5001,309,1002,91,1605,1562,4569,74,314
288,403,6,1820,1022,3539,197,632,24,1283,1374,3510,74,315
1077,635,9,1776,2145,5642,1210,847,11,1727,1729,5524,74,316
2330,834,25,1948,3924,9061,3216,1087,33,1747,2626,8709,74,317
2367,872,16,2010,4128,9393,3275,1313,28,1684,2737,9037,74,318
2205,947,42,2047,3995,9236,3237,1074,60,1729,2720,8820,74,319
1445,976,63,1888,2637,7009,1657,1171,96,1562,2075,6561,74,320
394,790,64,2231,1594,5073,283,988,94,1507,1768,4640,74,321
308,487,11,1803,1255,3864,193,782,17,1395,1296,3683,74,322
1798,683,4,1760,2949,7194,2311,983,10,1410,2328,7042,74,323
2443,863,27,1858,4011,9202,3265,1190,32,1664,2642,8793,74,324
2302,842,13,2015,4268,9440,3371,1198,24,1640,2689,8922,74,325
2167,986,14,1936,4045,9148,3164,1252,26,1664,2580,8686,74,326
1354,755,44,1840,2460,6453,1555,947,104,1400,1716,5722,74,327
297,678,48,1936,1492,4451,282,959,108,1298,1384,4031,74,328
283,401,29,1564,1055,3332,139,538,25,1124,1132,2958,74,329
1485,675,22,1731,2470,6383,1746,716,32,1321,1950,5765,74,330
1597,617,4,1877,2742,6837,1940,773,15,1396,1989,6113,74,331
1030,587,18,2000,1682,5317,1201,694,20,1311,1357,4583,74,332
214,158,9,838,432,1651,106,279,18,593,458,1454,74,333
432,461,34,1455,1074,3456,403,652,48,1070,1183,3356,74,334
207,446,23,1232,962,2870,227,656,48,963,1034,2928,74,335
229,408,10,1213,951,2811,183,840,18,1075,1275,3391,74,336
1502,607,22,1597,2516,6244,1933,906,27,1415,2078,6359,74,337
2169,836,11,1788,3799,8603,3025,1226,19,1628,2590,8488,74,338
2215,791,12,1896,3755,8669,3099,1171,22,1551,2693,8536,74,339
2119,838,18,1832,4044,8851,2887,1366,32,1649,2562,8496,74,340
1548,927,38,1810,2542,6865,1460,1076,109,1505,2074,6224,74,341
447,809,49,1977,1680,4962,227,1382,162,1365,1497,4633,74,342
264,489,10,1839,1300,3902,151,859,19,1367,1475,3871,74,343
1885,669,16,1607,2721,6898,2084,1037,22,1321,2137,6601,74,344
2333,763,12,1912,3400,8420,3161,1137,22,1664,2497,8481,74,345
2157,897,16,1837,3640,8547,3001,1194,18,1616,2386,8215,74,346
2161,999,20,2038,3794,9012,2901,1415,32,1798,2519,8665,74,347
1396,901,72,1990,2763,7122,1539,1181,156,1580,1996,6452,74,348
661,864,60,2743,1536,5864,693,1237,161,1858,1522,5471,74,349
254,410,19,1419,977,3079,152,692,25,1033,1030,2932,74,350
1565,639,18,1607,2582,6411,2005,808,22,1282,1946,6063,74,351
1962,879,27,1866,3606,8340,2828,1129,44,1506,2380,7887,74,352
1973,695,11,1844,3368,7891,2626,954,14,1548,2137,7279,74,353
1620,787,15,1711,3172,7305,2323,999,27,1480,1990,6819,74,354
992,627,19,1371,1851,4860,1020,726,53,1003,1242,4044,74,355
227,439,26,1295,927,2914,171,513,42,816,826,2368,74,356
152,283,17,956,804,2212,103,412,21,629,698,1863,74,357
539,330,20,1083,1242,3214,754,365,22,812,842,2795,74,358
362,190,6,782,580,1920,356,220,16,560,535,1687,74,359
77,120,5,340,280,822,65,162,12,273,261,773,74,360
362,289,12,838,946,2447,537,472,10,707,771,2497,74,361
387,408,28,1036,1062,2921,512,532,32,800,927,2803,74,362
186,309,27,880,590,1992,147,518,27,558,706,1956,74,363
169,249,23,998,832,2271,128,479,24,812,779,2222,74,364
617,467,22,1283,1614,4003,853,568,27,1059,1252,3759,74,365
616,790,218,1512,1241,4377,806,733,400,1114,1163,4216,74,366
213,138,2,717,331,1401,82,387,27,468,628,1592,75,1
2698,160,7,1131,614,4610,383,777,36,647,2716,4559,75,2
3219,158,11,1109,966,5463,421,1159,51,648,3102,5381,75,3
3071,176,7,1003,654,4911,401,819,42,699,2942,4903,75,4
2154,243,14,1076,1100,4587,359,1120,147,681,2112,4419,75,5
376,143,11,653,539,1722,103,574,93,383,619,1772,75,6
296,155,3,1294,320,2068,83,537,35,407,1037,2099,75,7
2965,139,7,958,825,4894,443,979,54,632,2751,4859,75,8
3656,132,11,773,471,5043,415,645,36,1036,2853,4985,75,9
3762,177,5,1109,699,5752,472,1004,48,748,3408,5680,75,10
3522,215,5,1131,1157,6030,448,1313,54,752,3258,5825,75,11
2253,237,11,1048,755,4304,386,782,112,711,2096,4087,75,12
484,221,8,2440,587,3740,136,960,105,570,1992,3763,75,13
287,153,4,852,387,1683,95,455,42,472,740,1804,75,14
694,131,11,975,348,2159,196,483,59,485,916,2139,75,15
1043,123,9,606,621,2402,293,714,57,413,866,2343,75,16
2972,155,2,992,609,4730,385,844,52,611,2752,4644,75,17
3488,206,9,1077,968,5748,421,1333,66,676,3070,5566,75,18
1174,184,19,844,464,2685,271,625,122,503,1119,2640,75,19
384,170,7,1004,661,2226,90,844,100,458,762,2254,75,20
299,99,4,931,457,1790,69,635,37,417,708,1866,75,21
2958,170,1,985,620,4734,418,882,41,626,2739,4706,75,22
4116,202,2,1020,711,6051,457,1070,51,718,3679,5975,75,23
4030,192,2,1226,902,6352,543,1182,75,790,3635,6225,75,24
3607,199,5,1147,885,5843,434,1252,58,735,3309,5788,75,25
2458,305,15,1168,932,4878,406,1061,139,823,2337,4766,75,26
638,242,18,2178,887,3963,154,1092,160,753,1781,3940,75,27
312,188,2,1128,376,2006,95,524,33,488,955,2095,75,28
3097,170,10,1016,696,4989,431,778,38,687,2921,4855,75,29
4097,194,2,990,703,5986,494,1014,33,715,3649,5905,75,30
4000,183,4,1096,879,6162,465,1250,43,752,3528,6038,75,31
3591,191,4,1049,801,5636,468,1070,62,675,3263,5538,75,32
2375,268,10,1091,1038,4782,407,1019,158,775,2282,4641,75,33
421,226,10,1115,567,2339,109,592,117,499,864,2181,75,34
274,137,1,938,388,1738,69,586,24,432,721,1832,75,35
3166,181,5,869,689,4910,451,802,37,713,2831,4834,75,36
4101,181,4,1024,983,6293,514,1311,49,698,3651,6223,75,37
4067,188,3,1068,885,6211,516,1195,44,711,3616,6082,75,38
3700,217,1,1081,800,5799,479,1107,46,783,3301,5716,75,39
2471,320,9,1117,927,4844,409,903,263,881,2264,4720,75,40
528,292,10,1638,844,3312,140,1013,161,707,1299,3320,75,41
310,199,2,1376,381,2268,87,482,61,539,1173,2342,75,42
3090,174,5,955,642,4866,433,760,39,699,2817,4748,75,43
3395,177,4,903,923,5402,424,1215,52,681,2960,5332,75,44
4000,213,1,1054,821,6089,461,1099,66,808,3510,5944,75,45
3593,218,4,1105,858,5778,441,1103,67,744,3260,5615,75,46
2248,298,25,1051,938,4560,376,959,140,856,2099,4430,75,47
417,226,21,1201,514,2379,124,670,123,441,992,2350,75,48
342,187,2,1160,383,2074,110,535,38,535,967,2185,75,49
999,199,1,1163,587,2949,284,625,38,648,1290,2885,75,50
4002,180,5,1034,966,6187,481,1256,48,725,3610,6120,75,51
4085,194,5,1075,775,6134,504,1111,53,755,3637,6060,75,52
3757,192,4,1016,975,5944,462,1247,63,753,3326,5851,75,53
2440,309,9,1103,860,4721,449,953,124,779,2232,4537,75,54
468,174,6,1095,592,2335,122,666,119,462,787,2156,75,55
279,123,0,771,423,1596,70,547,30,332,643,1622,75,56
3285,197,2,1078,973,5535,490,1144,32,722,2889,5277,75,57
4139,192,0,1053,941,6325,511,1324,37,771,3621,6264,75,58
3969,190,2,1039,721,5921,483,1120,53,709,3491,5856,75,59
3688,219,2,1087,760,5756,483,1089,55,725,3279,5631,75,60
2460,250,12,1081,1362,5165,403,1364,155,776,2314,5012,75,61
442,253,7,1138,638,2478,113,790,128,477,972,2480,75,62
360,160,6,1516,426,2468,116,544,44,531,1343,2578,75,63
3240,181,2,1015,665,5103,498,854,46,695,2940,5033,75,64
4114,226,10,1094,779,6223,468,1214,65,880,3635,6262,75,65
4133,183,2,1072,920,6310,492,1435,65,744,3493,6229,75,66
3839,264,21,1170,985,6279,505,1285,183,828,3464,6265,75,67
2510,320,10,1279,1078,5197,435,1176,124,854,2471,5060,75,68
532,183,6,1120,678,2519,138,961,106,442,796,2443,75,69
310,120,0,855,338,1623,71,460,39,434,567,1571,75,70
3121,179,0,1063,667,5030,433,1085,32,638,2801,4989,75,71
4261,226,1,1347,825,6660,483,1337,51,799,3857,6527,75,72
4219,220,4,1416,1000,6859,503,1453,111,802,3949,6818,75,73
3859,250,1,1583,1038,6731,467,1455,116,841,3685,6564,75,74
2460,340,9,1232,1135,5176,416,1167,221,875,2429,5108,75,75
582,288,6,2079,665,3620,143,1112,227,594,1353,3429,75,76
381,127,8,1233,588,2337,95,762,38,429,944,2268,75,77
3273,219,3,1157,783,5435,464,988,39,746,2985,5222,75,78
4394,220,4,1379,865,6862,521,1443,43,796,3946,6749,75,79
4273,230,4,1777,1336,7620,496,1858,69,901,4120,7444,75,80
3933,247,5,1598,1053,6836,490,1515,62,880,3715,6662,75,81
2638,296,10,2001,1504,6449,487,1778,156,939,2982,6342,75,82
512,281,11,1505,785,3094,114,1097,165,485,1177,3038,75,83
632,171,6,3381,610,4800,124,1194,33,792,2743,4886,75,84
3177,230,3,2075,1110,6595,470,1196,255,791,3526,6238,75,85
4010,221,1,1871,1134,7237,507,1650,49,852,3968,7026,75,86
3696,199,3,1466,840,6204,448,1274,62,847,3319,5950,75,87
3340,242,16,1514,820,5932,422,1240,67,792,3248,5769,75,88
2327,288,9,2623,1104,6351,377,1482,139,1032,3192,6222,75,89
818,276,6,3779,1151,6030,174,1879,157,966,2982,6158,75,90
417,261,5,1740,700,3123,114,935,50,680,1465,3244,75,91
2892,259,7,1926,806,5890,417,1418,87,737,2968,5627,75,92
4121,227,5,1280,856,6489,464,1296,46,743,3801,6350,75,93
3996,202,3,1206,1047,6454,509,1443,55,754,3576,6337,75,94
3995,235,5,1560,1236,7031,522,1783,55,877,3689,6926,75,95
2692,298,10,1534,1145,5679,475,1320,178,904,2707,5584,75,96
711,298,18,2164,646,3837,148,1181,150,770,1498,3747,75,97
643,191,6,1877,779,3496,111,1231,35,821,1437,3635,75,98
3117,229,7,1148,679,5180,468,925,63,833,2788,5077,75,99
4156,286,9,1269,973,6693,495,1258,237,844,3768,6602,75,100
4116,228,2,1428,853,6627,554,1306,59,867,3743,6529,75,101
3937,258,10,1151,886,6242,521,1280,85,868,3400,6154,75,102
2609,328,6,1230,1089,5262,475,1287,134,871,2439,5206,75,103
788,287,13,2263,1152,4503,206,1578,187,853,1664,4488,75,104
469,215,2,1856,573,3115,132,768,64,721,1470,3155,75,105
3279,231,6,1155,1030,5701,499,1299,80,709,2930,5517,75,106
4227,238,5,1299,786,6555,565,1399,44,805,3704,6517,75,107
4282,216,8,1342,845,6693,584,1420,113,837,3691,6645,75,108
4040,235,3,1251,911,6440,590,1446,91,815,3541,6483,75,109
2544,289,15,1321,1043,5212,494,1264,133,906,2445,5242,75,110
689,334,9,3104,966,5102,148,1871,295,649,1944,4907,75,111
394,181,4,1251,449,2279,205,642,39,1029,1091,3006,75,112
3279,230,1,1185,700,5395,510,873,56,794,3081,5314,75,113
4308,245,4,1201,998,6756,543,1455,58,768,3862,6686,75,114
4182,212,4,1297,1010,6705,529,1524,57,833,3783,6726,75,115
4253,273,16,1516,961,7019,503,1492,104,985,3681,6765,75,116
2624,319,11,1295,1546,5795,476,1654,172,810,2552,5664,75,117
631,276,4,1467,718,3096,136,921,245,669,1152,3123,75,118
392,219,4,1428,796,2839,105,1076,113,587,1098,2979,75,119
3344,192,2,1056,751,5345,521,933,37,791,2975,5257,75,120
4348,218,2,1193,790,6551,554,1231,60,818,3868,6531,75,121
4269,238,9,1266,832,6614,535,1317,68,789,3780,6489,75,122
3945,267,2,1214,773,6201,509,1304,83,853,3461,6210,75,123
2621,362,15,1346,1061,5405,493,1216,155,910,2580,5354,75,124
692,230,10,1623,819,3374,134,1181,153,633,1287,3388,75,125
395,200,3,1156,414,2168,92,820,47,501,788,2248,75,126
3235,216,1,1158,715,5325,505,973,63,751,3045,5337,75,127
4469,229,1,1251,1261,7211,552,1657,74,735,4013,7031,75,128
4389,253,1,1316,1169,7128,577,1642,115,893,3752,6979,75,129
3879,224,2,1175,794,6074,516,1310,62,850,3354,6092,75,130
2546,283,5,1149,833,4816,462,997,127,823,2406,4815,75,131
801,265,25,1861,607,3559,143,893,167,819,1655,3677,75,132
398,220,7,1155,379,2159,123,534,33,602,1007,2299,75,133
3353,201,1,1282,773,5610,531,1017,50,809,3157,5564,75,134
4366,225,1,1191,807,6590,548,1235,54,886,3813,6536,75,135
4193,210,6,1270,941,6620,536,1380,83,802,3745,6546,75,136
3953,276,1,1413,869,6512,542,1392,79,835,3531,6379,75,137
2626,332,10,1312,965,5245,513,1075,143,1058,2543,5332,75,138
706,278,11,1437,705,3137,145,970,152,678,1250,3195,75,139
541,242,3,1365,556,2707,111,714,60,729,1174,2788,75,140
3432,242,1,1115,849,5639,546,1074,53,829,3115,5617,75,141
4435,237,3,1279,942,6896,577,1382,63,874,4026,6922,75,142
4348,219,8,1454,849,6878,560,1396,72,878,3937,6843,75,143
3788,234,1,1312,863,6198,539,1221,65,906,3428,6159,75,144
2410,341,13,1383,1140,5287,444,1208,162,1047,2253,5114,75,145
742,328,14,2129,1000,4213,148,1545,249,769,1382,4093,75,146
490,330,1,1841,660,3322,135,979,139,703,1463,3419,75,147
475,253,2,1249,393,2372,132,646,36,689,1017,2520,75,148
4114,259,4,1209,955,6541,563,1093,161,821,3841,6479,75,149
4313,210,2,1263,799,6587,574,1254,59,899,3822,6608,75,150
4197,240,2,1396,963,6798,562,1385,66,958,3690,6661,75,151
2719,340,14,1377,1006,5456,484,1264,175,910,2477,5310,75,152
639,277,7,1820,839,3582,140,1118,135,811,1373,3577,75,153
463,197,2,1391,478,2531,124,751,38,644,1127,2684,75,154
3693,251,5,1151,814,5914,540,1129,51,790,3344,5854,75,155
4953,241,4,1304,984,7486,610,1483,57,944,4373,7467,75,156
4761,199,10,1436,943,7349,584,1419,54,903,4345,7305,75,157
4329,248,1,1316,1163,7057,574,1551,67,940,3872,7004,75,158
2915,386,17,1496,1550,6364,536,1616,238,985,2748,6123,75,159
739,406,9,3483,1573,6210,145,2922,276,810,1857,6010,75,160
463,240,2,2043,668,3416,127,1188,67,658,1504,3544,75,161
3799,188,3,1331,791,6112,593,1062,54,908,3444,6061,75,162
4728,258,3,1438,963,7390,591,1355,58,870,4399,7273,75,163
4704,326,2,1444,1111,7587,597,1489,236,917,4239,7478,75,164
4371,245,12,1419,929,6976,574,1439,69,981,3824,6887,75,165
2749,344,7,1444,1328,5872,527,1258,98,1024,2662,5569,75,166
659,350,24,2036,974,4043,184,1531,189,796,1433,4133,75,167
406,277,3,1419,519,2624,132,775,48,713,1175,2843,75,168
3527,239,3,1390,847,6006,554,1089,50,836,3282,5811,75,169
4540,262,3,1465,1065,7335,612,1452,84,969,4100,7217,75,170
1409,296,1,1623,807,4136,373,1173,61,762,1605,3974,75,171
4044,367,3,1471,925,6810,548,1319,70,939,3831,6707,75,172
2711,318,9,1306,964,5308,468,1178,140,838,2512,5136,75,173
621,450,11,1565,979,3626,161,1334,250,782,1089,3616,75,174
456,237,7,1112,560,2372,154,658,134,608,861,2415,75,175
3630,254,7,1270,769,5930,558,1085,58,850,3321,5872,75,176
4873,263,5,1351,844,7336,623,1321,67,863,4369,7243,75,177
4871,241,4,1431,952,7499,609,1479,53,995,4222,7358,75,178
4336,316,2,1601,980,7235,572,1443,100,1005,4004,7124,75,179
2741,383,14,1524,1046,5708,499,1243,183,963,2805,5693,75,180
671,337,13,1721,793,3535,140,1111,123,784,1424,3582,75,181
434,207,7,1186,481,2315,97,704,114,577,885,2377,75,182
3558,225,0,1531,1081,6395,569,1267,58,872,3492,6258,75,183
4394,295,1,1477,1161,7328,575,1513,160,898,4118,7264,75,184
3504,310,3,1554,1351,6722,530,1523,126,1223,3244,6646,75,185
803,1840,69,2097,2227,7036,173,3303,278,1001,1420,6175,75,186
1744,316,12,1505,880,4457,403,1134,125,836,1997,4495,75,187
595,293,12,1638,617,3155,147,1096,146,721,1091,3201,75,188
420,257,1,1230,394,2302,118,670,36,546,1025,2395,75,189
3377,264,1,1305,776,5723,525,1123,35,857,3141,5681,75,190
4102,228,1,1205,843,6379,630,1225,51,874,3590,6370,75,191
3922,206,4,1283,927,6342,642,1108,39,869,3571,6229,75,192
3671,318,5,1456,934,6384,592,1296,79,837,3544,6348,75,193
2584,370,5,1312,1127,5398,471,1261,200,886,2475,5293,75,194
686,425,18,1947,1514,4590,170,2152,191,751,1344,4608,75,195
379,251,3,1107,473,2213,130,706,64,599,937,2436,75,196
3550,202,5,1214,731,5702,527,1013,49,815,3234,5638,75,197
4543,229,3,1222,1009,7006,590,1451,61,888,3988,6978,75,198
4471,245,1,1248,812,6777,585,1138,57,873,4058,6711,75,199
4168,290,1,1488,937,6884,617,1346,63,942,3824,6792,75,200
2636,386,14,1455,1243,5734,534,1298,305,903,2530,5570,75,201
686,377,15,1740,1480,4298,182,1781,180,768,1322,4233,75,202
437,222,4,1595,465,2723,119,948,44,703,1092,2906,75,203
3453,237,3,1229,1033,5955,493,1313,61,792,3196,5855,75,204
4598,257,2,1493,1001,7351,582,1393,52,970,4328,7325,75,205
4171,237,0,1578,1210,7196,603,1581,117,948,3842,7091,75,206
4020,296,1,1623,870,6810,585,1422,49,902,3789,6747,75,207
2614,342,6,1448,1076,5486,512,1136,190,924,2621,5383,75,208
705,420,7,1949,1144,4225,154,1458,279,770,1438,4099,75,209
458,255,1,1429,585,2728,136,816,87,699,1131,2869,75,210
3396,224,5,1437,1334,6396,550,1190,397,793,3225,6155,75,211
4546,227,2,1319,912,7006,587,1295,44,919,4098,6943,75,212
4342,253,9,1372,864,6840,663,1331,56,935,3750,6735,75,213
3873,304,3,1468,955,6603,533,1301,71,870,3604,6379,75,214
2714,374,16,1642,1493,6239,445,1827,280,894,2454,5900,75,215
874,285,16,2360,662,4197,170,1579,196,721,1514,4180,75,216
562,254,22,1702,511,3051,125,821,57,758,1498,3259,75,217
3299,257,5,1211,844,5616,518,1078,43,829,3075,5543,75,218
4323,246,1,1387,1066,7023,565,1399,63,878,3983,6888,75,219
4221,244,9,1352,958,6784,586,1263,78,869,3931,6727,75,220
3598,200,2,1234,860,5894,532,1040,127,816,3382,5897,75,221
2161,345,4,1005,948,4463,405,954,214,704,2018,4295,75,222
585,345,9,1831,927,3697,146,1184,179,729,1486,3724,75,223
545,211,4,1363,646,2769,111,899,42,643,1245,2940,75,224
3307,248,3,1262,728,5548,538,954,44,804,3143,5483,75,225
4265,223,1,1390,916,6795,555,1126,52,905,4020,6658,75,226
4089,238,3,1411,1002,6743,563,1248,53,895,3897,6656,75,227
3572,236,5,1414,966,6193,516,1159,81,924,3443,6123,75,228
2525,391,8,1315,946,5185,476,1049,202,879,2495,5101,75,229
584,449,18,1640,905,3596,165,1078,258,761,1341,3603,75,230
358,184,1,1268,505,2316,115,666,49,589,993,2412,75,231
3268,215,2,1174,661,5320,485,882,38,768,3047,5220,75,232
4208,245,7,1371,951,6782,532,1351,71,887,3830,6671,75,233
4065,232,11,1390,956,6654,559,1251,125,857,3674,6466,75,234
3588,228,3,1466,843,6128,529,1137,69,787,3539,6061,75,235
2517,357,5,1190,1188,5257,445,1289,166,886,2362,5148,75,236
732,347,7,1839,870,3795,156,1361,184,763,1459,3923,75,237
490,186,2,1420,474,2572,145,818,43,615,1079,2700,75,238
3340,180,2,1107,1009,5638,495,1213,34,705,3086,5533,75,239
4531,239,3,1134,1149,7056,563,1458,59,891,4006,6977,75,240
4337,209,1,1210,1024,6781,557,1422,53,830,3777,6639,75,241
3825,282,0,1222,909,6238,498,1141,157,845,3389,6030,75,242
2298,340,5,1157,994,4794,380,1071,199,990,2147,4787,75,243
660,306,3,2146,664,3779,153,1244,174,781,1492,3844,75,244
410,186,2,1608,564,2770,122,775,63,662,1337,2959,75,245
440,194,5,1104,484,2227,131,568,35,638,973,2345,75,246
4187,226,1,1172,800,6386,547,1075,24,819,3842,6307,75,247
4328,239,8,1217,860,6652,561,1308,42,796,3857,6564,75,248
4080,240,2,1209,830,6361,545,1253,61,831,3571,6261,75,249
2642,319,4,1164,992,5121,476,1025,136,828,2491,4956,75,250
552,320,6,1579,974,3431,173,977,398,784,1213,3545,75,251
428,240,1,1202,537,2408,250,741,42,1132,943,3108,75,252
3560,251,6,1121,902,5840,535,1049,75,840,3172,5671,75,253
4692,258,3,1294,1029,7276,589,1320,63,821,4283,7076,75,254
4494,243,4,1298,1086,7125,582,1484,63,830,4035,6994,75,255
4194,236,5,1328,1000,6763,572,1475,67,970,3631,6715,75,256
2724,380,5,1236,1239,5584,496,1300,208,921,2621,5546,75,257
568,272,5,1681,776,3302,129,1067,180,654,1098,3128,75,258
428,168,1,1300,412,2309,97,583,34,538,1020,2272,75,259
3554,214,1,1231,766,5766,530,1031,59,810,3253,5683,75,260
4764,235,1,1234,896,7130,573,1275,53,878,4261,7040,75,261
4492,247,1,1235,933,6908,560,1382,108,851,3946,6847,75,262
4184,219,0,1328,1175,6906,564,1648,58,913,3634,6817,75,263
2723,403,5,1278,1160,5569,506,1263,218,903,2677,5567,75,264
698,383,13,1918,1166,4178,163,1614,287,814,1369,4247,75,265
399,222,2,1331,509,2463,105,711,52,632,1126,2626,75,266
3584,192,4,1255,832,5867,537,987,47,859,3355,5785,75,267
4640,237,2,1333,1104,7316,586,1415,75,784,4274,7134,75,268
4554,242,1,1299,1232,7328,564,1636,76,915,4085,7276,75,269
4023,302,3,1430,1015,6773,960,1319,138,858,3618,6893,75,270
2681,325,7,1215,1474,5702,449,1385,373,947,2595,5749,75,271
677,350,5,2329,1159,4520,155,1905,201,759,1472,4492,75,272
434,197,3,1495,600,2729,118,946,65,588,1122,2839,75,273
3604,196,2,1147,787,5736,523,1005,81,834,3217,5660,75,274
4645,224,10,1220,844,6943,599,1307,65,803,4042,6816,75,275
4543,243,24,1220,980,7010,598,1293,86,888,4139,7004,75,276
3936,286,26,1400,925,6573,543,1287,104,947,3704,6585,75,277
2673,354,17,1312,1085,5441,534,1132,221,955,2698,5540,75,278
649,372,7,1761,1055,3844,170,1347,162,821,1408,3908,75,279
448,227,2,1295,517,2489,127,741,41,685,1047,2641,75,280
3632,211,5,1248,818,5914,540,1051,48,865,3326,5830,75,281
4767,228,4,1311,917,7227,579,1335,39,867,4382,7202,75,282
4587,263,4,1295,1024,7173,573,1434,100,951,4286,7344,75,283
4078,268,4,1306,1149,6805,566,1494,65,926,3802,6853,75,284
2571,316,17,1291,1158,5353,503,1248,168,980,2623,5522,75,285
36,0,0,2,7,45,26,4,0,4,4,38,75,286
0,0,0,0,0,0,1,1,0,0,1,3,75,287
0,0,0,0,0,0,2,0,3,0,0,5,75,288
4629,218,6,1266,1114,7233,558,1464,70,880,4173,7145,75,289
4549,242,12,1467,1021,7291,597,1493,86,916,4196,7288,75,290
4104,274,2,1326,1286,6992,551,1680,91,823,3844,6989,75,291
2636,348,4,1564,1081,5633,471,1286,158,968,2797,5680,75,292
718,349,3,1766,1008,3844,174,1326,208,852,1305,3865,75,293
418,220,1,1525,603,2767,109,1044,28,682,1083,2946,75,294
3508,203,0,1121,861,5693,513,1148,55,711,3335,5762,75,295
4700,231,0,1285,890,7106,521,1424,50,953,4334,7282,75,296
4708,204,4,1293,1229,7438,575,1727,68,933,4353,7656,75,297
4256,275,1,1338,1156,7026,567,1648,79,877,3927,7098,75,298
2778,342,7,1315,1088,5530,479,1251,187,915,2808,5640,75,299
695,396,8,1857,1072,4028,151,1243,236,966,1472,4068,75,300
835,278,0,1412,714,3239,179,834,218,811,1317,3359,75,301
3530,200,0,1162,849,5741,490,1056,53,760,3365,5724,75,302
4475,270,1,1401,1636,7783,588,2154,62,975,4055,7834,75,303
4547,231,0,1370,1049,7197,575,1556,50,923,4199,7303,75,304
3771,304,2,1151,1207,6435,544,1366,99,736,3799,6544,75,305
2655,349,7,1257,1027,5295,490,1158,162,938,2653,5401,75,306
625,379,12,1952,1196,4164,155,1629,205,882,1385,4256,75,307
475,237,3,1142,613,2470,165,742,39,764,1089,2799,75,308
3601,187,0,1167,998,5953,634,1076,35,911,3297,5953,75,309
3443,232,2,1186,896,5759,587,831,54,1066,3233,5771,75,310
3813,205,2,1169,1203,6392,555,1400,71,920,3475,6421,75,311
4013,221,5,1193,906,6338,578,1104,68,946,3740,6436,75,312
2718,286,6,1291,1465,5766,487,1506,173,975,2688,5829,75,313
583,236,0,1439,560,2818,150,737,144,669,1140,2840,75,314
372,138,1,1035,372,1918,74,545,103,489,798,2009,75,315
1518,183,4,922,588,3215,370,661,32,595,1446,3104,75,316
4555,217,1,1222,906,6901,586,1115,44,940,4171,6856,75,317
4594,224,2,1234,1262,7316,603,1620,53,852,4174,7302,75,318
4140,196,1,1175,914,6426,561,1176,67,957,3677,6438,75,319
2795,273,7,1147,1033,5255,491,1050,153,879,2625,5198,75,320
663,295,4,1696,727,3385,142,817,164,757,1558,3438,75,321
452,193,0,1218,655,2518,158,765,68,683,992,2666,75,322
3566,207,0,1083,816,5672,529,920,45,829,3347,5670,75,323
4820,213,1,1231,914,7179,581,1205,54,901,4400,7141,75,324
4591,199,1,1221,912,6924,583,1352,74,835,4053,6897,75,325
4109,200,3,1199,1322,6833,558,1635,71,884,3672,6820,75,326
2594,279,8,1019,1060,4960,459,1096,204,867,2473,5099,75,327
541,301,7,1504,1172,3525,168,1297,216,693,1258,3632,75,328
373,146,5,1344,478,2346,103,668,26,622,1203,2622,75,329
3251,198,3,1177,893,5522,510,960,88,880,3149,5587,75,330
3499,224,2,1368,1000,6093,505,1350,68,971,3551,6445,75,331
2305,310,0,1542,921,5078,468,1190,71,1443,2361,5533,75,332
237,264,1,472,250,1224,107,266,17,773,554,1717,75,333
1023,258,8,2093,655,4037,235,1022,100,670,1747,3774,75,334
604,289,6,1600,742,3241,129,925,109,626,1184,2973,75,335
391,208,1,1220,721,2541,108,709,32,486,907,2242,75,336
3345,202,2,1086,772,5407,462,897,17,740,3056,5172,75,337
4511,226,0,1238,1231,7206,549,1509,42,802,4190,7092,75,338
4470,192,0,1273,894,6829,543,1346,38,925,3962,6814,75,339
3887,207,1,1203,1090,6388,516,1539,66,734,3475,6330,75,340
2481,266,4,1078,1010,4839,443,1039,152,774,2342,4750,75,341
592,240,6,1494,1129,3461,127,1299,187,661,1160,3434,75,342
389,165,10,1323,710,2597,111,916,75,550,1053,2705,75,343
3434,185,3,968,769,5359,495,968,45,712,3164,5384,75,344
4743,216,12,1268,825,7064,570,1320,75,847,4287,7099,75,345
4442,214,14,1198,844,6712,519,1414,61,795,3975,6764,75,346
4117,204,5,1364,1134,6824,543,1576,86,884,3726,6815,75,347
2623,284,11,1252,1106,5276,471,1263,191,925,2511,5361,75,348
744,266,10,1720,1533,4273,157,1726,193,808,1324,4208,75,349
416,164,2,997,644,2223,116,789,55,656,896,2512,75,350
3220,173,2,1101,707,5203,498,913,33,785,2994,5223,75,351
4371,214,12,1358,1206,7161,543,1455,256,881,4048,7183,75,352
4036,224,6,1372,939,6577,529,1232,106,884,3846,6597,75,353
3567,215,4,1315,1199,6300,521,1475,51,882,3361,6290,75,354
2284,335,6,1194,1359,5178,429,1459,171,943,2142,5144,75,355
455,257,4,1476,785,2977,134,986,164,695,1166,3145,75,356
367,140,3,1500,865,2875,95,1276,24,566,1129,3090,75,357
2048,176,1,1818,937,4980,412,1187,54,945,2561,5159,75,358
944,134,3,850,326,2257,245,435,16,875,1080,2651,75,359
149,140,3,400,233,925,62,226,17,355,374,1034,75,360
1454,171,2,1492,887,4006,278,984,40,653,1834,3789,75,361
1401,289,12,1681,851,4234,250,943,88,744,1912,3937,75,362
426,217,4,1559,754,2960,125,977,118,513,1117,2850,75,363
388,170,2,1294,520,2374,96,645,62,507,1123,2433,75,364
1993,227,11,1730,1062,5023,351,1272,62,829,2400,4914,75,365
1719,662,138,1673,781,4973,315,622,378,1020,2216,4551,75,366
104,257,12,418,362,1153,57,239,14,327,392,1029,76,1
585,368,58,675,865,2551,452,398,52,581,853,2336,76,2
844,444,5,1056,1013,3362,804,414,4,612,1127,2961,76,3
829,400,13,776,1287,3305,811,375,15,590,1088,2879,76,4
656,586,42,748,1345,3377,789,631,50,609,1054,3133,76,5
151,407,62,719,538,1877,87,482,57,589,611,1826,76,6
131,367,18,863,596,1975,91,321,20,671,649,1752,76,7
839,463,20,808,1521,3651,944,524,19,735,1048,3270,76,8
1031,279,6,816,1258,3390,974,328,6,736,1013,3057,76,9
1071,584,7,875,1644,4181,974,576,13,818,1297,3678,76,10
987,555,13,801,1672,4028,981,572,13,766,1243,3575,76,11
688,494,46,860,1514,3602,826,541,57,784,1023,3231,76,12
169,565,84,1052,760,2630,99,616,42,726,1106,2589,76,13
139,366,10,753,560,1828,72,357,12,640,646,1727,76,14
211,406,10,828,538,1993,180,437,14,609,634,1874,76,15
408,343,13,567,652,1983,296,433,18,468,632,1847,76,16
910,495,14,924,1422,3765,564,580,13,1033,1198,3388,76,17
1057,588,7,806,1625,4083,942,643,11,748,1333,3677,76,18
423,493,58,635,714,2323,252,595,41,494,783,2165,76,19
185,560,61,968,792,2566,100,649,60,745,899,2453,76,20
122,301,8,834,655,1920,85,371,9,719,599,1783,76,21
932,406,3,789,1477,3607,978,439,5,733,1111,3266,76,22
1179,518,27,832,1588,4144,1015,571,25,803,1284,3698,76,23
1115,630,20,1170,1431,4366,990,627,25,816,1373,3831,76,24
1050,558,7,772,1568,3955,980,560,11,758,1173,3482,76,25
583,796,88,952,1218,3637,522,811,41,807,1090,3271,76,26
183,717,67,942,812,2721,124,637,53,690,934,2438,76,27
143,541,12,772,520,1988,77,390,12,632,608,1719,76,28
850,488,6,777,1555,3676,904,429,10,653,1070,3066,76,29
1133,498,3,848,1643,4125,1030,522,10,831,1201,3594,76,30
1122,580,32,911,1668,4313,950,575,38,791,1242,3596,76,31
1018,700,5,904,1680,4307,952,569,11,795,1300,3627,76,32
713,569,67,923,1562,3834,744,672,53,739,1117,3325,76,33
160,634,62,965,759,2580,108,541,66,675,767,2157,76,34
122,324,11,741,547,1745,66,258,13,534,509,1380,76,35
886,453,23,824,1506,3692,976,459,22,754,991,3202,76,36
1093,585,13,879,1647,4217,1024,578,16,745,1308,3671,76,37
1119,602,10,1167,1328,4226,945,565,8,800,1292,3610,76,38
1045,664,18,818,1673,4218,972,597,20,729,1271,3589,76,39
721,813,92,902,1590,4118,893,744,58,764,1257,3716,76,40
190,616,105,1031,894,2836,119,742,75,790,985,2711,76,41
124,466,19,804,655,2068,88,357,26,665,738,1874,76,42
826,433,18,800,1528,3605,908,439,12,624,1101,3084,76,43
1104,574,13,831,1629,4151,872,635,12,712,1292,3523,76,44
1150,627,11,1040,1388,4216,729,586,19,869,1358,3561,76,45
1004,631,12,953,1590,4190,982,559,15,725,1246,3527,76,46
576,823,59,902,1160,3520,488,768,60,721,1030,3067,76,47
163,624,97,950,791,2625,115,622,63,772,939,2511,76,48
120,481,21,854,572,2048,89,383,23,671,712,1878,76,49
317,434,7,820,710,2288,286,381,9,712,778,2166,76,50
1030,576,63,810,1640,4119,980,569,60,807,1240,3656,76,51
1054,620,21,949,1677,4321,998,607,20,803,1332,3760,76,52
1104,616,11,886,1614,4231,979,570,16,700,1231,3496,76,53
665,678,157,908,1513,3921,845,834,85,784,1072,3620,76,54
260,613,102,949,872,2796,161,711,76,762,896,2606,76,55
136,404,48,717,646,1951,93,390,44,633,605,1765,76,56
861,527,7,780,1553,3728,946,476,5,662,1084,3173,76,57
1110,568,30,855,1600,4163,990,528,28,785,1285,3616,76,58
1118,528,16,1273,1335,4270,939,528,24,850,1273,3614,76,59
1004,606,9,827,1712,4158,964,573,7,769,1233,3546,76,60
743,844,78,899,1635,4199,797,846,64,748,1285,3740,76,61
189,673,97,866,710,2535,110,704,67,698,849,2428,76,62
138,397,14,812,617,1978,84,354,19,726,682,1865,76,63
810,623,11,770,1357,3571,798,582,12,631,1105,3128,76,64
1101,438,24,724,1455,3742,800,564,25,550,1227,3166,76,65
1072,464,5,816,1131,3488,663,605,16,700,1237,3221,76,66
1047,686,24,903,1494,4154,882,774,29,692,1356,3733,76,67
798,655,122,819,1511,3905,794,859,63,752,1222,3690,76,68
212,509,78,1003,697,2499,101,595,73,830,843,2442,76,69
148,425,19,879,635,2106,85,438,23,725,691,1962,76,70
914,520,20,877,1559,3890,935,598,15,706,1206,3460,76,71
1058,756,37,951,1602,4404,972,748,39,827,1404,3990,76,72
1072,753,11,1263,1453,4552,1050,857,18,869,1505,4299,76,73
850,798,22,1013,1358,4041,657,804,46,943,1532,3982,76,74
618,854,81,978,1202,3733,581,931,72,848,1279,3711,76,75
317,917,124,1640,1086,4084,239,1068,87,1575,1422,4391,76,76
148,500,23,876,725,2272,111,493,33,787,796,2220,76,77
809,477,25,805,1523,3639,948,556,31,749,1143,3427,76,78
1043,544,30,830,1610,4057,987,588,37,858,1361,3831,76,79
1054,797,14,1188,1353,4406,1040,855,19,846,1381,4141,76,80
990,638,11,761,1648,4048,995,704,12,739,1511,3961,76,81
690,749,86,866,1555,3946,843,889,43,815,1302,3892,76,82
112,605,61,905,789,2472,97,860,60,760,918,2695,76,83
152,376,5,1019,629,2181,64,494,9,790,850,2207,76,84
777,391,10,894,1445,3517,924,543,20,759,1159,3405,76,85
1023,541,13,829,1574,3980,1037,658,19,718,1362,3794,76,86
997,616,3,856,1442,3914,975,721,7,780,1379,3862,76,87
861,654,7,991,1581,4094,1014,687,9,810,1480,4000,76,88
603,724,123,1020,1559,4029,833,1067,41,867,1282,4090,76,89
202,639,58,1234,840,2973,112,917,54,965,1152,3200,76,90
138,344,16,971,548,2017,110,449,24,704,742,2029,76,91
702,389,5,853,1360,3309,853,553,7,677,1071,3161,76,92
1017,437,23,894,1558,3929,1024,649,19,767,1312,3771,76,93
1045,518,9,801,1520,3893,932,710,9,712,1339,3702,76,94
958,528,24,861,1573,3944,973,737,24,795,1327,3856,76,95
554,603,93,1058,1178,3486,606,997,58,803,1147,3611,76,96
265,693,65,1220,988,3231,179,980,34,1003,1122,3318,76,97
337,390,19,1010,655,2411,154,446,15,1008,774,2397,76,98
745,416,5,867,1280,3313,950,457,10,669,1044,3130,76,99
948,529,14,779,1455,3725,1004,708,18,794,1271,3795,76,100
971,504,11,835,1513,3834,993,594,12,807,1323,3729,76,101
896,553,25,865,1473,3812,984,625,30,747,1245,3631,76,102
654,765,89,849,1464,3821,819,939,41,752,1301,3852,76,103
197,777,77,1016,910,2977,118,906,81,907,1169,3181,76,104
155,610,7,916,593,2281,89,472,8,794,946,2309,76,105
642,401,4,812,1009,2868,567,537,11,696,978,2789,76,106
852,533,12,788,977,3162,550,694,19,707,1113,3083,76,107
871,528,5,793,1035,3232,594,657,9,754,872,2886,76,108
799,752,3,868,1020,3442,613,817,8,726,1311,3475,76,109
491,613,115,829,1163,3211,502,939,46,713,1092,3292,76,110
169,814,68,1134,1050,3235,93,1002,83,811,1393,3382,76,111
141,289,5,858,479,1772,83,341,10,642,700,1776,76,112
711,628,5,769,1351,3464,958,572,5,646,1147,3328,76,113
963,462,16,784,1619,3844,948,699,21,740,1287,3695,76,114
937,495,15,796,1591,3834,978,745,12,782,1273,3790,76,115
889,660,10,903,1536,3998,1003,790,11,795,1271,3870,76,116
640,909,87,823,1522,3981,882,1012,54,767,1369,4084,76,117
187,576,82,976,762,2583,132,826,115,844,814,2731,76,118
172,504,11,817,615,2119,94,495,46,736,850,2221,76,119
740,385,8,742,1330,3205,895,475,9,601,1062,3042,76,120
1006,439,4,753,1455,3657,986,620,7,712,1168,3493,76,121
1033,588,5,741,1559,3926,965,580,10,695,1366,3616,76,122
933,534,10,786,1492,3755,910,646,12,738,1305,3611,76,123
658,848,86,827,1533,3952,872,1055,74,731,1296,4028,76,124
176,525,55,845,698,2299,117,643,50,754,764,2328,76,125
135,377,11,832,503,1858,108,459,22,716,644,1949,76,126
756,350,7,691,1288,3092,841,485,9,642,1073,3050,76,127
992,646,9,703,1521,3871,925,818,14,710,1251,3718,76,128
1010,664,10,1146,1220,4050,944,839,11,754,1332,3880,76,129
938,549,9,784,1461,3741,918,677,10,743,1375,3723,76,130
611,597,72,844,1360,3484,871,690,41,709,1118,3429,76,131
228,682,77,940,743,2670,125,776,41,929,803,2674,76,132
130,294,5,715,493,1637,74,397,6,588,569,1634,76,133
783,464,10,603,1343,3203,877,531,13,568,1092,3081,76,134
1035,429,9,703,1408,3584,957,572,16,658,1270,3473,76,135
1064,474,9,803,1304,3654,904,666,18,655,1126,3369,76,136
919,561,22,777,1456,3735,935,678,32,673,1316,3634,76,137
656,639,83,798,1335,3511,862,750,48,705,1186,3551,76,138
169,670,111,818,674,2442,119,727,69,715,851,2481,76,139
160,368,5,777,509,1819,116,380,9,754,734,1993,76,140
846,435,3,640,1448,3372,966,574,7,574,1206,3327,76,141
1030,649,19,755,1476,3929,981,872,24,709,1323,3909,76,142
1067,502,36,1128,1161,3894,992,614,39,764,1408,3817,76,143
908,499,22,736,1345,3510,866,587,23,668,1232,3376,76,144
564,626,85,871,1375,3521,717,986,69,723,1023,3518,76,145
207,557,62,1034,735,2595,123,809,44,713,903,2592,76,146
137,496,13,825,548,2019,100,530,17,662,808,2117,76,147
148,238,9,566,437,1398,97,323,6,509,489,1424,76,148
943,409,12,686,1376,3426,949,501,13,651,1206,3320,76,149
1032,396,19,907,1317,3671,988,494,19,882,1240,3623,76,150
927,530,6,756,1411,3630,938,561,9,682,1262,3452,76,151
638,596,59,780,1477,3550,847,843,51,721,1138,3600,76,152
176,631,76,913,730,2526,181,731,54,860,871,2697,76,153
134,326,3,823,498,1784,114,364,3,652,671,1804,76,154
891,338,5,706,1430,3370,1000,565,7,666,1034,3272,76,155
980,423,4,761,1066,3234,648,636,10,638,1260,3192,76,156
1060,435,13,756,1373,3637,945,542,13,684,1279,3463,76,157
1003,637,7,763,1756,4166,964,1018,10,679,1343,4014,76,158
672,746,85,873,1576,3952,904,1093,99,1004,1141,4241,76,159
174,1204,165,1083,1152,3778,143,1284,87,1484,1595,4593,76,160
138,633,15,1027,838,2651,114,809,21,805,1042,2791,76,161
818,396,4,744,1214,3176,847,482,6,687,1086,3108,76,162
1006,616,6,864,1396,3888,874,789,9,738,1301,3711,76,163
1025,622,6,1025,1196,3874,803,821,8,798,1268,3698,76,164
925,612,4,865,1204,3610,834,671,8,664,1295,3472,76,165
673,609,60,925,1317,3584,714,994,49,765,1132,3654,76,166
193,652,79,838,745,2507,111,1069,36,734,812,2762,76,167
141,421,7,797,485,1851,117,427,13,653,780,1990,76,168
725,463,14,730,949,2881,634,539,10,617,1062,2862,76,169
895,604,16,675,1060,3250,548,765,27,640,1179,3159,76,170
289,546,3,823,726,2387,218,666,6,685,935,2510,76,171
804,533,4,770,907,3018,544,640,16,678,1156,3034,76,172
552,632,75,727,913,2899,445,729,55,662,1002,2893,76,173
174,820,123,866,804,2787,122,997,74,778,896,2867,76,174
116,397,3,681,482,1679,95,356,12,613,674,1750,76,175
694,482,5,683,901,2765,595,536,14,589,1021,2755,76,176
931,445,10,746,969,3101,616,578,15,641,1165,3015,76,177
966,431,6,772,1008,3183,643,607,5,723,1197,3175,76,178
870,634,8,831,1045,3388,611,741,11,660,1219,3242,76,179
628,638,78,768,938,3050,543,911,44,637,1103,3238,76,180
200,618,94,944,838,2694,115,856,56,867,827,2721,76,181
123,328,7,680,480,1618,85,432,10,539,562,1628,76,182
662,401,5,827,1069,2964,633,576,4,663,986,2862,76,183
822,427,17,855,1064,3185,662,593,28,626,1119,3028,76,184
694,667,14,908,1117,3400,659,851,18,712,1080,3320,76,185
126,1055,28,936,714,2859,87,1153,53,797,819,2909,76,186
299,495,60,780,873,2507,355,757,46,637,856,2651,76,187
149,469,65,759,625,2067,116,656,55,656,762,2245,76,188
128,297,3,721,484,1633,102,352,7,577,660,1698,76,189
763,351,11,768,881,2774,611,518,12,645,957,2743,76,190
980,604,5,1044,1275,3908,676,820,5,893,1570,3964,76,191
1178,592,30,1108,1370,4278,780,802,36,914,1613,4145,76,192
1184,730,20,1181,1357,4472,814,930,23,970,1742,4479,76,193
674,753,73,1002,1083,3585,602,919,52,725,1158,3456,76,194
178,651,97,906,754,2586,126,879,59,699,855,2618,76,195
139,330,11,813,500,1793,113,396,14,740,600,1863,76,196
711,330,37,868,866,2812,665,437,35,699,931,2767,76,197
926,491,7,754,994,3172,693,736,15,634,1133,3211,76,198
918,411,4,853,958,3144,671,486,5,618,1214,2994,76,199
826,542,10,829,996,3203,645,635,25,643,1174,3122,76,200
529,793,70,739,1297,3428,516,1120,230,626,1002,3494,76,201
166,634,93,869,865,2627,104,972,76,733,869,2754,76,202
138,407,23,807,463,1838,104,435,21,687,736,1983,76,203
704,337,4,730,823,2598,628,460,4,596,867,2555,76,204
962,392,3,862,1016,3235,661,703,5,661,1139,3169,76,205
880,460,5,816,1170,3331,661,697,7,686,1206,3257,76,206
900,466,11,894,1027,3298,639,648,10,666,1205,3168,76,207
573,652,102,913,952,3192,532,978,87,676,1027,3300,76,208
171,618,84,842,640,2355,99,785,110,745,790,2529,76,209
137,468,4,746,534,1889,95,470,27,719,717,2028,76,210
680,441,3,723,951,2798,547,621,17,591,990,2766,76,211
907,396,14,728,885,2930,608,541,14,609,1146,2918,76,212
863,503,6,759,897,3028,591,567,8,643,1270,3079,76,213
823,452,6,730,908,2919,572,537,7,615,1081,2812,76,214
521,596,57,781,914,2869,505,802,49,622,889,2867,76,215
169,511,62,855,656,2253,109,591,48,704,835,2287,76,216
143,332,16,774,537,1802,102,359,16,691,641,1809,76,217
587,414,2,668,868,2539,517,530,2,612,886,2547,76,218
862,455,21,774,1016,3128,547,667,26,731,1130,3101,76,219
822,521,31,783,966,3123,554,561,42,723,1141,3021,76,220
764,431,27,747,825,2794,485,508,30,569,1066,2658,76,221
378,534,53,680,859,2504,395,736,45,530,872,2578,76,222
159,536,47,898,772,2412,110,798,53,762,875,2598,76,223
115,348,4,724,456,1647,101,325,5,611,659,1701,76,224
576,423,20,744,1108,2871,577,614,21,580,917,2709,76,225
815,460,12,801,1003,3091,616,569,12,632,1102,2931,76,226
808,526,13,881,1059,3287,602,623,21,748,1223,3217,76,227
751,547,5,795,1115,3213,646,629,25,663,1198,3161,76,228
589,623,80,1113,1043,3448,489,851,53,884,1045,3322,76,229
163,520,82,972,677,2414,107,655,59,722,903,2446,76,230
137,354,12,879,532,1914,115,387,12,649,810,1973,76,231
606,376,16,740,1018,2756,666,421,15,755,861,2718,76,232
778,512,15,716,1269,3290,694,654,18,707,1107,3180,76,233
714,520,20,722,1244,3220,636,648,26,742,1190,3242,76,234
737,508,31,857,1164,3297,732,555,34,707,1131,3159,76,235
478,756,85,848,1077,3244,557,902,46,759,1061,3325,76,236
192,624,95,925,866,2702,112,904,86,780,908,2790,76,237
128,370,12,926,564,2000,98,433,26,644,803,2004,76,238
749,405,4,699,1566,3423,984,597,6,721,1086,3394,76,239
963,525,7,768,1631,3894,1075,677,8,734,1261,3755,76,240
926,581,6,800,1657,3970,1054,694,15,812,1253,3828,76,241
883,483,7,856,1539,3768,1045,553,10,791,1286,3685,76,242
578,587,61,887,1587,3700,894,899,61,779,998,3631,76,243
153,579,56,963,722,2473,86,794,56,682,947,2565,76,244
153,388,10,893,604,2048,100,521,13,678,815,2127,76,245
132,309,10,682,568,1701,95,424,13,609,627,1768,76,246
970,437,30,839,1610,3886,1116,537,32,862,1176,3723,76,247
964,540,15,806,1580,3905,1118,571,18,767,1294,3768,76,248
919,546,32,818,1697,4012,1154,621,32,808,1286,3901,76,249
623,704,87,896,1646,3956,999,854,63,753,1263,3932,76,250
163,750,88,1075,783,2859,127,959,73,822,1154,3135,76,251
144,382,8,785,562,1881,135,410,9,788,658,2000,76,252
858,407,14,683,1534,3496,1113,544,10,778,1220,3665,76,253
1063,566,25,763,1675,4092,1168,785,27,783,1241,4004,76,254
1065,472,25,875,1682,4119,1183,713,26,785,1326,4033,76,255
1027,782,5,819,1859,4492,1203,811,11,819,1499,4343,76,256
692,785,91,819,1769,4156,991,1050,96,858,1295,4290,76,257
217,669,80,1166,967,3099,165,1047,66,927,1086,3291,76,258
168,488,10,970,588,2224,117,490,13,780,937,2337,76,259
852,382,19,736,1652,3641,1177,528,17,737,1141,3600,76,260
1130,534,13,792,1787,4256,1222,733,12,831,1407,4205,76,261
1118,479,24,1161,1451,4233,1189,720,18,794,1324,4045,76,262
1056,693,7,855,1785,4396,1207,787,9,819,1464,4286,76,263
741,740,84,891,1639,4095,1037,860,81,889,1306,4173,76,264
224,635,101,1229,1027,3216,170,1424,71,893,991,3549,76,265
123,324,29,830,557,1863,112,381,31,702,659,1885,76,266
873,515,15,783,1528,3714,1137,596,13,776,1172,3694,76,267
1137,490,13,793,1752,4185,1227,576,19,762,1496,4080,76,268
1118,552,30,853,1805,4358,1152,741,28,796,1415,4132,76,269
1064,638,11,872,1806,4391,1142,662,13,887,1500,4204,76,270
731,678,86,842,1735,4072,1038,973,79,784,1178,4052,76,271
197,1035,137,1115,945,3429,163,1333,108,885,1171,3660,76,272
136,358,7,833,622,1956,118,428,10,719,764,2039,76,273
863,407,22,705,1636,3633,1153,531,15,753,1157,3609,76,274
1183,531,11,843,1653,4221,1237,699,7,752,1369,4064,76,275
1049,568,9,1214,1389,4229,1139,625,9,801,1475,4049,76,276
930,636,20,888,1777,4251,1157,693,21,834,1455,4160,76,277
673,724,86,891,1735,4109,1077,816,63,807,1291,4054,76,278
214,795,57,1263,1132,3461,163,977,71,1131,1182,3524,76,279
162,359,10,958,670,2159,130,460,11,799,783,2183,76,280
847,548,7,795,1649,3846,1124,617,8,778,1247,3774,76,281
1111,477,13,855,1755,4211,1233,635,15,816,1470,4169,76,282
1077,847,6,1335,1301,4566,1202,845,13,859,1533,4452,76,283
892,729,6,896,1308,3831,769,750,13,819,1494,3845,76,284
529,661,75,1070,1182,3517,566,856,60,874,1132,3488,76,285
248,614,88,1082,834,2866,139,872,70,815,1129,3025,76,286
182,441,21,967,752,2363,107,598,35,791,954,2485,76,287
381,355,14,938,793,2481,342,508,12,647,960,2469,76,288
1060,567,5,864,1777,4273,1210,762,6,856,1517,4351,76,289
1086,697,11,935,1868,4597,1172,758,15,828,1604,4377,76,290
1006,678,10,874,1874,4442,1137,830,8,818,1665,4458,76,291
705,1827,129,1015,3195,6871,1031,1201,61,1881,2674,6848,76,292
237,3080,302,1585,3146,8350,278,1801,180,3806,2935,9000,76,293
143,394,4,1021,852,2414,114,592,10,904,827,2447,76,294
857,425,6,832,1736,3856,1149,576,7,705,1262,3699,76,295
1133,467,14,833,1780,4227,1186,594,15,797,1426,4018,76,296
1082,636,6,1261,1445,4430,1189,744,9,830,1549,4321,76,297
1012,927,22,900,1727,4588,1174,921,29,826,1613,4563,76,298
707,932,110,973,1629,4351,1008,1064,79,795,1306,4252,76,299
225,655,113,1055,891,2939,135,987,102,909,1041,3174,76,300
283,395,4,984,686,2352,120,538,9,870,797,2334,76,301
937,422,14,807,1593,3773,1173,529,18,753,1280,3753,76,302
1058,476,15,872,2041,4462,1199,965,18,856,1365,4403,76,303
967,543,6,863,1819,4198,1154,734,7,826,1443,4164,76,304
866,592,10,828,1734,4030,1080,660,20,859,1429,4048,76,305
636,737,89,879,1633,3974,1010,946,60,778,1131,3925,76,306
204,646,114,897,767,2628,156,823,66,816,932,2793,76,307
144,318,10,832,586,1890,123,349,11,762,737,1982,76,308
713,387,38,813,988,2939,603,519,44,722,1027,2915,76,309
896,1841,91,1064,1011,4903,555,1827,36,870,2017,5305,76,310
886,718,18,1262,2145,5029,910,760,22,1189,1715,4596,76,311
971,506,16,727,1484,3704,1004,589,22,637,1334,3586,76,312
655,706,60,865,1649,3935,1033,876,55,804,1273,4041,76,313
222,659,78,956,788,2703,171,671,71,807,1027,2747,76,314
157,328,18,983,566,2052,112,405,27,710,1001,2255,76,315
315,310,17,835,668,2145,319,416,22,659,812,2228,76,316
1163,485,11,808,1777,4244,1226,660,14,823,1524,4247,76,317
1166,542,9,941,1807,4465,1222,659,14,948,1502,4345,76,318
1080,650,18,909,1779,4436,1158,782,27,806,1638,4411,76,319
789,625,60,852,1664,3990,1023,726,70,884,1371,4074,76,320
189,805,77,1116,862,3049,133,861,59,897,1250,3200,76,321
155,607,7,863,598,2230,120,582,8,711,815,2236,76,322
919,372,26,683,1613,3613,1113,486,29,717,1187,3532,76,323
1108,478,3,867,1742,4198,1216,566,4,888,1523,4197,76,324
1120,459,9,1241,1328,4157,1120,622,11,822,1471,4046,76,325
1067,593,22,813,1782,4277,1155,733,28,800,1470,4186,76,326
729,562,51,813,1547,3702,1048,659,34,772,1178,3691,76,327
184,601,59,957,789,2590,117,762,34,890,858,2661,76,328
179,348,11,808,582,1928,118,421,14,653,699,1905,76,329
741,387,19,804,1567,3518,1028,431,23,760,1023,3265,76,330
750,379,19,857,1497,3502,998,445,27,799,1017,3286,76,331
401,341,9,936,750,2437,433,384,12,635,635,2099,76,332
104,137,4,392,259,896,64,182,9,265,236,756,76,333
182,263,32,595,452,1524,162,468,21,521,611,1783,76,334
122,285,16,614,522,1559,95,470,26,552,616,1759,76,335
123,245,8,571,412,1359,96,380,14,542,624,1656,76,336
788,321,7,675,1565,3356,1038,493,8,710,1082,3331,76,337
1089,369,3,730,1713,3904,1095,602,6,736,1382,3821,76,338
1076,588,15,905,1615,4199,1077,657,20,829,1488,4071,76,339
1069,515,28,780,1686,4078,1033,772,36,715,1537,4093,76,340
733,486,76,776,1594,3665,959,767,49,712,1288,3775,76,341
151,726,80,941,873,2771,104,932,77,754,1122,2989,76,342
130,333,20,757,630,1870,98,435,20,660,749,1962,76,343
889,491,8,712,1467,3567,1018,506,10,657,1229,3420,76,344
1125,530,11,712,1783,4161,1138,713,15,770,1459,4095,76,345
1150,563,13,1141,1189,4056,1061,639,19,695,1511,3925,76,346
1078,759,18,833,1674,4362,1038,859,27,804,1490,4218,76,347
706,629,77,922,1545,3879,975,789,63,807,1285,3919,76,348
186,557,92,955,851,2641,125,864,69,893,948,2899,76,349
124,283,4,837,539,1787,91,385,8,675,627,1786,76,350
848,319,4,671,1303,3145,971,458,7,562,1118,3116,76,351
1034,368,6,716,1548,3672,995,521,13,645,1284,3458,76,352
968,526,3,783,1321,3601,921,561,5,654,1305,3446,76,353
992,561,20,736,1373,3682,982,637,21,691,1284,3615,76,354
601,413,42,749,1209,3014,784,630,45,608,836,2903,76,355
122,328,32,701,479,1662,85,421,35,548,622,1711,76,356
102,202,32,582,352,1270,76,273,27,402,428,1206,76,357
308,225,8,587,601,1729,302,237,10,474,537,1560,76,358
204,160,5,570,378,1317,241,182,5,426,344,1198,76,359
42,91,7,162,157,459,38,94,7,127,169,435,76,360
169,193,8,462,502,1334,209,265,10,397,469,1350,76,361
203,284,16,606,556,1665,229,360,27,457,621,1694,76,362
122,286,36,477,353,1274,74,351,32,414,463,1334,76,363
88,218,19,530,385,1240,67,273,24,424,458,1246,76,364
295,269,7,573,663,1807,311,392,6,526,704,1939,76,365
305,656,444,736,569,2710,317,831,315,600,697,2760,76,366
275,362,14,789,639,2079,145,516,41,692,877,2271,77,1
1907,504,15,1284,1428,5138,773,923,40,1109,2469,5314,77,2
2409,555,22,1462,1578,6026,925,1015,52,1129,2937,6058,77,3
2385,566,27,1451,1513,5942,949,1061,71,998,2739,5818,77,4
1701,699,54,1433,1550,5437,727,1180,131,1087,2231,5356,77,5
385,350,39,993,625,2392,174,610,116,735,712,2347,77,6
326,373,13,1115,657,2484,155,575,49,766,899,2444,77,7
2276,539,38,1318,1484,5655,874,1083,78,1005,2600,5640,77,8
2639,396,39,1297,1055,5426,971,771,55,1139,2494,5430,77,9
2894,583,18,1511,1703,6709,1002,1244,50,1161,3126,6583,77,10
2670,599,15,1521,1791,6596,977,1344,74,1097,2982,6474,77,11
1950,576,83,1451,1512,5572,818,970,139,1163,2287,5377,77,12
34,0,0,0,0,34,29,0,0,0,0,29,77,13
0,0,3,0,0,3,0,0,1,0,0,1,77,14
542,455,30,1042,795,2864,352,703,61,758,1090,2964,77,15
1038,372,16,930,783,3139,469,746,75,697,1142,3129,77,16
2313,511,16,1322,1368,5530,742,1084,43,949,2630,5448,77,17
2662,570,13,1460,1642,6347,942,1355,60,995,2925,6277,77,18
1195,450,36,1075,922,3678,445,860,118,783,1323,3529,77,19
434,451,44,1273,1002,3204,181,789,120,987,1052,3129,77,20
310,399,6,1081,841,2637,164,650,46,861,990,2711,77,21
2279,496,15,1399,1404,5593,918,913,53,1101,2684,5669,77,22
3092,605,24,1493,1703,6917,1152,1241,65,1154,3331,6943,77,23
2937,643,29,1511,1731,6851,1045,1385,68,1191,3195,6884,77,24
2797,582,22,1484,1693,6578,1022,1412,75,1070,2873,6452,77,25
2004,788,92,1596,1932,6412,801,1303,193,1361,2564,6222,77,26
111,0,0,0,0,111,82,0,0,0,0,82,77,27
4,34,11,0,3,52,3,37,13,0,5,58,77,28
2313,511,25,1399,1416,5664,847,1010,52,1095,2647,5651,77,29
3133,746,9,1456,1649,6993,1116,1339,27,1113,3287,6882,77,30
3032,602,4,1439,1718,6795,1007,1382,39,1157,3138,6723,77,31
2830,631,18,1539,1679,6697,1073,1340,54,1139,2926,6532,77,32
1987,689,39,1446,1727,5888,788,1250,136,1267,2319,5760,77,33
507,757,38,1812,1346,4460,253,1051,145,1268,1568,4285,77,34
376,434,37,1373,847,3067,181,711,45,981,1243,3161,77,35
2416,555,19,1351,1493,5834,929,1038,58,1098,2752,5875,77,36
3171,601,13,1469,1821,7075,1192,1302,62,1118,3313,6987,77,37
3040,644,25,1574,1758,7041,1078,1411,67,1179,3304,7039,77,38
2814,594,10,1514,1725,6657,1048,1322,32,1146,2973,6521,77,39
2064,750,78,1523,1706,6121,803,1201,202,1228,2490,5924,77,40
275,406,34,1090,838,2643,188,581,100,777,832,2478,77,41
232,272,27,688,555,1774,130,388,76,536,612,1742,77,42
2296,504,15,1263,1382,5460,864,998,47,1007,2657,5573,77,43
2733,579,20,1375,1595,6302,942,1525,82,1000,2182,5731,77,44
2987,678,38,1594,1835,7132,1047,1393,83,1252,3297,7072,77,45
2772,593,18,1665,1723,6771,1010,1331,49,1275,2883,6548,77,46
1835,749,57,1530,1604,5775,753,1205,157,1210,2353,5678,77,47
425,719,48,1489,1018,3699,192,1035,168,1011,1325,3731,77,48
303,556,17,1417,872,3165,133,761,56,927,1283,3160,77,49
865,515,6,1420,1124,3930,410,840,31,1176,1547,4004,77,50
2949,633,16,1365,1660,6623,1049,1291,36,1179,3095,6650,77,51
3018,572,12,1519,1735,6856,1079,1416,45,1212,3071,6823,77,52
2856,546,14,1468,1789,6673,1006,1381,71,1147,3055,6660,77,53
1970,847,37,1496,1567,5917,771,1224,142,1165,2549,5851,77,54
441,701,34,1748,1350,4274,239,1030,146,1245,1522,4182,77,55
389,482,22,1363,962,3218,154,905,49,952,1124,3184,77,56
2401,508,34,1321,1608,5872,846,1091,79,984,2730,5730,77,57
3151,560,31,1487,1767,6996,1120,1256,87,1201,3319,6983,77,58
3021,581,10,1480,1653,6745,1066,1310,31,1174,3158,6739,77,59
2859,681,10,1612,1749,6911,1000,1439,43,1183,3183,6848,77,60
2050,865,55,1703,1816,6489,796,1390,150,1420,2657,6413,77,61
469,817,49,1474,1205,4014,210,1008,175,1148,1535,4076,77,62
438,563,44,1642,1068,3755,202,872,96,1292,1397,3859,77,63
2484,634,94,1450,1563,6225,948,1168,137,1203,2772,6228,77,64
3026,667,39,1439,1712,6883,1063,1375,79,1086,3348,6951,77,65
3037,512,19,1460,1664,6692,1077,1303,77,1167,3051,6675,77,66
2842,710,45,1507,1718,6822,1001,1502,150,1153,3000,6806,77,67
1966,710,69,1474,1705,5924,778,1350,167,1218,2465,5978,77,68
512,542,55,1576,951,3636,209,986,185,1181,1119,3680,77,69
359,455,8,1422,745,2989,160,713,47,925,1243,3088,77,70
2252,500,19,1280,1307,5358,771,1099,47,964,2646,5527,77,71
2988,574,7,1591,1776,6936,1049,1451,46,1115,3344,7005,77,72
3091,663,8,1604,1758,7124,1085,1578,69,1218,3248,7198,77,73
2704,684,5,1751,1783,6927,944,1608,74,1093,3166,6885,77,74
1913,753,39,1578,1614,5897,696,1293,194,1249,2516,5948,77,75
678,901,33,2226,1385,5223,264,1475,193,1480,1825,5237,77,76
449,503,4,1657,994,3607,178,948,38,1049,1487,3700,77,77
2383,458,13,1402,1401,5657,883,1112,42,1024,2654,5715,77,78
3020,529,9,1502,1692,6752,1061,1414,39,1040,3227,6781,77,79
3143,581,8,1834,1879,7445,1013,1658,58,1243,3422,7394,77,80
2868,619,11,1733,1732,6963,977,1628,51,1071,3093,6820,77,81
2051,793,42,1730,1796,6412,757,1559,194,1162,2700,6372,77,82
465,795,28,1424,1173,3885,179,1204,149,890,1495,3917,77,83
468,445,14,2071,1015,4013,170,1094,49,1144,1714,4171,77,84
2324,522,6,1677,1517,6046,829,1187,63,1100,2797,5976,77,85
3026,513,4,1798,1751,7092,1036,1440,28,1110,3313,6927,77,86
2748,666,12,1477,1545,6448,984,1427,39,1015,2973,6438,77,87
2524,609,15,1623,1520,6291,882,1301,45,1145,2925,6298,77,88
1779,838,24,1924,1637,6202,687,1509,136,1228,2527,6087,77,89
549,666,47,2499,1359,5120,215,1507,160,1282,1950,5114,77,90
449,387,12,1465,844,3157,180,908,33,965,1275,3361,77,91
2096,555,13,1505,1389,5558,794,1212,58,968,2637,5669,77,92
2911,469,21,1543,1577,6521,977,1267,63,1074,3152,6533,77,93
2923,468,6,1451,1613,6461,1001,1458,36,984,2957,6436,77,94
2945,560,11,1831,1667,7014,1024,1548,55,1169,3129,6925,77,95
2023,703,42,1792,1777,6337,741,1419,155,1370,2513,6198,77,96
596,598,34,2016,1220,4464,246,1187,148,1349,1556,4486,77,97
645,455,38,1586,961,3685,206,976,50,1184,1382,3798,77,98
2354,493,9,1490,1319,5665,842,1082,59,992,2734,5709,77,99
2988,622,5,1551,1601,6767,1056,1396,59,1157,3253,6921,77,100
2999,529,5,1710,1631,6874,979,1364,51,1184,3233,6811,77,101
3022,539,15,1588,1670,6834,1006,1416,55,1126,3027,6630,77,102
2106,724,31,1615,1642,6118,778,1342,151,1198,2574,6043,77,103
605,793,63,2004,1376,4841,231,1409,182,1344,1740,4906,77,104
443,435,24,1716,1006,3624,205,931,59,1238,1446,3879,77,105
2343,665,9,1511,1532,6060,892,1328,36,1145,2736,6137,77,106
2927,704,18,1595,1733,6977,1048,1464,40,1209,3233,6994,77,107
3065,621,14,1587,1727,7014,1065,1584,49,1220,3099,7017,77,108
2926,673,8,1710,1673,6990,997,1596,48,1193,3074,6908,77,109
1963,941,32,1663,1622,6221,710,1425,141,1267,2587,6130,77,110
580,824,31,2269,1432,5136,243,1536,197,1245,1843,5064,77,111
392,462,5,1432,796,3087,171,850,32,982,1264,3299,77,112
2261,555,12,1427,1401,5656,823,1093,55,1072,2691,5734,77,113
3000,609,6,1556,1675,6846,1125,1459,28,1121,3220,6953,77,114
3084,540,8,1589,1778,6999,1028,1563,44,1238,3040,6913,77,115
2922,580,7,1722,1773,7004,1030,1560,41,1184,3082,6897,77,116
2050,716,43,1629,1837,6275,762,1503,196,1220,2572,6253,77,117
543,622,28,1667,1142,4002,214,1214,202,1142,1288,4060,77,118
458,411,9,1498,986,3362,183,946,65,979,1337,3510,77,119
2395,493,9,1339,1448,5684,881,1145,43,991,2678,5738,77,120
3099,602,9,1552,1732,6994,1179,1401,39,1143,3245,7007,77,121
3007,585,9,1576,1780,6957,1102,1507,50,1172,3154,6985,77,122
2875,652,52,1663,1728,6970,1064,1477,96,1188,2991,6816,77,123
2034,785,35,1754,1792,6400,860,1390,160,1312,2495,6217,77,124
558,642,22,1697,985,3904,231,1146,149,1057,1422,4005,77,125
379,433,7,1342,788,2949,169,770,46,937,1059,2981,77,126
2465,488,3,1411,1375,5742,955,1123,30,1076,2674,5858,77,127
3128,674,8,1543,1906,7259,1175,1604,63,1151,3271,7264,77,128
3149,623,14,1641,2031,7458,1088,1755,65,1262,3181,7351,77,129
2781,626,8,1632,1712,6759,1004,1477,43,1192,3118,6834,77,130
2049,805,43,1514,1636,6047,776,1299,143,1209,2493,5920,77,131
669,654,31,1890,1243,4487,265,1099,153,1369,1600,4486,77,132
429,462,15,1411,802,3119,194,833,50,1034,1112,3223,77,133
2435,686,14,1442,1514,6091,930,1340,59,1098,2730,6157,77,134
3052,638,14,1569,1622,6895,1070,1310,48,1216,3380,7024,77,135
3042,632,22,1632,1767,7095,1017,1478,93,1265,3241,7094,77,136
2939,681,5,1770,1728,7123,1060,1601,80,1137,3207,7085,77,137
2095,803,60,1637,1696,6291,822,1361,201,1253,2617,6254,77,138
463,431,59,1293,821,3067,197,647,127,748,823,2542,77,139
340,333,18,1007,578,2276,154,541,52,705,789,2241,77,140
2412,559,3,1551,1464,5989,986,1210,40,1167,2777,6180,77,141
3133,667,5,1555,1949,7309,1141,1629,58,1220,3403,7451,77,142
3025,678,26,1637,1746,7112,1092,1480,65,1237,3301,7175,77,143
2731,575,26,1472,1672,6476,996,1327,63,1190,2903,6479,77,144
1866,724,83,1667,1755,6095,740,1386,187,1439,2197,5949,77,145
508,731,45,1795,1263,4342,258,1315,149,1200,1466,4388,77,146
399,599,11,1564,963,3536,213,1074,64,1040,1298,3689,77,147
469,454,11,1300,779,3013,230,752,72,1019,1152,3225,77,148
2799,639,5,1488,1646,6577,1047,1310,39,1174,3212,6782,77,149
2935,647,9,1528,1597,6716,1124,1297,47,1229,3129,6826,77,150
3018,842,23,1667,1782,7332,983,1712,59,1305,3032,7091,77,151
2078,810,84,1632,1643,6247,819,1390,210,1213,2449,6081,77,152
0,7,11,34,29,81,0,5,6,35,27,73,77,240
18,3,0,42,11,74,21,0,0,50,8,79,77,241
6,27,7,36,25,101,8,23,5,35,29,100,77,242
13,3,101,16,17,150,14,0,92,21,18,145,77,243
50,17,5,99,56,227,46,20,5,103,50,224,77,244
298,487,17,1231,785,2818,137,797,74,880,1144,3032,77,245
334,364,12,1025,740,2475,118,623,45,795,1061,2642,77,246
2366,482,6,1239,1362,5455,844,1003,33,962,2726,5568,77,247
2501,422,8,1260,1436,5627,932,1046,41,929,2752,5700,77,248
2379,522,7,1409,1400,5717,848,1182,40,956,2753,5779,77,249
1608,770,35,1348,1344,5105,615,1146,160,1005,2210,5136,77,250
430,781,30,1430,1004,3675,158,1031,169,974,1381,3713,77,251
386,415,6,1311,711,2829,136,790,28,918,996,2868,77,252
2200,452,6,1216,1303,5177,824,999,29,947,2491,5290,77,253
2859,554,14,1339,1626,6392,1037,1407,52,1041,3027,6564,77,254
2825,770,15,1429,1702,6741,1038,1506,56,990,3094,6684,77,255
2607,568,6,1445,1607,6233,924,1390,54,1065,2760,6193,77,256
1789,739,37,1381,1501,5447,687,1276,185,1049,2293,5490,77,257
459,720,38,1636,1170,4023,218,1333,163,1137,1374,4225,77,258
397,412,8,1384,776,2977,157,762,54,985,1256,3214,77,259
2243,434,10,1266,1423,5376,880,1116,37,945,2524,5502,77,260
2942,479,7,1504,1485,6417,1010,1281,31,1027,3143,6492,77,261
2776,610,32,1340,1614,6372,998,1480,87,1013,2905,6483,77,262
2755,671,19,1516,1725,6686,958,1526,97,1072,3033,6686,77,263
1936,1085,52,1452,1563,6088,725,1454,160,1130,2535,6004,77,264
508,740,40,1879,1417,4584,215,1331,185,1246,1599,4576,77,265
384,494,15,1299,811,3003,155,863,43,1018,1057,3136,77,266
2333,617,5,1300,1355,5610,879,1086,65,958,2712,5700,77,267
2867,559,13,1453,1684,6576,1083,1256,81,1095,3248,6763,77,268
2741,551,8,1436,1644,6380,1017,1441,42,991,2896,6387,77,269
2660,641,29,1521,1542,6393,964,1390,57,1046,2958,6415,77,270
1810,660,35,1533,1580,5618,738,1309,184,1145,2188,5564,77,271
466,755,64,1906,1281,4472,230,1387,211,1223,1513,4564,77,272
399,423,23,1342,755,2942,185,808,57,970,1159,3179,77,273
2244,441,7,1237,1392,5321,818,991,58,962,2529,5358,77,274
2948,516,9,1386,1577,6436,1033,1284,36,1072,3028,6453,77,275
2947,548,6,1448,1721,6670,1080,1348,39,1089,3065,6621,77,276
2598,577,14,1505,1676,6370,934,1339,63,1126,2923,6385,77,277
1844,700,32,1499,1667,5742,762,1306,147,1152,2368,5735,77,278
523,693,33,1787,1285,4321,223,1226,182,1207,1483,4321,77,279
402,425,31,1453,853,3164,176,808,57,1033,1360,3434,77,280
2378,603,6,1373,1450,5810,912,1214,36,1032,2699,5893,77,281
3145,560,15,1510,1644,6874,1061,1337,78,1194,3268,6938,77,282
3060,601,13,1581,1776,7031,1106,1341,52,1215,3239,6953,77,283
2667,629,11,1646,1799,6752,1026,1424,65,1178,2984,6677,77,284
1765,770,37,1672,1717,5961,686,1321,158,1321,2386,5872,77,285
586,828,42,1978,1264,4698,241,1355,158,1249,1691,4694,77,286
470,532,18,1471,965,3456,180,972,57,1109,1233,3551,77,287
1227,481,4,1455,1267,4434,575,934,36,1090,1762,4397,77,288
2924,503,16,1507,1795,6745,1061,1374,60,1130,3139,6764,77,289
3003,514,15,1625,1693,6850,1062,1301,58,1260,3176,6857,77,290
2739,604,15,1541,1779,6678,1000,1505,90,1151,2915,6661,77,291
1892,854,32,1735,1592,6105,727,1441,165,1308,2516,6157,77,292
588,909,68,1942,1396,4903,254,1460,260,1316,1655,4945,77,293
423,439,10,1545,1032,3449,155,909,68,1110,1293,3535,77,294
2381,537,5,1352,1483,5758,905,1092,67,1040,2858,5962,77,295
3030,610,6,1545,1696,6887,1124,1446,49,1104,3381,7104,77,296
3057,595,10,1623,1852,7137,1142,1499,71,1168,3178,7058,77,297
2827,630,8,1639,1803,6907,1033,1622,54,1160,3033,6902,77,298
2034,897,41,1601,1603,6176,779,1355,166,1253,2651,6204,77,299
571,926,48,1866,1290,4701,267,1333,252,1320,1598,4770,77,300
634,467,8,1524,987,3620,222,854,45,1133,1450,3704,77,301
2336,529,5,1402,1491,5763,869,1073,41,992,2820,5795,77,302
2918,556,13,1628,2326,7441,1104,1953,61,1231,3197,7546,77,303
3029,649,11,1618,1682,6989,1064,1381,53,1209,3363,7070,77,304
2584,759,17,1504,1732,6596,920,1213,84,1189,3128,6534,77,305
1864,851,30,1567,1661,5973,713,1307,166,1253,2419,5858,77,306
493,883,34,1795,1438,4643,215,1447,182,1135,1638,4617,77,307
438,407,5,1405,826,3081,190,702,46,1134,1212,3284,77,308
2272,456,22,1461,1547,5758,922,960,79,1204,2640,5805,77,309
2242,583,39,1621,1555,6040,956,974,114,1341,2674,6059,77,310
2508,480,17,1453,1614,6072,1052,1080,69,1084,2733,6018,77,311
2715,576,32,1570,1575,6468,1073,1166,90,1141,2946,6416,77,312
1962,676,29,1503,1555,5725,740,1279,138,1197,2308,5662,77,313
506,762,27,1739,1196,4230,250,1046,187,1330,1559,4372,77,314
429,349,13,1430,857,3078,182,719,52,993,1324,3270,77,315
1205,465,14,1419,1116,4219,498,841,45,1179,1747,4310,77,316
3068,566,5,1532,1692,6863,1103,1295,42,1137,3325,6902,77,317
3081,571,8,1512,1801,6973,1117,1335,43,1180,3279,6954,77,318
2856,650,11,1500,1658,6675,1058,1377,63,1147,3033,6678,77,319
1950,723,46,1474,1566,5759,814,1214,159,1207,2516,5910,77,320
429,593,32,1976,1027,4057,275,858,133,1341,1409,4016,77,321
324,332,8,1166,797,2627,148,606,50,842,1016,2662,77,322
2364,622,7,1376,1526,5895,882,1076,44,1099,2859,5960,77,323
3056,708,9,1479,1755,7007,1071,1269,39,1173,3532,7084,77,324
3068,491,9,1505,1724,6797,1069,1273,53,1088,3200,6683,77,325
2839,540,11,1511,1747,6648,1005,1383,44,1138,3066,6636,77,326
1920,609,47,1305,1399,5280,722,1186,173,1075,2172,5328,77,327
484,733,56,1515,1174,3962,196,1061,165,1192,1378,3992,77,328
369,368,5,1331,843,2916,185,727,56,940,1107,3015,77,329
2104,540,10,1539,1366,5559,801,989,71,1176,2484,5521,77,330
2263,675,12,1584,1576,6110,857,1180,46,1168,2746,5997,77,331
1584,469,8,1635,1306,5002,660,892,72,1451,1965,5040,77,332
261,283,9,740,428,1721,119,371,28,556,618,1692,77,333
731,435,29,1522,973,3690,342,823,89,1102,1440,3796,77,334
436,513,27,1369,961,3306,183,826,115,995,1324,3443,77,335
353,356,14,1196,829,2748,157,714,36,994,1123,3024,77,336
2199,414,25,1239,1375,5252,834,979,62,1088,2504,5467,77,337
2925,542,13,1477,1695,6652,1034,1249,47,1099,3249,6678,77,338
2989,537,23,1475,1670,6694,1133,1309,66,1105,3067,6680,77,339
2664,534,5,1505,1608,6316,1011,1299,59,1051,2981,6401,77,340
1916,723,31,1402,1440,5512,750,1181,134,1130,2469,5664,77,341
412,636,23,1677,1376,4124,194,1269,176,1191,1412,4242,77,342
358,435,2,1414,980,3189,173,885,48,1018,1355,3479,77,343
2452,521,8,1387,1460,5828,848,1128,51,1062,2833,5922,77,344
3198,529,7,1552,1703,6989,1052,1555,51,1166,3375,7199,77,345
3158,542,11,1525,1510,6746,993,1470,28,1059,3022,6572,77,346
2945,585,6,1707,1768,7011,1015,1602,58,1169,3172,7016,77,347
2017,825,53,1608,1668,6171,791,1350,196,1233,2510,6080,77,348
477,694,25,1790,1418,4404,223,1088,198,1124,1739,4372,77,349
350,421,10,1365,860,3006,159,822,53,974,1252,3260,77,350
2172,458,6,1373,1502,5511,885,1018,35,1110,2515,5563,77,351
2740,647,10,1569,1809,6775,1075,1321,46,1187,3161,6790,77,352
2722,539,6,1527,1753,6547,1062,1221,59,1163,3070,6575,77,353
2398,574,17,1624,1883,6496,991,1362,70,1230,2861,6514,77,354
1669,689,39,1427,1561,5385,666,1214,139,1217,2132,5368,77,355
430,503,35,1464,1081,3513,207,816,104,1064,1290,3481,77,356
374,345,8,1152,692,2571,130,714,30,738,1076,2688,77,357
1240,462,11,1399,1252,4364,470,834,38,1051,1851,4244,77,358
797,301,5,1110,750,2963,394,429,22,962,1049,2856,77,359
179,248,8,491,347,1273,82,334,26,320,534,1296,77,360
915,360,9,1144,1072,3500,400,822,45,885,1462,3614,77,361
940,508,37,1364,1136,3985,421,862,120,1019,1661,4083,77,362
333,548,28,1201,883,2993,159,843,137,824,1097,3060,77,363
340,336,12,1264,749,2701,157,657,61,835,1199,2909,77,364
1274,529,22,1549,1390,4764,549,922,73,1193,2062,4799,77,365
1169,822,229,1459,1048,4727,504,921,442,1173,1618,4658,77,366
20,136,14,584,1393,2147,152,80,18,1572,403,2225,78,1
159,185,46,791,2619,3800,1252,69,39,2106,473,3939,78,2
224,185,27,794,2454,3684,1522,85,25,1691,408,3731,78,3
209,150,4,815,2285,3463,1384,79,4,1700,362,3529,78,4
150,225,10,790,1878,3053,881,125,14,1739,491,3250,78,5
47,112,13,564,1196,1932,163,116,20,1801,330,2430,78,6
33,137,15,764,1444,2393,132,122,16,1575,509,2354,78,7
159,172,10,700,1765,2806,1175,76,12,1164,343,2770,78,8
179,115,11,879,1786,2970,1687,51,10,1093,246,3087,78,9
195,236,13,878,2345,3667,1772,92,18,1477,355,3714,78,10
211,334,21,760,2070,3396,1557,101,13,1324,466,3461,78,11
144,143,9,775,1479,2550,788,84,7,1399,323,2601,78,12
46,178,10,1020,2496,3750,183,94,13,2824,720,3834,78,13
33,81,8,917,1717,2756,133,44,7,2472,490,3146,78,14
75,148,6,770,1502,2501,216,116,5,1934,486,2757,78,15
154,108,5,459,489,1215,312,80,7,509,319,1227,78,16
166,166,5,524,1696,2557,1169,84,8,1118,298,2677,78,17
200,382,7,729,2400,3718,1555,148,7,1399,655,3764,78,18
132,304,15,946,1799,3196,607,212,13,5768,979,7579,78,19
55,197,18,1063,2004,3337,213,136,9,2862,677,3897,78,20
34,67,7,602,1356,2066,123,50,7,1742,411,2333,78,21
190,150,22,601,1550,2513,1210,67,22,908,279,2486,78,22
227,284,18,738,2146,3413,1869,80,13,1041,328,3331,78,23
204,218,14,774,2142,3352,1728,144,8,1170,324,3374,78,24
184,204,15,784,2016,3203,1551,64,13,1264,285,3177,78,25
137,513,13,1189,2020,3872,958,270,20,1874,656,3778,78,26
51,264,11,1208,2716,4250,238,98,16,3363,848,4563,78,27
21,117,9,587,1154,1888,95,76,7,1503,257,1938,78,28
189,127,5,736,1688,2745,1212,50,5,1174,287,2728,78,29
203,190,18,691,2243,3345,1879,80,14,1039,291,3303,78,30
228,172,14,698,2102,3214,1857,82,12,963,291,3205,78,31
208,216,7,909,1882,3222,1523,106,8,1203,358,3198,78,32
152,208,25,804,1572,2761,1009,151,16,1372,336,2884,78,33
43,214,36,1689,3095,5077,255,131,22,4721,717,5846,78,34
23,122,9,927,1746,2827,131,66,9,2260,525,2991,78,35
190,162,20,845,1701,2918,1252,67,21,1149,320,2809,78,36
240,200,16,698,2215,3369,1890,86,8,1128,341,3453,78,37
227,193,4,793,2371,3588,1856,90,3,1218,355,3522,78,38
197,223,11,807,2220,3458,1511,106,12,1384,379,3392,78,39
130,353,31,1042,1897,3453,859,191,15,1770,588,3423,78,40
37,503,15,1077,2337,3969,225,123,19,2771,843,3981,78,41
34,84,19,608,1100,1845,131,47,16,1482,238,1914,78,42
175,163,21,734,1774,2867,1250,73,15,1191,316,2845,78,43
222,212,9,803,2163,3409,1702,109,17,1097,358,3283,78,44
231,437,17,888,2363,3936,1424,110,21,1498,479,3532,78,45
246,190,14,974,1997,3421,1571,121,19,1444,327,3482,78,46
122,280,31,1297,2021,3751,1021,179,13,2248,548,4009,78,47
55,279,18,1287,2928,4567,214,131,10,3452,884,4691,78,48
39,193,23,1173,2957,4385,139,104,24,3407,866,4540,78,49
89,193,26,1262,2230,3800,344,106,16,3014,532,4012,78,50
183,222,5,1004,2522,3936,1774,88,5,1715,354,3936,78,51
173,260,11,893,2547,3884,1866,78,11,1448,379,3782,78,52
161,281,11,862,2325,3640,1564,111,15,1612,401,3703,78,53
135,241,76,1106,1978,3536,968,151,81,2033,431,3664,78,54
59,208,21,1353,2852,4493,280,98,15,3758,669,4820,78,55
48,152,30,990,2055,3275,202,88,25,2534,539,3388,78,56
159,195,46,738,1940,3078,1274,129,42,1222,417,3084,78,57
201,228,36,895,2294,3654,1878,76,38,1360,357,3709,78,58
191,287,24,965,2130,3597,1745,90,21,1332,347,3535,78,59
186,323,3,932,2150,3594,1611,174,5,1403,476,3669,78,60
145,321,20,1028,1931,3445,986,186,12,1830,563,3577,78,61
52,275,12,931,2414,3684,204,178,13,3026,703,4124,78,62
38,261,17,1450,3071,4837,212,101,20,3420,979,4732,78,63
174,346,58,845,2437,3860,1328,258,56,2026,496,4164,78,64
221,314,13,1068,3112,4728,1980,131,9,2289,528,4937,78,65
234,310,7,1112,2773,4436,1911,126,10,2057,501,4605,78,66
241,545,6,1095,3005,4892,1568,164,6,2121,829,4688,78,67
162,401,17,1597,2842,5019,1072,174,16,2947,691,4900,78,68
54,134,15,1455,2883,4541,395,77,16,3862,578,4928,78,69
31,252,44,1530,3663,5520,229,111,43,4482,803,5668,78,70
191,483,55,1205,3685,5619,1362,206,70,3397,719,5754,78,71
260,1032,30,1395,4744,7461,2164,277,35,3987,1112,7575,78,72
285,1059,25,1831,4965,8165,2208,287,29,4385,1352,8261,78,73
270,1517,51,1826,4928,8592,1911,596,52,4490,1992,9041,78,74
176,625,25,2193,4281,7300,1260,287,25,4710,1064,7346,78,75
242,2041,37,4562,9063,15945,1458,453,15,10820,3857,16603,78,76
120,1635,7,3648,7794,13204,722,341,8,9112,3578,13761,78,77
400,1370,6,2452,5213,9441,1775,311,7,4925,2686,9704,78,78
490,1511,21,2490,5891,10403,2551,240,22,5021,3159,10993,78,79
584,2869,7,3815,8077,15352,2701,536,5,7701,5328,16271,78,80
498,2309,9,2987,6366,12169,2224,431,10,6443,4005,13113,78,81
717,3377,29,4988,10015,19126,2301,681,8,10993,7864,21847,78,82
156,1261,19,2342,8576,12354,436,345,9,8600,3908,13298,78,83
339,3345,10,9508,19275,32477,1990,458,11,24421,8761,35641,78,84
327,2305,7,4237,10327,17203,2094,498,5,11541,3792,17930,78,85
373,1974,24,3838,9150,15359,2487,326,26,9940,3134,15913,78,86
308,708,7,2709,5130,8862,2371,171,9,6053,1191,9795,78,87
253,952,9,2763,6091,10068,1761,274,12,7139,1680,10866,78,88
270,2358,41,5558,10549,18776,1688,519,10,13506,4136,19859,78,89
143,2263,28,10407,16869,29710,1323,466,12,32047,6078,39926,78,90
220,1419,5,3709,8323,13676,723,295,4,9499,3426,13947,78,91
200,568,6,1987,4937,7698,1431,196,6,5749,1199,8581,78,92
268,537,10,2562,5481,8858,2193,170,12,6159,944,9478,78,93
307,648,15,2241,5021,8232,2264,190,9,5110,919,8492,78,94
266,1029,36,2743,5894,9968,2172,324,38,6195,1582,10311,78,95
188,826,35,2889,5958,9896,1477,339,27,7054,1435,10332,78,96
95,1029,17,3430,6470,11041,648,355,21,8524,2100,11648,78,97
487,794,10,7182,4289,12762,9148,210,6,5956,1566,16886,78,98
196,513,15,1352,5171,7247,1362,186,20,5266,914,7748,78,99
253,604,5,1394,3650,5906,2060,136,8,2919,953,6076,78,100
214,740,6,1613,3868,6441,2140,202,2,3483,988,6815,78,101
219,534,16,1557,3403,5729,1828,226,20,2922,957,5953,78,102
194,774,37,1550,3254,5809,1261,293,19,3872,1026,6471,78,103
121,1056,31,2989,5615,9812,957,325,40,6817,2090,10229,78,104
99,906,5,2042,4423,7475,602,188,7,5550,1662,8009,78,105
206,664,11,1480,3097,5458,1401,247,7,3259,801,5715,78,106
235,1000,20,1413,3642,6310,2116,309,22,3056,1146,6649,78,107
220,681,44,1255,4032,6232,2018,194,31,2614,1120,5977,78,108
229,901,30,1289,3573,6022,1744,269,31,2871,1289,6204,78,109
186,488,61,1566,2955,5256,1115,242,19,3404,719,5499,78,110
64,1270,5,1623,4925,7887,390,398,10,4914,1769,7481,78,111
34,398,6,1244,2544,4226,294,135,6,3574,674,4683,78,112
203,552,4,1391,3175,5325,1577,204,6,2596,747,5130,78,113
234,566,20,1296,3345,5461,2229,174,16,2193,719,5331,78,114
230,854,35,1205,3216,5540,2038,193,38,2390,911,5570,78,115
235,646,17,1450,3035,5383,1872,208,31,2813,889,5813,78,116
148,588,18,1427,2981,5162,1131,244,17,3292,776,5460,78,117
59,516,15,2103,2894,5587,809,233,19,4264,808,6133,78,118
35,684,6,1560,3119,5404,293,234,6,3661,1001,5195,78,119
186,660,4,1174,2484,4508,1416,162,6,2443,619,4646,78,120
226,629,17,1225,2933,5030,2203,179,9,1947,767,5105,78,121
236,817,5,1240,2746,5044,1942,293,6,1865,876,4982,78,122
236,995,20,1256,2554,5061,1865,246,21,2130,1119,5381,78,123
150,621,15,1327,2573,4686,1152,231,14,2758,705,4860,78,124
38,255,18,1252,2381,3944,323,109,12,3301,564,4309,78,125
66,502,5,1145,1999,3717,233,158,4,2934,624,3953,78,126
227,537,18,1078,2547,4407,1492,124,19,2176,640,4451,78,127
205,659,26,1241,3287,5418,2183,167,21,2164,792,5327,78,128
217,919,7,1263,3298,5704,2144,255,6,2407,878,5690,78,129
210,678,4,1164,3004,5060,1865,191,3,2386,984,5429,78,130
141,535,14,1346,2472,4508,1175,211,9,2736,712,4843,78,131
64,486,16,2485,3705,6756,438,189,13,5185,1110,6935,78,132
41,497,4,1078,2533,4153,398,184,4,2912,678,4176,78,133
183,1041,6,1275,3004,5509,1459,381,8,2829,1035,5712,78,134
244,334,6,1342,3280,5206,2031,176,7,2420,547,5181,78,135
234,542,36,1218,3308,5338,2121,189,33,2379,741,5463,78,136
233,1069,13,1430,3336,6081,1960,434,16,2721,1448,6579,78,137
150,597,21,1616,2862,5246,1243,257,8,3002,729,5239,78,138
58,412,29,1595,3257,5351,314,282,19,4368,908,5891,78,139
44,684,7,3385,2972,7092,1426,244,6,5515,884,8075,78,140
202,866,6,1272,3110,5456,1413,239,8,2966,865,5491,78,141
228,896,6,1281,3753,6164,2144,334,7,2820,930,6235,78,142
303,901,10,1260,3293,5767,2174,262,8,2466,851,5761,78,143
230,828,19,1262,3134,5473,1792,347,27,2648,1013,5827,78,144
129,837,16,1772,2741,5495,1113,384,7,3291,806,5601,78,145
65,1157,15,2095,4403,7735,543,425,12,5826,1485,8291,78,146
68,1316,10,2520,4269,8183,496,482,8,6140,1454,8580,78,147
54,548,19,1602,3805,6028,413,180,23,4813,809,6238,78,148
207,736,44,1284,3614,5885,2005,222,42,2698,694,5661,78,149
233,484,10,1934,3369,6030,2431,195,9,3107,541,6283,78,150
205,1178,23,1538,3427,6371,1844,442,26,3333,1135,6780,78,151
160,1092,37,1538,2877,5704,1199,360,13,3121,1072,5765,78,152
62,1254,23,1400,3128,5867,463,410,12,3912,1349,6146,78,153
53,606,5,1167,2892,4723,280,242,4,3566,739,4831,78,154
208,729,8,1453,3157,5555,1784,282,7,3041,687,5801,78,155
270,829,3,1379,3751,6232,2311,288,3,2855,933,6390,78,156
247,460,17,1653,3399,5776,2231,175,19,2939,624,5988,78,157
213,975,8,1575,3807,6578,2051,397,12,3296,1187,6943,78,158
135,1209,30,1792,3434,6600,1387,499,14,3835,1291,7026,78,159
62,1454,40,2369,4881,8806,514,552,12,5519,1416,8013,78,160
72,1069,9,1746,3475,6371,351,503,5,4776,1189,6824,78,161
201,864,4,1558,3940,6567,1650,318,7,4208,828,7011,78,162
236,1014,5,1568,4411,7234,2339,355,5,3845,1044,7588,78,163
244,1023,27,1486,4197,6977,2227,314,29,3414,1051,7035,78,164
240,1265,18,1812,3479,6814,1976,586,16,3549,1218,7345,78,165
171,1166,32,2041,3508,6918,1302,378,9,4530,1203,7422,78,166
69,1059,18,1801,3952,6899,404,448,10,5185,1158,7205,78,167
43,612,6,1509,2888,5058,306,248,3,3872,763,5192,78,168
194,854,6,1517,3539,6110,1668,409,6,3429,821,6333,78,169
228,739,5,1734,3980,6686,2311,247,6,3416,947,6927,78,170
101,764,9,1873,3377,6124,758,318,8,4882,937,6903,78,171
230,983,6,1716,4015,6950,2086,494,11,3929,1130,7650,78,172
179,1056,27,1795,3439,6496,1471,485,11,3884,1132,6983,78,173
57,9240,405,2103,3785,15590,530,5983,16,5598,3409,15536,78,174
62,636,10,1370,2442,4520,369,241,9,3689,734,5042,78,175
249,769,27,1283,3400,5728,1843,254,32,2998,835,5962,78,176
257,940,7,1559,3931,6694,2397,336,15,3298,933,6979,78,177
276,800,8,1574,3905,6563,2170,260,10,3509,977,6926,78,178
232,983,26,1607,4069,6917,2127,380,26,3911,1148,7592,78,179
161,1157,18,1822,3731,6889,1375,395,23,4271,1361,7425,78,180
80,905,18,2064,4305,7372,433,394,12,6222,1325,8386,78,181
53,532,4,1496,3225,5310,359,303,5,4624,840,6131,78,182
220,931,5,1576,3900,6632,1761,291,5,4088,993,7138,78,183
250,820,70,1577,4279,6996,2211,300,63,3882,964,7420,78,184
262,1039,18,1874,4154,7347,1942,517,19,4116,1009,7603,78,185
85,16405,32,3183,6589,26294,521,23176,17,8334,8552,40600,78,186
148,947,29,2445,4823,8392,984,534,28,6761,1351,9658,78,187
82,928,49,2079,3881,7019,474,489,12,5989,1063,8027,78,188
43,773,12,1362,2757,4947,289,437,14,3616,781,5137,78,189
217,658,11,1393,3615,5894,1864,282,13,3206,794,6159,78,190
243,753,6,2089,3715,6806,2087,315,4,3378,1010,6794,78,191
270,811,10,1608,3740,6439,2024,240,13,3713,992,6982,78,192
220,986,12,1467,3763,6448,1797,437,13,3373,1231,6851,78,193
142,534,19,1586,3437,5718,1501,213,12,3659,943,6328,78,194
65,1048,26,1944,4323,7406,454,404,21,6104,1432,8415,78,195
74,625,3,1392,2522,4616,410,283,5,3843,748,5289,78,196
212,545,8,1299,3346,5410,1762,251,6,3015,590,5624,78,197
236,575,7,1509,3703,6030,2225,276,5,3156,757,6419,78,198
278,389,24,1578,3767,6036,2226,276,26,3133,626,6287,78,199
243,1024,14,1475,3818,6574,2013,482,13,3599,1100,7207,78,200
173,1121,48,1587,3434,6363,1302,470,16,3469,1299,6556,78,201
67,713,52,2206,4070,7108,342,319,18,5774,1131,7584,78,202
37,760,8,1544,3130,5479,352,295,7,4204,1003,5861,78,203
192,424,14,1303,3632,5565,1627,186,15,3239,610,5677,78,204
243,761,11,1663,3986,6664,2176,291,8,3425,829,6729,78,205
246,977,14,1632,4185,7054,2200,332,19,3967,1114,7632,78,206
215,967,12,1685,3832,6711,1996,414,19,3620,1245,7294,78,207
131,957,37,1644,3688,6457,1294,433,24,4035,1181,6967,78,208
57,1198,37,1941,4221,7454,406,493,24,5510,1489,7922,78,209
42,773,5,1025,2794,4639,251,318,6,3257,878,4710,78,210
225,537,10,1393,3436,5601,1657,263,13,3279,739,5951,78,211
241,598,8,1427,3805,6079,2247,219,9,3048,771,6294,78,212
267,725,8,1402,3788,6190,2012,307,7,3194,969,6489,78,213
225,930,16,1408,3532,6111,1854,400,12,3066,1050,6382,78,214
196,780,31,1559,3234,5800,1434,422,23,3410,928,6217,78,215
55,352,29,1832,3588,5856,320,192,17,4753,1088,6370,78,216
49,646,7,1463,2596,4761,322,296,8,3644,715,4985,78,217
165,832,18,1389,3239,5643,1558,361,20,3045,849,5833,78,218
207,709,12,1426,3578,5932,2126,266,11,2948,814,6165,78,219
179,558,22,1360,3531,5650,1934,269,16,2800,720,5739,78,220
161,293,8,1568,3059,5089,1633,71,10,2933,593,5240,78,221
114,557,23,852,2474,4020,917,217,16,2555,648,4353,78,222
58,853,9,1575,3472,5967,323,368,4,4513,1135,6343,78,223
59,545,4,1132,2444,4184,247,191,3,3330,803,4574,78,224
188,831,10,1103,2992,5124,1471,236,11,2684,1047,5449,78,225
207,670,10,1299,3419,5605,1991,219,15,2797,784,5806,78,226
210,615,11,1226,3144,5206,1947,212,14,2476,782,5431,78,227
187,772,16,1225,3085,5285,1807,251,17,2553,1061,5689,78,228
148,891,27,1327,2801,5194,1157,307,19,2925,1070,5478,78,229
55,658,33,1484,3282,5512,309,228,14,3864,1079,5494,78,230
50,482,7,1147,1933,3619,214,199,7,2804,658,3882,78,231
167,820,23,962,2389,4361,1238,281,21,2183,556,4279,78,232
219,604,8,1069,2941,4841,1831,253,7,2251,637,4979,78,233
221,707,16,1105,2866,4915,1709,256,18,2312,792,5087,78,234
158,718,30,1094,2648,4648,1509,325,31,2061,926,4852,78,235
116,925,60,1183,2357,4641,976,403,12,2360,922,4673,78,236
65,784,35,1426,2860,5170,345,372,25,3894,901,5537,78,237
57,429,10,1058,2143,3697,213,153,9,2831,679,3885,78,238
160,396,6,898,2166,3626,1292,130,10,1775,518,3725,78,239
180,522,2,937,2766,4407,1874,192,3,1833,562,4464,78,240
172,451,13,984,2467,4087,1758,183,11,1856,524,4332,78,241
193,224,23,921,2461,3822,1521,92,29,1813,489,3944,78,242
92,513,23,1265,2085,3978,915,255,12,2433,572,4187,78,243
65,697,38,1788,3463,6051,307,249,22,4687,1109,6374,78,244
41,986,7,1554,3365,5953,286,392,8,4392,1040,6118,78,245
64,540,15,1334,2434,4387,295,195,21,3236,825,4572,78,246
225,560,16,857,2329,3987,1684,168,22,1521,634,4029,78,247
199,478,6,836,2456,3975,1856,154,9,1550,566,4135,78,248
195,554,21,824,2332,3926,1640,178,16,1451,683,3968,78,249
114,647,34,989,2082,3866,1133,325,35,1903,688,4084,78,250
59,599,27,1467,2362,4514,421,236,21,3343,727,4748,78,251
39,570,11,1083,2053,3756,239,173,14,2612,715,3753,78,252
190,568,10,863,2327,3958,1473,175,11,1718,612,3989,78,253
195,451,13,947,2653,4259,2034,128,11,1743,576,4492,78,254
244,633,12,1023,2912,4824,2077,196,12,1920,668,4873,78,255
240,779,8,1148,2748,4923,1863,253,11,2016,975,5118,78,256
128,718,34,1199,2357,4436,1119,329,25,2355,804,4632,78,257
73,1548,67,2016,2956,6660,436,497,33,4527,1521,7014,78,258
118,459,10,2007,2126,4720,661,126,10,2762,745,4304,78,259
157,540,10,834,2299,3840,1443,144,12,1894,544,4037,78,260
214,322,14,1068,2857,4475,2098,126,16,1772,432,4444,78,261
223,591,6,981,2746,4547,1994,201,6,1868,658,4727,78,262
218,730,7,1059,2676,4690,1782,264,9,1921,848,4824,78,263
134,929,66,1276,2488,4893,1147,520,18,2702,783,5170,78,264
85,556,89,1777,3053,5560,382,233,11,4240,1061,5927,78,265
51,516,3,1130,2058,3758,230,153,5,2845,742,3975,78,266
178,490,8,847,2329,3852,1439,163,11,2031,532,4176,78,267
229,398,9,1023,2932,4591,2052,137,8,1980,496,4673,78,268
228,464,12,1206,2860,4770,1980,206,15,2186,627,5014,78,269
231,480,39,1054,2702,4506,1689,184,35,2231,626,4765,78,270
154,444,49,1171,2417,4235,1178,282,19,2729,516,4724,78,271
68,860,34,2319,3442,6723,702,344,32,4916,1279,7273,78,272
47,535,16,1147,2861,4606,324,183,14,3681,687,4889,78,273
187,376,17,896,2235,3711,1346,123,16,1883,470,3838,78,274
194,376,7,860,2618,4055,1997,136,9,1797,360,4299,78,275
223,583,11,937,2637,4391,1891,142,14,1823,728,4598,78,276
188,606,7,1140,2884,4825,1656,220,10,2275,928,5089,78,277
137,700,16,1462,2507,4822,1111,291,15,2797,777,4991,78,278
62,968,24,1511,3402,5967,394,277,11,4353,1157,6192,78,279
58,595,6,1265,2500,4424,244,178,6,3033,887,4348,78,280
186,529,12,1118,2797,4642,1461,148,12,2342,650,4613,78,281
245,513,17,1239,3307,5321,2141,150,19,2407,730,5447,78,282
205,604,7,1741,3314,5871,2038,191,8,2936,790,5963,78,283
194,725,30,1309,3106,5364,1745,415,25,2949,930,6064,78,284
119,903,28,1675,3632,6357,1115,402,7,4135,1008,6667,78,285
69,2097,51,2255,6090,10562,2376,513,15,6711,1919,11534,78,286
230,738,11,2265,3745,6989,884,248,10,5163,1084,7389,78,287
111,493,10,1404,2850,4868,433,154,12,3780,811,5190,78,288
292,377,18,1170,3080,4937,2046,118,22,2561,679,5426,78,289
227,547,13,1439,3293,5519,1990,214,15,2600,761,5580,78,290
212,621,10,1190,3132,5165,1669,261,14,2538,883,5365,78,291
171,731,21,1607,3427,5957,1223,288,20,3767,1000,6298,78,292
67,1073,33,1779,3767,6719,498,342,15,4601,1540,6996,78,293
37,439,25,1272,2686,4459,206,215,28,3516,757,4722,78,294
222,541,17,947,2703,4430,1453,218,18,2342,825,4856,78,295
241,494,18,1156,2903,4812,2074,193,21,2126,750,5164,78,296
225,585,5,1231,3135,5181,2044,168,7,2348,855,5422,78,297
228,569,11,1174,2886,4868,1795,276,16,2224,842,5153,78,298
128,631,38,1489,2917,5203,1248,259,18,2913,857,5295,78,299
109,827,21,2785,4101,7843,1267,250,16,5193,1370,8096,78,300
400,348,3,12304,2629,15684,3225,198,6,9448,819,13696,78,301
189,371,120,1194,2794,4668,1479,129,115,2527,453,4703,78,302
239,4140,18,1304,2975,8676,1917,459,11,2245,2632,7264,78,303
185,440,8,1068,2890,4591,1920,132,11,1903,615,4581,78,304
180,363,10,1054,2144,3751,1528,202,13,1671,548,3962,78,305
119,1288,16,1337,2383,5143,1111,471,18,2250,1464,5314,78,306
61,564,29,1601,3332,5587,774,285,39,3836,1173,6107,78,307
45,186,3,1127,2157,3518,257,125,5,2693,601,3681,78,308
168,213,9,956,2109,3455,1329,94,10,1869,381,3683,78,309
195,216,7,1054,2067,3539,1548,96,7,1387,446,3484,78,310
184,271,14,743,1956,3168,1574,128,19,1116,476,3313,78,311
215,380,10,824,2234,3663,1661,177,9,1391,520,3758,78,312
151,464,37,1230,2331,4213,1030,254,10,2388,711,4393,78,313
67,387,31,1631,3494,5610,391,234,21,4461,1012,6119,78,314
30,124,12,1174,2469,3809,272,80,9,3091,527,3979,78,315
64,262,21,1215,1812,3374,386,142,22,2438,499,3487,78,316
191,263,15,905,2580,3954,1943,108,11,1578,416,4056,78,317
204,349,15,990,2610,4168,1970,113,24,1539,470,4116,78,318
168,274,5,979,2295,3721,1724,104,7,1542,366,3743,78,319
126,300,30,1146,2146,3748,1121,203,16,2162,525,4027,78,320
45,427,23,1403,3089,4987,291,253,14,3731,974,5263,78,321
43,189,10,921,1900,3063,200,116,9,2378,547,3250,78,322
177,275,19,820,2133,3424,1515,122,15,1388,427,3467,78,323
206,282,19,964,2575,4046,2131,90,17,1368,456,4062,78,324
180,366,14,1086,2452,4098,1995,123,7,1321,403,3849,78,325
172,272,10,971,2245,3670,1678,140,12,1606,348,3784,78,326
138,187,22,982,1640,2969,1065,99,22,1762,320,3268,78,327
47,287,23,1134,2415,3906,285,188,12,3056,774,4315,78,328
31,186,8,927,2050,3202,250,90,7,2595,576,3518,78,329
170,207,11,1273,2741,4402,1364,93,8,2601,482,4548,78,330
190,265,18,1225,3185,4883,1585,88,26,2710,571,4980,78,331
120,228,23,1754,2532,4657,1052,77,23,3366,539,5057,78,332
35,91,5,669,1288,2088,177,72,5,1677,280,2211,78,333
59,151,11,1832,3086,5139,567,90,9,4343,567,5576,78,334
39,216,14,1210,2597,4076,296,116,12,3279,608,4311,78,335
23,82,59,577,1199,1940,131,51,55,1479,316,2032,78,336
173,166,9,693,1821,2862,1264,71,10,1226,337,2908,78,337
227,207,11,891,2358,3694,2026,65,18,1347,352,3808,78,338
209,324,5,890,2245,3673,1845,103,5,1305,394,3652,78,339
188,239,7,859,2341,3634,1691,111,12,1404,414,3632,78,340
116,198,14,1001,2089,3418,1005,108,19,1941,461,3534,78,341
31,533,13,940,2037,3554,347,124,4,2647,699,3821,78,342
24,252,5,824,1883,2988,190,147,6,1991,567,2901,78,343
182,265,24,604,1976,3051,1371,144,27,1275,368,3185,78,344
232,379,6,1094,2542,4253,2097,131,9,1511,471,4219,78,345
250,405,9,894,2541,4099,2157,165,11,1551,362,4246,78,346
267,453,7,933,2255,3915,1961,138,9,1650,543,4301,78,347
133,356,48,1225,2010,3772,1232,181,20,2204,457,4094,78,348
59,343,24,1122,2241,3789,231,221,15,2932,776,4175,78,349
126,69,9,861,1275,2340,407,51,13,1734,303,2508,78,350
168,203,4,740,1781,2896,1255,79,7,1434,338,3113,78,351
237,275,9,885,2662,4068,1982,111,16,1603,414,4126,78,352
186,207,20,894,2252,3559,1629,85,21,1664,359,3758,78,353
163,260,11,1045,2003,3482,1462,128,13,1510,441,3554,78,354
106,170,24,451,864,1615,551,85,32,692,234,1594,78,355
37,111,8,416,876,1448,141,93,14,919,280,1447,78,356
31,100,15,378,758,1282,121,57,22,778,252,1230,78,357
100,118,14,541,1073,1846,474,61,19,954,230,1738,78,358
72,39,4,224,522,861,205,33,5,500,101,844,78,359
19,70,7,151,348,595,29,33,6,186,154,408,78,360
123,130,26,579,1341,2199,388,71,17,1146,339,1961,78,361
23,6,11,38,11,89,26,5,12,40,12,95,78,362
37,54,7,26,10,134,31,58,5,24,19,137,78,363
42,7,37,116,10,212,47,5,44,106,13,215,78,364
120,209,6,1272,3064,4671,597,94,9,3347,719,4766,78,365
128,265,235,1280,2367,4275,727,324,72,2797,465,4385,78,366
129,63,0,191,68,451,41,115,5,141,172,474,79,1
876,179,9,460,274,1798,150,402,22,384,1010,1968,79,2
1321,129,4,496,349,2299,229,372,13,430,1281,2325,79,3
1157,221,6,470,483,2337,207,500,21,337,1368,2433,79,4
1292,260,11,710,523,2796,278,547,55,525,1302,2707,79,5
291,190,12,482,242,1217,111,332,51,320,384,1198,79,6
199,203,9,473,262,1146,86,394,29,286,341,1136,79,7
1451,184,7,611,477,2730,341,431,15,451,1406,2644,79,8
1482,145,4,610,328,2569,350,426,17,576,1288,2657,79,9
1632,220,7,793,429,3081,313,584,16,528,1457,2898,79,10
1250,204,4,691,499,2648,212,580,33,483,1477,2785,79,11
1090,217,13,706,512,2538,225,489,61,562,1257,2594,79,12
272,167,9,573,331,1352,114,343,36,410,511,1414,79,13
153,92,1,350,143,739,55,171,8,218,264,716,79,14
335,125,5,393,200,1058,143,264,14,280,356,1057,79,15
433,144,5,331,238,1151,132,334,20,239,418,1143,79,16
1133,168,6,802,406,2515,224,550,19,518,1294,2605,79,17
1590,223,10,687,464,2974,304,588,31,557,1514,2994,79,18
568,177,17,461,238,1461,182,327,52,344,576,1481,79,19
249,172,23,506,312,1262,104,419,62,339,404,1328,79,20
204,175,5,430,271,1085,79,336,15,310,388,1128,79,21
1472,226,7,692,400,2797,280,529,20,483,1427,2739,79,22
1622,199,6,702,450,2979,332,531,22,485,1572,2942,79,23
1702,222,5,732,540,3201,341,623,21,579,1674,3238,79,24
1593,221,9,739,494,3056,348,653,31,541,1519,3092,79,25
1339,241,18,764,545,2907,270,590,68,614,1299,2841,79,26
347,233,18,626,336,1560,123,413,71,430,577,1614,79,27
228,212,11,463,268,1182,96,353,22,303,477,1251,79,28
1698,215,16,740,541,3210,314,507,27,560,1636,3044,79,29
1822,225,11,691,474,3223,368,534,23,556,1772,3253,79,30
1803,150,1,701,385,3040,339,533,13,529,1567,2981,79,31
1711,171,10,670,435,2997,338,507,27,506,1554,2932,79,32
1412,191,6,679,466,2754,290,489,60,566,1419,2824,79,33
352,179,13,492,285,1321,130,347,62,298,457,1294,79,34
261,135,5,436,188,1025,79,289,21,226,389,1004,79,35
1615,181,6,604,376,2782,312,484,18,467,1513,2794,79,36
1820,162,11,580,408,2981,330,498,29,421,1662,2940,79,37
1750,143,11,745,425,3074,367,543,18,554,1550,3032,79,38
1770,168,9,652,409,3008,363,509,20,502,1626,3020,79,39
1426,186,12,669,457,2750,290,482,49,540,1370,2731,79,40
310,162,4,560,347,1383,121,393,55,330,446,1345,79,41
212,146,16,436,197,1007,87,253,31,249,421,1041,79,42
1571,177,9,615,411,2783,362,492,23,461,1497,2835,79,43
1580,181,5,605,382,2753,287,554,22,426,1551,2840,79,44
1691,177,12,725,436,3041,305,533,27,541,1520,2926,79,45
1649,168,11,627,449,2904,284,499,28,426,1647,2884,79,46
1246,185,15,636,402,2484,243,443,65,564,1219,2534,79,47
250,157,6,463,242,1118,109,298,55,293,432,1187,79,48
204,120,6,371,220,921,81,292,17,224,365,979,79,49
478,175,8,504,303,1468,133,371,21,388,636,1549,79,50
1642,193,7,608,418,2868,288,520,18,426,1612,2864,79,51
1753,175,9,663,419,3019,290,508,29,520,1636,2983,79,52
1634,194,5,688,454,2975,280,529,27,543,1591,2970,79,53
1456,185,5,601,422,2669,297,356,31,508,1418,2610,79,54
266,104,5,388,172,935,89,221,42,234,346,932,79,55
153,84,2,310,159,708,61,202,11,208,268,750,79,56
1496,168,3,612,398,2677,298,527,20,439,1489,2773,79,57
1756,157,5,602,409,2929,304,552,28,445,1616,2945,79,58
1714,196,10,608,410,2938,320,565,19,440,1558,2902,79,59
1682,187,5,569,421,2864,299,513,26,454,1632,2924,79,60
1481,198,14,696,455,2844,292,506,55,510,1404,2767,79,61
273,180,4,430,269,1156,103,330,42,305,411,1191,79,62
204,162,4,436,234,1040,81,314,13,236,397,1041,79,63
1508,185,5,625,372,2695,308,525,22,478,1529,2862,79,64
1722,175,15,597,407,2916,339,547,31,443,1675,3035,79,65
1752,186,5,640,441,3024,348,594,24,532,1622,3120,79,66
1724,174,3,653,507,3061,322,551,21,522,1690,3106,79,67
1454,204,10,700,497,2865,305,523,74,523,1454,2879,79,68
304,121,9,423,218,1075,111,307,41,296,382,1137,79,69
203,152,3,425,190,973,78,275,24,257,345,979,79,70
1628,199,15,576,361,2779,314,516,40,409,1533,2812,79,71
1797,231,7,745,428,3208,335,664,42,494,1670,3205,79,72
1754,196,1,610,384,2945,273,583,13,392,1620,2881,79,73
1312,151,1,560,312,2336,216,475,19,379,1316,2405,79,74
1093,133,7,681,334,2248,159,393,39,504,1090,2185,79,75
254,224,5,439,251,1173,84,414,46,292,401,1237,79,76
152,95,0,354,175,776,61,272,9,192,289,823,79,77
1401,198,4,465,401,2469,237,521,14,349,1533,2654,79,78
1758,175,3,654,445,3035,304,631,17,476,1724,3152,79,79
1768,182,3,687,438,3078,308,617,22,501,1598,3046,79,80
1724,188,15,673,480,3080,316,669,29,522,1674,3210,79,81
1508,216,6,650,459,2839,286,605,47,502,1427,2867,79,82
273,190,17,466,292,1238,99,421,45,274,444,1283,79,83
213,162,2,466,238,1081,88,346,12,256,433,1135,79,84
1628,222,4,662,397,2913,336,585,21,454,1536,2932,79,85
1718,220,16,747,490,3191,319,610,30,434,1848,3241,79,86
1717,237,27,708,428,3117,309,638,45,581,1636,3209,79,87
1617,206,9,636,415,2883,307,572,22,468,1604,2973,79,88
1338,234,17,702,502,2793,275,659,44,489,1426,2893,79,89
280,206,12,602,328,1428,112,462,55,369,512,1510,79,90
177,167,4,464,258,1070,73,319,20,266,407,1085,79,91
1445,223,10,704,428,2810,266,588,28,421,1500,2803,79,92
1667,179,5,650,435,2936,302,576,21,483,1598,2980,79,93
1625,159,9,622,413,2828,284,606,17,426,1631,2964,79,94
1754,214,6,760,473,3207,346,654,27,540,1760,3327,79,95
1359,233,11,715,524,2842,291,656,64,522,1287,2820,79,96
321,182,7,569,326,1405,113,461,46,361,527,1508,79,97
252,196,4,507,243,1202,101,432,18,274,455,1280,79,98
1527,199,9,607,420,2762,328,551,32,421,1533,2865,79,99
1746,180,11,722,481,3140,368,634,36,441,1741,3220,79,100
1725,180,3,722,477,3107,335,561,18,535,1714,3163,79,101
1754,180,8,641,437,3020,348,553,22,470,1701,3094,79,102
1470,225,10,686,424,2815,341,557,57,559,1398,2912,79,103
334,230,14,609,348,1535,124,541,63,379,572,1679,79,104
221,232,10,563,289,1315,87,418,23,303,466,1297,79,105
1294,244,7,714,406,2665,274,594,25,472,1288,2653,79,106
1360,215,10,762,402,2749,243,588,33,495,1453,2812,79,107
1476,204,14,724,428,2846,268,613,26,547,1178,2632,79,108
1489,200,14,744,458,2905,301,695,31,496,1428,2951,79,109
1270,202,14,687,409,2582,284,449,66,495,1269,2563,79,110
298,294,24,687,335,1638,120,617,50,343,583,1713,79,111
257,155,5,464,214,1095,91,304,16,263,421,1095,79,112
1572,192,8,610,430,2812,288,588,22,505,1565,2968,79,113
1820,202,11,713,457,3203,340,661,23,465,1733,3222,79,114
1748,184,15,712,438,3097,305,631,40,505,1712,3193,79,115
1761,231,7,726,437,3162,341,660,17,519,1628,3165,79,116
1473,227,10,740,532,2982,289,635,64,566,1444,2998,79,117
322,202,11,502,299,1336,127,414,55,348,473,1417,79,118
229,171,3,479,255,1137,79,390,23,271,445,1208,79,119
1606,206,9,623,420,2864,294,562,22,512,1481,2871,79,120
1810,219,25,696,460,3210,372,593,38,436,1767,3206,79,121
1782,248,6,715,502,3253,354,646,28,512,1715,3255,79,122
1806,272,12,708,503,3301,377,659,40,498,1632,3206,79,123
1521,235,7,754,476,2993,327,643,37,541,1403,2951,79,124
311,227,14,515,300,1367,108,471,66,381,509,1535,79,125
221,199,14,446,248,1128,107,404,30,269,430,1240,79,126
1605,206,3,614,396,2824,306,498,12,442,1564,2822,79,127
1853,220,3,685,460,3221,356,641,14,480,1727,3218,79,128
1852,240,4,768,468,3332,354,691,26,507,1683,3261,79,129
1773,196,7,708,410,3094,334,602,24,582,1614,3156,79,130
1479,227,6,629,494,2835,325,527,45,524,1493,2914,79,131
343,231,18,576,336,1504,167,469,65,409,568,1678,79,132
259,188,4,435,218,1104,112,363,19,310,405,1209,79,133
1604,209,3,654,380,2850,317,552,14,473,1549,2905,79,134
1817,200,4,638,426,3085,331,583,15,445,1690,3064,79,135
1726,184,2,707,472,3091,294,578,12,535,1660,3079,79,136
1793,237,8,761,464,3263,351,633,24,537,1728,3273,79,137
1530,214,9,684,473,2910,317,526,50,580,1368,2841,79,138
287,219,19,511,301,1337,119,491,62,352,510,1534,79,139
239,185,2,511,201,1138,93,363,25,353,423,1257,79,140
1586,229,7,634,509,2965,323,643,19,486,1616,3087,79,141
1812,205,7,687,541,3252,359,648,28,502,1815,3352,79,142
1846,258,7,785,484,3380,363,675,27,609,1803,3477,79,143
1670,241,9,622,459,3001,307,605,24,514,1592,3042,79,144
1457,255,10,730,492,2944,320,639,71,688,1284,3002,79,145
333,256,12,607,376,1584,115,577,80,401,528,1701,79,146
275,220,2,512,251,1260,116,411,30,339,544,1440,79,147
264,237,5,403,249,1158,106,370,13,308,453,1250,79,148
1735,197,3,679,461,3075,328,574,16,522,1662,3102,79,149
1766,248,5,729,383,3131,299,602,33,504,1694,3132,79,150
1792,252,0,708,471,3223,358,607,23,505,1792,3285,79,151
1489,255,16,721,529,3010,326,627,55,558,1498,3064,79,152
340,271,11,654,383,1659,119,480,56,426,565,1646,79,153
250,175,2,488,259,1174,101,397,15,305,458,1276,79,154
1622,219,3,668,459,2971,322,561,14,499,1648,3044,79,155
1719,239,4,712,453,3127,304,641,24,491,1615,3075,79,156
1854,210,3,749,427,3243,351,658,19,514,1728,3270,79,157
1737,231,3,726,552,3249,328,713,25,567,1692,3325,79,158
1504,273,16,790,529,3112,276,684,70,563,1410,3003,79,159
367,349,17,734,606,2073,161,889,133,445,683,2311,79,160
282,237,4,504,328,1355,107,533,30,335,511,1516,79,161
1591,198,7,675,439,2910,287,517,17,484,1535,2840,79,162
1804,212,5,725,448,3194,334,564,41,513,1767,3219,79,163
1785,250,6,795,471,3307,325,710,42,577,1710,3364,79,164
1676,215,8,731,457,3087,341,618,25,563,1563,3110,79,165
1453,226,18,763,527,2987,313,657,66,583,1326,2945,79,166
366,289,15,639,369,1678,134,601,80,412,612,1839,79,167
277,175,2,472,261,1187,117,418,14,344,500,1393,79,168
1392,200,3,631,394,2620,252,537,26,453,1372,2640,79,169
1577,203,34,687,439,2940,267,593,50,617,1418,2945,79,170
691,203,17,598,420,1929,225,515,35,398,763,1936,79,171
1519,230,5,718,418,2890,256,642,30,461,1447,2836,79,172
1315,270,12,690,436,2723,239,617,61,558,1282,2757,79,173
334,237,18,561,307,1457,117,597,71,384,499,1668,79,174
231,186,19,449,256,1141,89,410,51,312,441,1303,79,175
1446,158,1,619,349,2573,232,458,21,482,1379,2572,79,176
1666,247,7,721,373,3014,283,637,27,502,1542,2991,79,177
1661,211,11,662,394,2939,258,583,23,511,1707,3082,79,178
1612,221,8,650,402,2893,247,625,22,522,1568,2984,79,179
1398,285,12,770,423,2888,269,637,51,595,1302,2854,79,180
342,260,20,547,330,1499,129,478,56,393,626,1682,79,181
267,200,6,428,246,1147,108,421,13,294,405,1241,79,182
1494,196,8,697,367,2762,245,564,22,480,1511,2822,79,183
1614,221,8,706,464,3013,251,652,25,504,1565,2997,79,184
1546,252,12,763,555,3128,265,754,26,723,1367,3135,79,185
305,454,24,522,388,1693,133,760,70,376,516,1855,79,186
993,229,7,657,429,2315,231,543,62,538,967,2341,79,187
289,205,11,487,330,1322,119,419,48,326,475,1387,79,188
249,154,7,444,207,1061,91,356,12,241,447,1147,79,189
1461,178,3,680,330,2652,240,494,18,526,1419,2697,79,190
1593,194,5,622,349,2763,299,592,19,495,1440,2845,79,191
1588,212,4,671,358,2833,290,548,24,507,1541,2910,79,192
1578,195,5,703,381,2862,277,571,21,577,1506,2952,79,193
1306,222,9,712,412,2661,242,543,56,527,1297,2665,79,194
310,214,15,567,357,1463,102,537,57,370,513,1579,79,195
254,174,8,396,245,1077,77,346,16,258,372,1069,79,196
1504,146,3,597,342,2592,255,516,16,443,1307,2537,79,197
1652,163,58,637,335,2845,263,497,75,495,1475,2805,79,198
1651,146,10,687,356,2850,263,475,27,494,1572,2831,79,199
1568,194,1,704,388,2855,265,511,16,554,1437,2783,79,200
1071,231,18,489,401,2210,207,560,78,407,1174,2426,79,201
315,203,13,514,327,1372,112,490,45,331,482,1460,79,202
240,168,3,443,233,1087,92,336,16,206,429,1079,79,203
1434,139,4,579,316,2472,232,510,21,476,1302,2541,79,204
1544,153,3,706,362,2768,249,550,21,451,1579,2850,79,205
1555,169,4,612,428,2768,259,633,21,486,1543,2942,79,206
1480,159,4,672,347,2662,250,524,13,462,1549,2798,79,207
1326,206,10,726,413,2681,239,560,48,531,1215,2593,79,208
325,204,18,579,330,1456,100,490,85,350,492,1517,79,209
231,156,5,474,258,1124,85,387,33,267,397,1169,79,210
1406,169,8,617,363,2563,245,464,17,442,1334,2502,79,211
1552,182,3,647,371,2755,230,490,13,489,1524,2746,79,212
1449,200,2,677,378,2706,203,601,16,448,1486,2754,79,213
1497,213,3,782,405,2900,272,564,16,591,1470,2913,79,214
1318,204,8,737,410,2677,254,560,45,509,1203,2571,79,215
325,164,17,529,303,1338,136,395,50,329,518,1428,79,216
274,185,3,456,257,1175,104,383,18,316,493,1314,79,217
1326,178,9,615,373,2501,277,492,28,416,1308,2521,79,218
1535,167,5,608,423,2738,273,567,11,442,1378,2671,79,219
1489,155,6,613,399,2662,259,511,22,423,1401,2616,79,220
1383,168,2,632,386,2571,263,506,18,441,1370,2598,79,221
1159,197,8,564,385,2313,236,566,52,440,1038,2332,79,222
332,195,45,585,363,1520,140,473,81,416,521,1631,79,223
261,174,2,457,206,1100,91,402,12,305,405,1215,79,224
1358,182,3,617,366,2526,244,473,11,386,1313,2427,79,225
1531,226,6,633,402,2798,278,535,17,431,1526,2787,79,226
1519,170,3,674,423,2789,289,473,14,466,1540,2782,79,227
1430,169,2,669,381,2651,282,474,11,451,1383,2601,79,228
1268,186,6,693,442,2595,258,498,44,544,1141,2485,79,229
302,228,15,542,333,1420,132,461,50,372,530,1545,79,230
239,163,5,398,237,1042,96,371,21,257,387,1132,79,231
1320,163,5,498,344,2330,249,389,14,325,1330,2307,79,232
1440,174,7,624,410,2655,271,540,22,440,1407,2680,79,233
1530,204,2,616,460,2812,303,608,27,428,1473,2839,79,234
1474,177,13,624,401,2689,306,486,32,449,1343,2616,79,235
1316,226,10,698,483,2733,304,548,41,526,1312,2731,79,236
328,192,17,585,339,1461,127,430,48,424,558,1587,79,237
257,168,10,457,238,1130,86,339,19,284,428,1156,79,238
1452,164,13,566,413,2608,269,467,22,378,1407,2543,79,239
1693,150,5,632,427,2907,295,530,18,415,1539,2797,79,240
1651,131,2,623,387,2794,309,532,11,390,1473,2715,79,241
1626,137,16,664,436,2879,323,465,23,469,1626,2906,79,242
1390,171,13,639,411,2624,291,461,44,561,1241,2598,79,243
303,174,6,583,291,1357,129,425,27,305,452,1338,79,244
230,151,3,421,220,1025,86,266,13,283,389,1037,79,245
223,142,2,387,219,973,81,276,6,256,346,965,79,246
1652,177,2,563,412,2806,279,473,14,416,1610,2792,79,247
1684,171,5,635,391,2886,273,516,16,497,1634,2936,79,248
1756,176,3,639,440,3014,347,510,12,483,1659,3011,79,249
1549,201,5,647,471,2873,335,557,39,526,1521,2978,79,250
318,225,15,505,274,1337,99,420,44,342,461,1366,79,251
247,144,2,396,202,991,101,292,12,262,324,991,79,252
1644,167,7,617,421,2856,263,508,19,373,1570,2733,79,253
1821,169,2,639,481,3112,288,608,14,438,1847,3195,79,254
1797,162,4,641,451,3055,283,552,18,480,1720,3053,79,255
1727,144,12,648,437,2968,337,579,18,386,1631,2951,79,256
1555,171,5,656,483,2870,329,587,37,505,1398,2856,79,257
294,180,15,622,319,1430,113,441,54,319,481,1408,79,258
224,117,14,452,211,1018,69,292,23,232,401,1017,79,259
1599,167,10,502,480,2758,301,507,24,390,1822,3044,79,260
1798,157,3,601,405,2964,315,530,12,482,1609,2948,79,261
1746,151,14,570,455,2936,261,586,31,417,1705,3000,79,262
1841,196,12,723,528,3300,395,632,25,476,1782,3310,79,263
1591,184,11,715,439,2940,313,483,64,538,1423,2821,79,264
308,191,14,537,336,1386,116,426,45,294,485,1366,79,265
212,137,10,403,202,964,85,286,24,221,354,970,79,266
1575,133,7,531,404,2650,276,433,10,402,1507,2628,79,267
1827,173,8,620,479,3107,333,618,20,431,1718,3120,79,268
1746,170,4,600,450,2970,271,507,20,406,1512,2716,79,269
1730,151,4,605,413,2903,276,509,18,453,1532,2788,79,270
1538,170,5,586,417,2716,251,509,47,465,1266,2538,79,271
357,241,12,561,386,1557,112,481,56,381,512,1542,79,272
228,142,7,471,248,1096,109,348,21,273,367,1118,79,273
1611,163,2,587,502,2865,259,502,13,458,1618,2850,79,274
1696,150,8,565,485,2904,273,470,23,414,1712,2892,79,275
1781,204,4,651,461,3101,286,605,10,495,1825,3221,79,276
1689,167,29,625,409,2919,317,442,31,445,1560,2795,79,277
1464,228,14,583,503,2792,292,575,61,458,1371,2757,79,278
285,145,10,531,303,1274,84,369,37,323,433,1246,79,279
217,131,7,347,192,894,70,276,15,214,355,930,79,280
1571,175,24,514,509,2793,269,479,30,406,1648,2832,79,281
1814,195,8,568,498,3083,293,512,30,453,1781,3069,79,282
1813,157,4,623,433,3030,319,489,18,444,1578,2848,79,283
1510,196,3,640,450,2799,300,515,18,405,1442,2680,79,284
1267,175,11,593,433,2479,206,483,45,464,1170,2368,79,285
292,153,7,491,300,1243,75,394,30,291,428,1218,79,286
212,108,2,405,225,952,65,338,12,265,327,1007,79,287
640,145,2,503,295,1585,139,326,16,379,727,1587,79,288
1761,170,5,570,407,2913,318,494,21,476,1598,2907,79,289
1792,156,38,561,395,2942,281,507,48,433,1601,2870,79,290
1717,186,3,572,487,2965,327,622,20,419,1725,3113,79,291
1432,207,9,615,533,2796,245,555,47,426,1521,2794,79,292
274,166,12,503,361,1316,96,433,56,398,457,1440,79,293
209,163,4,407,188,971,64,370,17,240,334,1025,79,294
1581,152,12,541,374,2660,264,429,29,428,1467,2617,79,295
1720,158,5,639,440,2962,266,477,21,497,1634,2895,79,296
1742,163,7,708,428,3048,301,525,24,531,1652,3033,79,297
1620,182,3,597,476,2878,284,563,13,419,1524,2803,79,298
1487,220,11,625,480,2823,301,421,52,560,1383,2717,79,299
323,209,9,498,325,1364,114,373,60,370,423,1340,79,300
222,131,3,396,187,939,88,292,13,222,323,938,79,301
1504,147,4,486,403,2544,287,408,16,373,1396,2480,79,302
1682,171,2,601,508,2964,270,544,10,475,1479,2778,79,303
1690,174,6,584,434,2888,286,454,29,432,1605,2806,79,304
1619,207,9,547,447,2829,300,459,28,400,1455,2642,79,305
1402,182,10,552,460,2606,300,401,34,449,1339,2523,79,306
268,151,18,507,293,1237,100,382,30,311,427,1250,79,307
243,86,5,353,189,876,78,229,12,264,287,870,79,308
1432,125,8,586,386,2537,233,390,16,454,1355,2448,79,309
1359,128,6,545,365,2403,221,346,13,520,1192,2292,79,310
1590,140,10,552,371,2663,302,447,17,388,1531,2685,79,311
1636,174,3,537,367,2717,280,404,16,427,1502,2629,79,312
1465,162,13,568,485,2693,326,433,39,498,1349,2645,79,313
261,187,9,443,277,1177,122,356,34,313,433,1258,79,314
215,91,2,361,180,849,69,216,4,235,286,810,79,315
597,125,1,495,265,1483,141,297,9,368,637,1452,79,316
1504,149,2,523,367,2545,249,395,11,438,1596,2689,79,317
1775,155,4,570,378,2882,395,420,11,397,1606,2829,79,318
1617,143,19,564,333,2676,304,384,25,378,1444,2535,79,319
1462,158,11,551,387,2569,268,351,25,428,1251,2323,79,320
289,141,15,471,288,1204,88,288,29,308,462,1175,79,321
204,91,4,396,215,910,82,207,8,238,314,849,79,322
1721,132,4,540,398,2795,334,364,11,418,1480,2607,79,323
1925,122,6,527,342,2922,360,409,15,420,1535,2739,79,324
1806,173,5,659,407,3050,338,490,11,499,1620,2958,79,325
1708,144,8,570,414,2844,327,451,13,376,1491,2658,79,326
1423,126,9,534,390,2482,290,382,22,427,1175,2296,79,327
281,139,6,448,254,1128,100,293,34,300,396,1123,79,328
203,104,6,381,166,860,71,246,14,232,292,855,79,329
1491,147,2,565,361,2566,238,399,29,438,1314,2418,79,330
1390,153,10,546,392,2491,193,382,20,440,1401,2436,79,331
1092,134,5,512,334,2077,187,342,16,607,866,2018,79,332
127,126,4,221,134,612,62,124,3,179,257,625,79,333
542,178,10,516,301,1547,131,280,10,410,582,1413,79,334
253,116,10,418,244,1041,87,256,20,334,397,1094,79,335
229,98,1,409,188,925,71,221,8,272,326,898,79,336
1511,126,4,503,335,2479,251,367,12,392,1300,2322,79,337
1644,145,3,568,383,2743,270,404,10,424,1493,2601,79,338
1659,121,5,540,310,2635,245,399,13,393,1486,2536,79,339
1624,114,7,540,329,2614,250,424,16,367,1409,2466,79,340
1387,127,5,561,351,2431,216,366,39,450,1174,2245,79,341
255,113,13,412,290,1083,112,318,37,310,405,1182,79,342
197,108,2,351,220,878,60,248,8,209,326,851,79,343
1526,128,2,507,340,2503,249,345,10,412,1388,2404,79,344
1637,123,11,550,346,2667,272,420,19,419,1505,2635,79,345
1638,134,0,538,287,2597,237,418,12,399,1446,2512,79,346
1448,132,0,506,322,2408,242,409,12,370,1303,2336,79,347
1229,168,9,551,415,2372,213,410,40,420,1242,2325,79,348
273,134,17,419,298,1141,86,346,40,317,417,1206,79,349
219,95,6,348,197,865,94,236,15,208,332,885,79,350
1638,136,6,582,393,2755,285,411,17,453,1565,2731,79,351
1728,167,7,573,426,2901,303,409,15,433,1585,2745,79,352
1679,129,5,582,382,2777,268,445,15,413,1504,2645,79,353
1570,143,4,592,431,2740,295,417,14,425,1564,2715,79,354
1301,155,15,536,393,2400,212,369,35,438,1245,2299,79,355
264,120,17,448,242,1091,107,262,34,325,416,1144,79,356
183,86,0,349,163,781,74,205,6,201,277,763,79,357
984,118,3,508,286,1899,183,349,11,431,887,1861,79,358
616,99,2,391,198,1306,161,193,6,394,520,1274,79,359
86,82,1,211,116,496,73,109,5,143,155,485,79,360
730,148,1,461,337,1677,119,384,10,294,883,1690,79,361
810,128,16,476,339,1769,149,281,26,355,750,1561,79,362
242,123,14,347,237,963,84,284,33,245,341,987,79,363
213,100,4,391,228,936,81,239,8,271,350,949,79,364
998,138,4,555,340,2035,204,345,8,456,940,1953,79,365
1040,247,42,494,301,2124,240,340,66,539,802,1987,79,366
47,47,3,85,59,241,27,47,2,85,98,259,80,1
134,58,11,167,198,568,144,48,9,167,213,581,80,2
179,68,7,163,215,632,207,68,12,171,241,699,80,3
159,81,7,205,218,670,194,54,8,183,243,682,80,4
122,93,3,151,186,555,142,71,5,162,184,564,80,5
26,47,6,95,64,238,39,49,11,87,92,278,80,6
33,51,2,114,94,294,33,56,5,124,117,335,80,7
143,74,6,134,209,566,172,75,8,141,221,617,80,8
168,66,8,125,173,540,224,70,10,128,185,617,80,9
178,82,13,159,231,663,236,75,14,146,234,705,80,10
175,89,5,188,244,701,220,87,6,176,233,722,80,11
110,53,5,138,166,472,132,48,11,165,156,512,80,12
33,71,4,145,84,337,47,65,11,115,116,354,80,13
26,39,2,84,85,236,27,36,2,98,83,246,80,14
44,53,14,68,109,288,61,38,12,103,66,280,80,15
74,70,6,86,130,366,98,40,7,125,88,358,80,16
136,53,2,142,221,554,212,58,4,128,205,607,80,17
172,66,2,180,258,678,216,105,6,152,244,723,80,18
116,57,9,145,107,434,84,63,13,96,164,420,80,19
34,65,6,130,106,341,34,92,12,126,99,363,80,20
38,55,6,82,72,253,21,54,4,109,89,277,80,21
132,60,4,136,219,551,171,57,5,135,210,578,80,22
180,63,18,165,246,672,234,72,14,171,233,724,80,23
192,79,4,142,247,664,230,74,7,136,256,703,80,24
180,89,5,176,238,688,212,101,6,150,297,766,80,25
149,72,3,161,223,608,167,87,8,171,204,637,80,26
48,75,8,226,127,484,68,75,7,198,151,499,80,27
41,44,14,96,82,277,24,45,11,117,78,275,80,28
147,80,9,181,202,619,202,70,9,139,209,629,80,29
187,74,5,115,253,634,202,78,6,149,223,658,80,30
164,68,5,157,241,635,207,87,6,140,227,667,80,31
181,91,2,197,223,694,209,91,4,175,265,744,80,32
128,91,10,162,199,590,175,79,10,167,182,613,80,33
33,80,3,157,103,376,59,44,3,150,132,388,80,34
23,44,5,120,96,288,27,36,6,117,106,292,80,35
133,76,6,163,226,604,186,67,4,144,231,632,80,36
210,86,13,152,238,699,271,90,13,140,265,779,80,37
193,81,9,161,251,695,245,85,10,164,242,746,80,38
188,131,7,171,244,741,233,176,11,132,251,803,80,39
108,82,8,174,210,582,175,82,16,157,196,626,80,40
41,86,6,154,89,376,68,52,22,152,88,382,80,41
29,51,3,128,88,299,33,61,8,122,92,316,80,42
130,59,3,170,181,543,176,63,3,136,196,574,80,43
163,72,8,147,235,625,225,100,7,124,224,680,80,44
190,73,7,176,233,679,216,92,13,171,231,723,80,45
165,73,1,162,248,649,233,80,7,163,227,710,80,46
112,131,7,146,229,625,180,106,23,189,233,731,80,47
47,73,5,145,95,365,56,79,8,155,141,439,80,48
35,50,2,114,93,294,25,50,5,128,114,322,80,49
56,60,4,128,147,395,84,61,5,122,135,407,80,50
195,74,4,159,257,689,255,82,4,130,242,713,80,51
196,77,3,156,237,669,243,80,3,131,251,708,80,52
182,68,3,165,262,680,234,76,3,128,255,696,80,53
103,90,6,175,212,586,169,80,9,157,226,641,80,54
41,76,5,163,113,398,61,66,9,142,155,433,80,55
30,60,7,121,87,305,30,70,8,125,101,334,80,56
151,61,5,158,225,600,184,73,7,129,210,603,80,57
211,75,16,137,227,666,195,94,18,150,255,712,80,58
180,70,11,123,236,620,178,96,16,147,258,695,80,59
187,85,2,154,239,667,226,102,4,147,260,739,80,60
121,78,5,184,221,609,174,96,10,169,232,681,80,61
32,78,6,142,121,379,55,79,14,138,146,432,80,62
36,75,9,140,85,345,27,65,8,122,137,359,80,63
127,77,8,189,237,638,185,83,6,157,218,649,80,64
204,90,4,198,225,721,199,128,9,195,304,835,80,65
215,82,3,186,230,716,233,101,3,159,251,747,80,66
212,91,6,206,273,788,219,107,7,189,302,824,80,67
123,78,9,200,229,639,181,88,11,175,251,706,80,68
80,90,3,127,89,389,65,88,23,120,127,423,80,69
35,74,2,97,96,304,25,59,4,142,128,358,80,70
132,77,7,156,187,559,174,80,4,133,213,604,80,71
191,96,6,205,258,756,245,112,5,156,285,803,80,72
218,101,2,185,273,779,225,123,4,163,278,793,80,73
208,110,5,199,285,807,233,131,11,175,279,829,80,74
141,90,8,203,217,659,181,106,20,187,219,713,80,75
59,100,4,287,131,581,55,112,18,181,216,582,80,76
42,71,3,164,117,397,21,102,4,153,149,429,80,77
174,71,4,178,220,647,174,103,4,143,230,654,80,78
221,96,5,182,245,749,229,135,7,129,297,797,80,79
242,103,3,203,271,822,267,131,8,167,303,876,80,80
216,97,6,197,255,771,248,116,7,199,294,864,80,81
155,102,10,222,224,713,167,130,17,176,280,770,80,82
49,82,5,183,137,456,44,108,10,129,164,455,80,83
68,56,2,219,119,464,35,82,5,147,171,440,80,84
166,109,5,276,224,780,192,162,8,160,328,850,80,85
250,76,2,212,266,806,183,132,2,171,330,818,80,86
209,78,6,158,250,701,197,115,11,144,283,750,80,87
198,102,2,208,218,728,183,124,5,163,300,775,80,88
129,118,7,273,237,764,141,191,18,139,254,743,80,89
95,92,3,319,135,644,55,135,13,203,251,657,80,90
67,59,4,174,104,408,32,82,7,197,152,470,80,91
144,98,4,226,286,758,166,169,8,149,307,799,80,92
253,87,4,229,272,845,213,156,8,180,366,923,80,93
216,105,1,203,259,784,220,168,2,152,290,832,80,94
283,87,6,229,289,894,237,141,10,170,444,1002,80,95
155,77,8,269,247,756,175,119,13,171,280,758,80,96
163,79,7,215,151,615,65,176,7,200,162,610,80,97
72,71,3,170,125,441,31,127,5,196,121,480,80,98
181,89,1,182,230,683,205,86,6,144,236,677,80,99
204,90,5,193,273,765,229,128,11,173,277,818,80,100
217,85,5,197,297,801,228,128,7,198,288,849,80,101
215,81,21,210,274,801,247,115,21,176,287,846,80,102
145,108,3,202,215,673,171,112,8,175,223,689,80,103
165,113,4,227,159,668,69,131,14,215,202,631,80,104
35,94,31,182,113,455,38,86,29,151,160,464,80,105
182,93,4,223,244,746,186,94,10,159,263,712,80,106
252,98,5,197,298,850,247,154,15,176,309,901,80,107
265,78,4,199,321,867,255,146,9,166,324,900,80,108
241,96,4,222,317,880,248,130,12,183,362,935,80,109
169,106,7,183,239,704,177,143,21,197,235,773,80,110
59,112,8,253,174,606,58,168,22,174,187,609,80,111
26,64,2,127,133,352,28,77,3,156,118,382,80,112
151,100,8,188,242,689,185,96,13,196,237,727,80,113
188,90,5,184,297,764,241,115,8,180,297,841,80,114
229,89,7,194,290,809,257,110,12,160,293,832,80,115
243,84,2,171,287,787,257,125,7,188,280,857,80,116
115,84,3,150,233,585,141,104,7,162,174,588,80,117
55,91,5,149,114,414,64,87,18,157,119,445,80,118
29,80,1,173,123,406,43,77,10,175,122,427,80,119
153,88,9,172,215,637,187,70,12,193,226,688,80,120
199,97,4,153,279,732,259,110,11,170,257,807,80,121
223,85,5,208,276,797,234,107,17,175,287,820,80,122
197,90,2,216,283,788,265,112,6,193,254,830,80,123
149,105,7,203,261,725,190,131,19,181,249,770,80,124
50,78,5,165,119,417,60,88,11,140,126,425,80,125
32,70,2,130,131,365,37,75,7,152,142,413,80,126
200,107,2,164,221,694,273,113,4,173,260,823,80,127
226,100,8,212,297,843,277,178,16,312,388,1171,80,128
237,113,13,198,303,864,309,147,17,191,300,964,80,129
206,77,9,193,311,796,262,125,14,185,276,862,80,130
136,95,6,176,209,622,199,90,10,171,230,700,80,131
63,111,2,209,154,539,79,89,13,176,224,581,80,132
37,82,1,130,119,369,58,81,9,202,126,476,80,133
173,134,5,150,375,837,253,116,9,151,358,887,80,134
212,80,9,185,291,777,243,114,8,180,291,836,80,135
231,102,4,212,266,815,248,128,6,186,283,851,80,136
232,89,2,232,312,867,261,147,6,176,330,920,80,137
157,108,4,216,261,746,209,145,15,162,251,782,80,138
47,88,5,191,123,454,54,100,13,151,168,486,80,139
59,69,2,192,122,444,53,117,6,186,166,528,80,140
174,108,4,237,278,801,207,129,3,184,264,787,80,141
239,103,5,212,340,899,256,119,10,192,326,903,80,142
251,105,3,218,304,881,249,136,4,184,328,901,80,143
212,86,3,171,319,791,264,125,4,165,322,880,80,144
145,111,6,207,282,751,164,149,10,206,208,737,80,145
60,110,4,231,166,571,66,146,12,168,163,555,80,146
124,96,1,245,118,584,35,123,6,189,258,611,80,147
42,87,2,153,111,395,35,93,3,159,123,413,80,148
218,98,6,176,295,793,253,112,15,161,282,823,80,149
214,104,4,197,264,783,263,92,5,169,273,802,80,150
228,117,3,213,314,875,274,113,5,195,327,914,80,151
143,121,7,207,251,729,208,125,12,151,243,739,80,152
47,113,5,215,120,500,66,132,15,189,154,556,80,153
30,81,8,174,132,425,42,91,6,183,144,466,80,154
195,104,3,173,287,762,230,116,12,174,280,812,80,155
287,98,5,230,354,974,300,139,7,209,342,997,80,156
308,102,4,207,359,980,266,130,6,249,330,981,80,157
273,111,5,233,310,932,285,162,9,227,328,1011,80,158
194,110,4,178,334,820,199,175,26,172,237,809,80,159
105,115,9,295,211,735,65,219,22,212,250,768,80,160
68,92,7,214,120,501,47,123,5,160,185,520,80,161
205,91,4,214,296,810,247,116,7,169,291,830,80,162
259,121,3,219,360,962,287,119,9,182,302,899,80,163
248,98,4,183,337,870,289,129,10,166,321,915,80,164
255,110,3,221,294,883,289,137,16,251,389,1082,80,165
170,112,4,227,295,808,205,161,23,253,221,863,80,166
65,111,6,217,146,545,43,146,16,185,166,556,80,167
38,107,3,196,104,448,29,112,4,192,151,488,80,168
173,104,5,175,253,710,218,85,7,160,347,817,80,169
269,141,10,215,350,985,295,166,15,221,563,1260,80,170
106,105,6,199,248,664,148,131,6,196,201,682,80,171
213,124,7,254,302,900,276,121,6,172,349,924,80,172
162,104,4,166,266,702,198,145,14,143,304,804,80,173
66,144,12,210,149,581,52,125,29,231,179,616,80,174
59,86,2,145,123,415,47,91,4,166,156,464,80,175
154,97,8,176,262,697,218,122,9,163,215,727,80,176
348,131,6,175,306,966,289,137,13,194,339,972,80,177
243,96,7,205,279,830,277,142,10,166,300,895,80,178
249,125,5,202,305,886,262,141,6,199,316,924,80,179
185,129,4,193,248,759,195,124,16,173,264,772,80,180
70,120,2,223,167,582,54,145,16,233,313,761,80,181
41,74,2,169,109,395,38,99,4,153,136,430,80,182
186,96,4,160,284,730,236,96,6,176,248,762,80,183
228,109,24,198,330,889,281,117,33,202,272,905,80,184
177,97,7,194,307,782,240,122,13,176,228,779,80,185
45,200,6,279,228,758,43,344,5123,210,180,5900,80,186
132,106,6,163,194,601,3108,110,14,170,155,3557,80,187
58,114,4,205,125,506,54,137,10,157,172,530,80,188
37,78,8,183,97,403,46,90,7,174,120,437,80,189
170,99,6,194,268,737,231,116,8,156,245,756,80,190
235,130,3,177,322,867,289,121,2,184,318,914,80,191
208,112,3,198,289,810,272,104,6,147,302,831,80,192
238,128,5,209,322,902,272,133,13,182,325,925,80,193
147,112,5,195,232,691,175,136,18,181,242,752,80,194
59,125,4,241,172,601,51,190,20,185,180,626,80,195
76,67,3,168,105,419,35,88,9,144,131,407,80,196
195,103,9,152,253,712,228,104,12,148,223,715,80,197
237,113,4,153,316,823,248,120,8,155,307,838,80,198
226,106,3,152,254,741,254,104,6,140,274,778,80,199
224,116,16,215,311,882,239,134,19,192,326,910,80,200
154,147,2,223,284,810,206,147,26,167,261,807,80,201
72,113,4,223,139,551,55,169,22,171,182,599,80,202
62,94,4,207,123,490,52,101,4,168,169,494,80,203
180,93,11,164,283,731,222,114,15,137,232,720,80,204
255,122,9,213,304,903,277,133,9,169,321,909,80,205
231,117,9,164,286,807,257,125,10,149,309,850,80,206
225,152,9,195,323,904,246,160,7,172,328,913,80,207
148,133,3,201,271,756,192,135,24,179,231,761,80,208
63,101,6,237,184,591,69,120,31,188,202,610,80,209
31,104,5,178,104,422,47,95,9,148,150,449,80,210
181,88,3,176,282,730,241,88,28,170,222,749,80,211
250,125,4,175,314,868,279,110,4,182,306,881,80,212
242,108,3,163,291,807,264,121,5,160,273,823,80,213
232,118,8,187,289,834,258,100,12,188,326,884,80,214
145,103,3,174,222,647,199,105,23,170,195,692,80,215
59,88,3,221,139,510,53,137,14,189,147,540,80,216
48,93,4,178,115,438,30,87,4,185,144,450,80,217
191,96,2,195,261,745,248,112,7,180,216,763,80,218
281,101,2,196,342,922,312,130,4,192,302,940,80,219
235,112,3,208,281,839,262,102,6,162,283,815,80,220
215,97,6,202,232,752,254,84,10,147,277,772,80,221
129,119,8,138,243,637,169,131,17,144,177,638,80,222
48,128,2,186,156,520,55,111,12,187,177,542,80,223
61,73,3,151,117,405,33,82,7,153,137,412,80,224
180,103,5,169,299,756,259,101,9,177,259,805,80,225
225,117,3,146,321,812,279,125,3,171,279,857,80,226
258,102,5,167,288,820,251,107,7,164,298,827,80,227
201,138,2,201,298,840,255,125,6,193,291,870,80,228
147,112,8,154,249,670,187,115,15,163,218,698,80,229
34,105,3,190,134,466,53,97,16,171,153,490,80,230
39,84,3,163,116,405,32,87,6,155,128,408,80,231
163,123,4,208,276,774,214,118,4,192,255,783,80,232
253,114,8,205,345,925,274,123,8,193,308,906,80,233
232,108,3,202,303,848,253,123,4,167,313,860,80,234
244,116,3,154,289,806,248,103,9,170,267,797,80,235
133,102,7,154,252,648,190,116,15,166,207,694,80,236
55,106,1,217,162,541,52,122,7,189,180,550,80,237
29,89,9,172,99,398,40,88,6,197,121,452,80,238
179,96,4,215,277,771,231,109,5,200,251,796,80,239
219,129,5,190,331,874,283,150,4,174,284,895,80,240
221,100,36,170,294,821,267,117,42,146,272,844,80,241
221,69,3,154,273,720,247,82,16,145,247,737,80,242
114,87,10,154,237,602,188,91,15,153,182,629,80,243
39,110,3,212,161,525,61,128,7,188,159,543,80,244
24,90,1,201,119,435,36,96,5,150,163,450,80,245
39,77,3,153,118,390,55,75,6,187,96,419,80,246
228,89,4,148,288,757,230,110,5,153,317,815,80,247
215,78,11,181,292,777,266,93,16,147,312,834,80,248
227,109,4,172,269,781,266,131,4,149,276,826,80,249
147,120,5,161,214,647,199,112,10,166,211,698,80,250
47,93,4,170,123,437,68,92,18,161,168,507,80,251
20,82,5,149,120,376,34,97,5,163,135,434,80,252
200,85,3,153,300,741,264,100,13,157,254,788,80,253
303,118,4,195,383,1003,315,166,8,172,322,983,80,254
269,107,5,213,298,892,269,139,7,190,335,940,80,255
237,112,1,183,309,842,251,135,8,163,345,902,80,256
156,107,4,185,254,706,218,136,17,155,224,750,80,257
70,97,3,205,150,525,60,148,17,180,159,564,80,258
46,71,3,144,120,384,36,100,7,166,143,452,80,259
204,81,12,152,289,738,250,103,12,156,239,760,80,260
286,94,8,172,356,916,298,121,10,177,310,916,80,261
247,91,2,167,303,810,248,124,7,160,279,818,80,262
241,118,11,172,309,851,299,143,7,144,282,875,80,263
205,86,3,164,277,735,221,106,11,181,229,748,80,264
53,94,2,226,178,553,70,104,15,187,183,559,80,265
30,51,3,161,102,347,41,70,5,172,140,428,80,266
186,83,2,134,287,692,241,94,4,161,214,714,80,267
240,102,4,196,329,871,292,121,7,171,307,898,80,268
246,95,2,209,306,858,256,106,13,179,309,863,80,269
225,119,2,178,302,826,237,127,7,162,318,851,80,270
147,103,4,170,281,705,197,146,17,166,234,760,80,271
49,108,8,179,182,526,72,127,16,178,158,551,80,272
29,62,1,150,107,349,42,86,4,139,111,382,80,273
143,75,2,139,255,614,230,84,6,128,199,647,80,274
252,103,8,155,294,812,270,112,7,148,307,844,80,275
242,98,7,145,301,793,275,119,12,145,259,810,80,276
204,118,2,188,332,844,263,136,6,151,312,868,80,277
152,118,7,147,239,663,201,114,15,182,214,726,80,278
51,89,4,200,165,509,70,118,11,194,163,556,80,279
32,80,8,158,127,405,51,70,11,164,185,481,80,280
177,93,1,151,293,715,241,97,7,144,283,772,80,281
259,124,3,164,369,919,286,129,7,156,330,908,80,282
250,98,2,180,310,840,253,119,15,140,338,865,80,283
237,119,2,194,309,861,278,120,9,177,301,885,80,284
144,100,5,199,274,722,215,106,9,179,247,756,80,285
76,74,12,185,179,526,61,127,18,171,182,559,80,286
62,78,3,201,150,494,50,106,10,192,153,511,80,287
126,79,3,173,223,604,180,120,7,155,189,651,80,288
271,109,3,174,335,892,262,163,11,135,315,886,80,289
265,88,2,186,296,837,282,119,8,169,315,893,80,290
217,98,4,202,314,835,276,147,7,172,292,894,80,291
206,110,1,205,270,792,205,171,13,172,256,817,80,292
48,105,5,203,189,550,63,111,19,193,187,573,80,293
62,69,3,196,161,491,31,118,8,172,164,493,80,294
197,82,6,180,301,766,253,101,9,169,262,794,80,295
240,81,2,175,320,818,302,119,3,128,306,858,80,296
250,95,3,195,340,883,290,166,6,177,315,954,80,297
255,114,3,192,315,879,274,131,9,173,334,921,80,298
151,107,4,206,300,768,221,133,13,161,265,793,80,299
65,98,10,246,162,581,53,126,18,230,223,650,80,300
82,82,6,188,136,494,51,91,16,174,154,486,80,301
176,98,11,156,336,777,249,109,9,126,272,765,80,302
234,97,10,197,378,916,301,163,13,173,305,955,80,303
244,91,4,172,336,847,263,118,5,141,346,873,80,304
187,96,4,178,278,743,279,101,9,162,268,819,80,305
121,108,7,166,268,670,221,88,9,152,232,702,80,306
53,88,4,189,195,529,56,101,24,187,175,543,80,307
35,68,3,151,114,371,31,59,3,142,135,370,80,308
167,88,2,150,277,684,268,80,4,151,228,731,80,309
180,90,4,180,362,816,321,59,8,179,278,845,80,310
183,100,4,167,305,759,260,106,6,134,255,761,80,311
211,98,3,157,293,762,291,133,6,159,257,846,80,312
149,119,3,155,453,879,228,91,14,176,997,1506,80,313
41,90,3,219,153,506,75,74,23,167,158,497,80,314
38,51,2,150,111,352,45,45,5,158,128,381,80,315
102,75,3,159,217,556,164,83,6,157,188,598,80,316
232,92,2,160,315,801,305,105,8,139,324,881,80,317
223,84,5,170,323,805,278,80,8,141,311,818,80,318
216,89,6,171,294,776,281,112,17,164,233,807,80,319
143,85,4,168,263,663,220,94,10,178,198,700,80,320
41,89,4,197,165,496,45,81,17,202,192,537,80,321
41,68,3,124,129,365,36,57,5,144,145,387,80,322
152,104,2,143,309,710,257,91,4,166,246,764,80,323
249,78,3,153,319,802,272,90,6,179,304,851,80,324
227,89,3,162,328,809,243,95,6,155,301,800,80,325
224,82,5,172,323,806,249,103,10,187,246,795,80,326
129,68,3,159,201,560,185,87,8,167,178,625,80,327
49,72,5,147,159,432,64,52,11,196,132,455,80,328
43,73,4,135,105,360,27,61,5,158,140,391,80,329
168,81,7,192,240,688,222,86,6,186,236,736,80,330
178,85,6,173,289,731,219,104,7,199,258,787,80,331
113,65,5,200,189,572,160,88,8,206,178,640,80,332
35,34,2,41,42,154,26,15,1,59,87,188,80,333
62,72,2,142,142,420,64,78,8,190,163,503,80,334
39,71,5,172,135,422,50,77,8,162,153,450,80,335
33,51,6,139,98,327,30,50,6,125,128,339,80,336
145,74,12,129,259,619,227,83,10,133,196,649,80,337
222,103,7,155,285,772,270,115,10,152,280,827,80,338
201,73,9,167,244,694,236,90,8,148,232,714,80,339
197,69,11,139,250,666,220,88,19,148,248,723,80,340
114,85,12,127,221,559,169,64,17,146,212,608,80,341
41,79,1,160,163,444,57,76,13,187,143,476,80,342
27,61,9,132,118,347,28,51,12,167,134,392,80,343
181,88,9,144,218,640,201,101,6,130,239,677,80,344
254,97,8,164,302,825,251,133,5,149,326,864,80,345
258,94,13,133,227,725,214,118,8,144,244,728,80,346
242,85,10,150,300,787,232,128,12,150,278,800,80,347
138,96,10,167,258,669,209,103,13,171,210,706,80,348
36,91,16,195,163,501,54,124,20,177,161,536,80,349
32,48,1,101,97,279,38,61,4,125,105,333,80,350
148,80,10,127,239,604,194,93,10,149,195,641,80,351
199,74,5,180,311,769,235,101,16,181,270,803,80,352
190,68,2,169,265,694,208,90,5,176,272,751,80,353
178,75,8,165,268,694,230,101,13,163,221,728,80,354
94,83,3,123,232,535,141,93,14,144,147,539,80,355
31,57,3,167,133,391,40,74,8,149,109,380,80,356
34,45,1,126,84,290,27,75,3,118,86,309,80,357
72,55,3,172,191,493,128,59,5,125,182,499,80,358
53,39,4,114,90,300,85,32,6,114,93,330,80,359
22,20,4,37,35,118,16,25,4,55,39,139,80,360
63,54,2,141,165,425,104,64,3,141,156,468,80,361
57,61,3,140,181,442,114,75,3,145,147,484,80,362
27,60,4,130,112,333,34,62,8,130,125,359,80,363
12,52,0,111,106,281,29,42,7,94,110,282,80,364
88,80,3,141,200,512,143,70,6,140,174,533,80,365
82,87,16,206,141,532,135,67,44,152,170,568,80,366
76,107,10,357,181,731,46,168,16,271,266,767,81,1
484,200,27,439,349,1499,216,270,28,357,653,1524,81,2
653,196,47,481,592,1969,467,269,33,431,807,2007,81,3
676,187,38,514,588,2003,444,268,36,431,763,1942,81,4
534,203,20,477,598,1832,411,304,33,409,630,1787,81,5
110,131,10,384,203,838,60,245,26,280,205,816,81,6
123,133,14,360,251,881,65,248,20,299,302,934,81,7
689,192,5,456,627,1969,494,301,8,471,769,2043,81,8
749,106,5,470,421,1751,456,216,6,406,698,1782,81,9
863,218,12,534,655,2282,499,297,12,487,864,2159,81,10
705,187,5,500,687,2084,456,301,13,449,860,2079,81,11
538,173,19,496,645,1871,433,275,20,460,648,1836,81,12
140,140,6,558,266,1110,68,252,31,315,461,1127,81,13
114,113,2,356,213,798,49,185,8,294,270,806,81,14
150,159,5,325,214,853,102,196,10,268,321,897,81,15
266,140,4,389,260,1059,107,224,5,297,369,1002,81,16
650,152,3,489,556,1850,199,307,6,504,807,1823,81,17
774,170,7,472,663,2086,427,316,19,423,841,2026,81,18
334,168,8,2020,306,2836,1201,267,18,366,472,2324,81,19
125,130,13,429,254,951,45,241,35,290,350,961,81,20
105,120,5,351,233,814,50,202,12,276,291,831,81,21
704,167,2,454,677,2004,437,278,10,437,771,1933,81,22
856,158,9,494,731,2248,498,360,14,423,983,2278,81,23
798,201,4,635,721,2359,498,354,7,571,934,2364,81,24
762,187,5,529,701,2184,462,356,11,475,864,2168,81,25
499,282,12,537,477,1807,269,373,45,434,693,1814,81,26
148,183,18,485,333,1167,90,285,30,373,339,1117,81,27
104,153,8,370,208,843,61,223,16,291,292,883,81,28
698,216,4,444,578,1940,481,310,12,432,778,2013,81,29
861,194,11,486,664,2216,496,378,13,433,917,2237,81,30
808,244,48,501,668,2269,480,373,42,453,904,2252,81,31
767,236,11,503,679,2196,460,366,16,432,841,2115,81,32
572,239,19,529,576,1935,426,314,40,461,694,1935,81,33
144,182,26,504,357,1213,71,285,42,401,390,1189,81,34
126,137,4,399,275,941,64,210,10,301,330,915,81,35
728,219,10,490,618,2065,483,311,15,449,862,2120,81,36
837,173,10,468,696,2184,501,366,13,405,887,2172,81,37
832,227,11,591,684,2345,444,389,14,543,873,2263,81,38
762,199,6,513,714,2194,465,356,6,412,849,2088,81,39
577,247,19,473,675,1991,435,341,29,453,663,1921,81,40
160,171,75,461,344,1211,86,330,84,360,391,1251,81,41
150,147,5,397,247,946,94,195,16,288,368,961,81,42
665,172,5,463,652,1957,423,288,6,404,852,1973,81,43
869,241,12,459,603,2184,469,389,17,413,886,2174,81,44
795,245,22,584,712,2358,465,396,26,492,856,2235,81,45
737,185,7,622,792,2343,460,335,18,860,868,2541,81,46
465,194,20,511,468,1658,284,325,36,417,573,1635,81,47
125,190,14,446,288,1063,67,289,34,289,318,997,81,48
96,161,6,393,261,917,46,215,20,267,377,925,81,49
84,197,8,138,85,512,54,263,17,101,115,550,81,50
785,178,6,545,669,2183,474,374,7,452,906,2213,81,51
788,191,11,581,676,2247,497,322,17,500,822,2158,81,52
769,191,4,525,671,2160,441,378,10,467,849,2145,81,53
575,189,12,497,645,1918,428,318,29,459,670,1904,81,54
156,184,13,467,290,1110,78,268,47,357,361,1111,81,55
124,149,3,377,210,863,65,237,9,277,332,920,81,56
716,234,8,481,625,2064,486,334,18,428,849,2115,81,57
862,187,2,542,792,2385,556,342,5,456,939,2298,81,58
923,201,12,544,730,2410,549,368,20,487,824,2248,81,59
805,224,3,508,687,2227,456,382,12,432,911,2193,81,60
586,219,19,517,709,2050,449,333,35,531,769,2117,81,61
441,324,52,1090,651,2558,213,736,111,713,914,2687,81,62
416,364,11,1044,481,2316,214,737,35,703,949,2638,81,63
736,212,10,493,688,2139,492,331,12,470,834,2139,81,64
852,205,5,518,669,2249,467,372,14,432,900,2185,81,65
842,208,14,565,653,2282,474,424,16,442,888,2244,81,66
785,235,26,643,671,2360,503,452,28,507,879,2369,81,67
595,230,31,625,743,2224,447,403,43,541,753,2187,81,68
152,181,14,525,271,1143,102,312,34,380,378,1206,81,69
109,203,16,500,282,1110,50,244,21,374,411,1100,81,70
709,222,14,558,602,2105,420,376,21,454,792,2063,81,71
853,280,5,581,649,2368,465,422,13,482,992,2374,81,72
829,258,9,748,602,2446,452,438,32,565,948,2435,81,73
722,255,9,633,545,2164,264,430,24,495,913,2126,81,74
527,213,7,572,528,1847,261,388,32,453,688,1822,81,75
207,253,13,671,456,1600,80,389,35,573,490,1567,81,76
94,221,6,449,328,1098,65,306,15,366,387,1139,81,77
726,242,4,524,686,2182,447,355,13,464,844,2123,81,78
860,242,14,590,730,2436,508,438,13,455,996,2410,81,79
858,277,10,736,788,2669,513,452,14,657,985,2621,81,80
802,258,42,574,725,2401,457,419,55,475,946,2352,81,81
646,258,5,589,787,2285,457,394,39,555,787,2232,81,82
150,204,19,485,307,1165,86,328,49,311,399,1173,81,83
129,192,4,574,292,1191,65,320,10,407,446,1248,81,84
709,192,15,529,696,2141,469,371,18,488,834,2180,81,85
829,255,9,594,719,2406,474,446,10,427,991,2348,81,86
846,200,11,565,634,2256,436,402,14,429,905,2186,81,87
768,231,12,605,709,2325,452,415,15,499,832,2213,81,88
566,255,15,677,809,2322,445,421,33,647,769,2315,81,89
157,186,10,723,339,1415,98,358,29,465,560,1510,81,90
112,171,7,461,308,1059,58,281,14,327,359,1039,81,91
673,239,9,580,695,2196,426,366,12,475,894,2173,81,92
863,197,9,565,669,2303,526,341,10,491,932,2300,81,93
817,202,14,568,627,2228,464,392,13,439,868,2176,81,94
839,247,8,641,688,2423,524,429,11,449,916,2329,81,95
544,230,6,640,570,1990,286,421,35,495,695,1932,81,96
169,155,9,596,515,1444,106,329,34,577,445,1491,81,97
232,184,22,433,292,1163,79,301,32,372,387,1171,81,98
712,278,64,551,669,2274,501,412,72,448,773,2206,81,99
846,240,30,497,678,2291,524,435,38,477,920,2394,81,100
854,271,26,595,661,2407,481,450,38,491,921,2381,81,101
805,212,10,525,673,2225,512,370,14,452,889,2237,81,102
616,239,12,572,664,2103,443,392,31,477,728,2071,81,103
160,172,12,629,382,1355,152,392,41,428,401,1414,81,104
139,193,8,497,291,1128,70,336,17,368,416,1207,81,105
602,204,10,590,422,1828,222,396,18,457,748,1841,81,106
704,178,17,584,396,1879,166,393,26,486,759,1830,81,107
731,256,14,524,462,1987,220,456,15,420,759,1870,81,108
693,236,11,545,437,1922,236,429,25,459,761,1910,81,109
431,670,27,576,562,2266,188,481,38,588,994,2289,81,110
762,2260,51,2579,1972,7624,437,2509,267,2187,3103,8503,81,111
634,530,23,1775,780,3742,321,1238,88,1072,1692,4411,81,112
665,228,16,503,580,1992,499,324,22,422,745,2012,81,113
859,251,11,586,673,2380,527,404,18,469,970,2388,81,114
783,217,16,657,693,2366,494,419,23,483,860,2279,81,115
835,244,20,632,698,2429,466,429,32,524,906,2357,81,116
616,269,24,689,705,2303,468,396,37,541,845,2287,81,117
896,6015,248,2299,1195,10653,460,1886,290,2000,4558,9194,81,118
382,4394,45,1306,787,6914,198,1099,79,1186,3279,5841,81,119
706,231,36,538,700,2211,540,330,44,434,783,2131,81,120
817,199,31,560,667,2274,480,400,35,440,912,2267,81,121
808,224,20,634,630,2316,504,372,23,476,873,2248,81,122
744,195,11,588,581,2119,426,372,15,484,830,2127,81,123
568,211,11,541,609,1940,392,365,30,429,643,1859,81,124
150,144,11,413,279,997,82,306,39,310,296,1033,81,125
102,155,12,401,199,869,50,231,15,293,263,852,81,126
668,172,13,507,552,1912,399,288,21,417,758,1883,81,127
805,172,9,580,587,2153,464,338,16,430,819,2067,81,128
798,178,23,611,576,2186,444,345,28,497,822,2136,81,129
737,180,25,598,600,2140,446,330,35,486,774,2071,81,130
594,192,15,520,571,1892,420,324,29,396,682,1851,81,131
135,131,12,488,291,1057,82,246,25,275,396,1024,81,132
88,128,12,402,198,828,70,221,15,293,302,901,81,133
619,269,6,807,907,2608,398,388,14,983,932,2715,81,134
817,213,16,638,776,2460,463,342,19,689,1041,2554,81,135
857,208,7,593,609,2274,456,385,16,476,837,2170,81,136
798,195,20,627,616,2256,476,398,29,492,815,2210,81,137
555,199,13,535,590,1892,382,313,27,429,667,1818,81,138
140,140,5,411,235,931,78,234,27,307,314,960,81,139
116,158,4,388,248,914,69,265,7,286,310,937,81,140
656,190,23,575,577,2021,424,329,18,468,761,2000,81,141
847,195,38,612,643,2335,474,405,40,500,856,2275,81,142
815,197,9,525,605,2151,439,395,14,424,874,2146,81,143
775,210,9,652,612,2258,455,339,17,506,792,2109,81,144
551,233,17,556,596,1953,406,324,23,412,643,1808,81,145
151,176,6,412,278,1023,109,305,36,324,299,1073,81,146
86,162,6,381,229,864,72,247,19,271,376,985,81,147
118,164,8,351,221,862,76,194,9,283,304,866,81,148
721,193,7,453,549,1923,445,319,15,377,759,1915,81,149
798,153,13,549,615,2128,457,311,16,482,839,2105,81,150
794,183,11,583,579,2150,455,341,20,479,790,2085,81,151
566,222,8,594,640,2030,434,346,29,470,649,1928,81,152
163,189,12,592,286,1242,120,354,31,486,340,1331,81,153
104,148,7,376,272,907,56,237,8,286,328,915,81,154
709,157,26,697,594,2183,467,323,33,591,765,2179,81,155
759,166,25,550,452,1952,287,406,30,424,831,1978,81,156
816,161,36,647,580,2240,428,333,42,451,910,2164,81,157
809,195,8,643,597,2252,437,444,13,516,846,2256,81,158
597,441,13,665,636,2352,387,450,27,512,944,2320,81,159
155,240,16,710,537,1658,98,623,53,415,521,1710,81,160
138,158,17,474,256,1043,71,302,19,260,386,1038,81,161
670,167,17,543,524,1921,344,289,21,456,713,1823,81,162
809,180,23,527,560,2099,384,404,29,464,854,2135,81,163
841,184,17,619,563,2224,401,401,30,474,826,2132,81,164
751,194,4,614,552,2115,375,378,12,519,810,2094,81,165
600,223,16,751,546,2136,488,401,44,590,645,2168,81,166
143,221,26,461,325,1176,72,358,41,367,390,1228,81,167
113,183,8,422,275,1001,86,255,13,328,337,1019,81,168
672,197,14,527,427,1837,306,347,18,431,698,1800,81,169
752,207,9,499,493,1960,282,395,16,412,782,1887,81,170
242,153,8,557,344,1304,129,320,11,404,434,1298,81,171
638,208,7,504,433,1790,236,359,17,429,710,1751,81,172
511,250,10,501,430,1702,271,413,32,391,565,1672,81,173
147,202,43,496,301,1189,91,362,77,287,339,1156,81,174
99,126,17,442,218,902,71,216,28,321,276,912,81,175
614,199,17,462,376,1668,237,316,18,347,688,1606,81,176
788,156,17,557,407,1925,281,368,22,458,782,1911,81,177
832,195,17,574,433,2051,345,436,18,435,784,2018,81,178
744,204,17,605,482,2052,325,381,28,440,735,1909,81,179
577,591,19,575,473,2235,332,396,56,433,927,2144,81,180
145,883,15,469,348,1860,83,539,23,827,2509,3981,81,181
126,171,3,368,488,1156,80,222,7,504,308,1121,81,182
651,212,35,545,423,1866,376,329,27,411,685,1828,81,183
664,204,16,590,516,1990,334,374,24,455,807,1994,81,184
647,228,16,631,463,1985,348,402,40,485,742,2017,81,185
181,591,15,579,422,1788,134,669,33,429,438,1703,81,186
291,210,17,558,387,1463,162,347,29,407,467,1412,81,187
147,196,15,434,274,1066,87,323,41,283,326,1060,81,188
104,165,5,372,203,849,58,219,11,308,291,887,81,189
617,171,13,523,374,1698,306,314,22,380,675,1697,81,190
742,177,15,577,440,1951,325,340,17,413,841,1936,81,191
767,173,15,553,442,1950,292,386,19,444,842,1983,81,192
713,187,8,594,449,1951,331,407,10,461,746,1955,81,193
574,219,12,571,457,1833,294,324,30,458,583,1689,81,194
139,173,16,434,298,1060,78,313,41,328,336,1096,81,195
126,132,4,473,216,951,107,240,11,359,295,1012,81,196
631,143,7,518,374,1673,271,260,18,381,719,1649,81,197
782,167,4,537,402,1892,290,371,20,398,794,1873,81,198
745,134,20,590,427,1916,312,281,23,440,831,1887,81,199
677,201,13,597,412,1900,295,358,19,421,734,1827,81,200
472,225,15,481,453,1646,285,368,52,412,569,1686,81,201
135,159,16,439,297,1046,76,305,30,348,341,1100,81,202
99,174,7,429,225,934,63,233,9,272,325,902,81,203
661,163,9,624,356,1813,283,303,13,480,718,1797,81,204
756,189,3,622,451,2021,309,355,16,481,862,2023,81,205
690,203,6,626,490,2015,271,418,13,468,827,1997,81,206
712,174,10,542,380,1818,244,324,21,412,755,1756,81,207
524,202,9,586,514,1835,295,367,31,467,631,1791,81,208
146,214,27,470,325,1182,79,324,53,348,401,1205,81,209
92,152,5,372,218,839,65,239,12,300,276,892,81,210
638,150,6,561,376,1731,289,302,6,430,688,1715,81,211
735,202,7,475,867,2286,488,401,10,428,811,2138,81,212
708,166,5,478,852,2209,510,473,5,364,777,2129,81,213
686,177,12,541,401,1817,223,331,12,408,741,1715,81,214
507,206,10,511,358,1592,234,380,35,386,552,1587,81,215
124,134,19,440,255,972,68,246,48,275,314,951,81,216
87,140,9,464,202,902,50,240,14,309,298,911,81,217
536,169,2,399,329,1435,209,288,7,326,628,1458,81,218
671,168,5,446,355,1645,212,345,4,350,757,1668,81,219
654,187,8,526,334,1709,181,352,16,409,708,1666,81,220
580,152,6,467,270,1475,186,310,11,339,617,1463,81,221
381,186,5,452,348,1372,182,312,42,318,458,1312,81,222
129,148,12,451,311,1051,91,295,35,323,357,1101,81,223
92,131,3,369,201,796,64,188,9,260,298,819,81,224
518,133,3,360,305,1319,198,244,2,347,588,1379,81,225
607,158,17,409,387,1578,198,320,24,339,704,1585,81,226
600,220,5,447,431,1703,228,345,7,372,699,1651,81,227
577,192,14,436,384,1603,201,314,16,415,648,1594,81,228
423,224,14,451,383,1495,221,315,31,358,543,1468,81,229
129,166,17,451,244,1007,76,260,46,310,311,1003,81,230
81,145,4,361,187,778,61,192,6,250,282,791,81,231
519,141,3,411,387,1461,288,242,11,298,615,1454,81,232
650,164,4,381,461,1660,276,321,10,318,738,1663,81,233
652,150,10,406,443,1661,278,288,10,360,717,1653,81,234
575,154,5,480,418,1632,240,275,10,357,755,1637,81,235
420,176,8,464,479,1547,255,302,25,412,515,1509,81,236
141,201,10,521,260,1133,107,305,25,347,326,1110,81,237
104,143,7,453,250,957,44,205,27,332,320,928,81,238
650,159,6,375,699,1889,468,302,8,329,780,1887,81,239
765,167,9,409,777,2127,496,357,14,319,928,2114,81,240
716,165,10,432,705,2028,490,349,14,342,762,1957,81,241
704,122,7,426,624,1883,587,271,12,338,810,2018,81,242
513,208,8,447,679,1855,431,324,32,440,556,1783,81,243
125,155,29,509,342,1160,68,293,42,349,339,1091,81,244
106,173,4,441,204,928,53,235,5,280,333,906,81,245
102,174,4,370,288,938,72,209,7,326,295,909,81,246
745,190,17,441,710,2103,529,303,16,391,888,2127,81,247
778,183,27,487,624,2099,494,350,30,366,929,2169,81,248
746,230,21,552,697,2246,505,363,19,423,866,2176,81,249
581,337,11,493,661,2083,502,339,20,413,748,2022,81,250
138,167,17,488,296,1106,75,285,32,390,332,1114,81,251
113,142,11,374,187,827,65,211,10,306,268,860,81,252
713,155,16,422,600,1906,478,333,12,355,758,1936,81,253
804,193,12,485,680,2174,518,374,17,392,884,2185,81,254
796,215,14,524,628,2177,519,364,15,402,863,2163,81,255
767,194,18,468,781,2228,527,387,23,415,882,2234,81,256
607,258,6,516,681,2068,550,358,33,428,718,2087,81,257
141,223,16,501,367,1248,84,339,45,425,366,1259,81,258
131,171,17,532,265,1116,67,238,24,349,462,1140,81,259
736,182,18,484,697,2117,523,334,25,402,927,2211,81,260
899,205,15,489,718,2326,522,394,19,366,978,2279,81,261
871,202,19,511,667,2270,481,396,20,421,864,2182,81,262
820,213,12,554,691,2290,506,429,9,450,942,2336,81,263
593,305,18,721,638,2275,473,349,38,608,818,2286,81,264
31,30,2,30,31,124,27,29,3,27,35,121,81,265
9,14,13,23,19,78,7,16,7,20,19,69,81,266
666,211,11,433,669,1990,524,351,15,358,806,2054,81,267
847,227,37,531,776,2418,551,403,30,440,992,2416,81,268
806,211,22,572,744,2355,542,388,23,447,971,2371,81,269
775,228,6,544,647,2200,531,354,16,417,885,2203,81,270
607,330,7,569,710,2223,474,392,25,493,754,2138,81,271
148,238,14,558,331,1289,123,333,48,368,367,1239,81,272
100,139,8,407,201,855,70,183,16,309,303,881,81,273
715,188,19,461,683,2066,539,320,24,358,743,1984,81,274
878,207,16,464,780,2345,566,361,18,393,943,2281,81,275
879,197,16,569,754,2415,555,393,22,474,919,2363,81,276
803,240,23,524,714,2304,564,354,21,456,898,2293,81,277
593,227,10,541,833,2204,495,306,33,420,754,2008,81,278
142,232,12,553,342,1281,90,331,34,407,437,1299,81,279
116,142,28,499,288,1073,76,227,21,318,443,1085,81,280
700,198,16,534,771,2219,519,371,19,450,816,2175,81,281
892,222,10,567,701,2392,518,374,10,433,1004,2339,81,282
832,219,13,600,753,2417,501,390,15,432,915,2253,81,283
761,167,6,524,514,1972,312,374,8,396,828,1918,81,284
596,221,7,1482,1417,3723,420,362,29,1507,1343,3661,81,285
239,214,10,3000,1410,4873,385,365,22,3005,1100,4877,81,286
150,185,16,436,293,1080,61,263,18,369,357,1068,81,287
276,156,15,447,354,1248,143,260,19,367,460,1249,81,288
798,214,2,519,783,2316,544,396,8,411,973,2332,81,289
836,188,5,819,603,2451,574,366,12,510,915,2377,81,290
752,250,16,609,781,2408,495,428,20,412,932,2287,81,291
568,277,14,565,852,2276,485,352,45,462,808,2152,81,292
155,237,13,517,356,1278,82,361,22,381,436,1282,81,293
111,137,19,494,283,1044,52,281,26,318,332,1009,81,294
647,147,11,478,748,2031,492,311,12,414,831,2060,81,295
796,155,14,576,826,2367,566,375,12,430,956,2339,81,296
796,219,61,537,841,2454,560,436,52,487,968,2503,81,297
804,215,10,577,723,2329,538,377,10,453,936,2314,81,298
626,317,23,576,735,2277,528,381,35,467,890,2301,81,299
179,250,15,479,339,1262,91,370,39,377,404,1281,81,300
208,181,14,491,314,1208,65,383,18,440,381,1287,81,301
691,159,6,492,803,2151,501,340,17,420,858,2136,81,302
865,204,23,518,975,2585,528,558,25,455,966,2532,81,303
866,158,12,564,764,2364,520,383,14,441,980,2338,81,304
762,385,15,518,720,2400,492,417,23,467,1007,2406,81,305
571,241,16,561,705,2094,458,355,38,471,718,2040,81,306
510,404,23,1329,836,3102,252,1015,82,820,1133,3302,81,307
345,303,12,937,526,2123,174,571,28,739,820,2332,81,308
669,143,13,488,457,1770,375,259,14,374,690,1712,81,309
592,162,17,474,363,1608,220,262,24,393,687,1586,81,310
697,161,25,521,718,2122,506,301,20,419,819,2065,81,311
727,190,5,532,715,2169,488,341,7,463,892,2191,81,312
581,375,11,557,718,2242,472,395,25,446,867,2205,81,313
151,175,12,494,281,1113,114,243,28,409,395,1189,81,314
104,123,5,441,209,882,60,185,7,314,391,957,81,315
263,114,11,400,286,1074,128,230,12,324,442,1136,81,316
840,217,13,572,765,2407,541,426,5,452,990,2414,81,317
867,164,6,545,835,2417,564,375,13,445,969,2366,81,318
820,160,5,551,777,2313,509,354,13,524,971,2371,81,319
598,181,19,545,749,2092,453,286,38,487,729,1993,81,320
154,229,10,485,317,1195,95,302,37,395,390,1219,81,321
114,148,5,418,261,946,65,192,13,316,337,923,81,322
736,174,5,458,677,2050,518,319,9,430,791,2067,81,323
894,213,3,649,799,2558,565,334,6,523,1115,2543,81,324
912,189,11,509,716,2337,554,387,10,462,948,2361,81,325
841,173,4,577,808,2403,512,367,5,545,925,2354,81,326
622,192,6,547,679,2046,512,275,30,520,740,2077,81,327
154,184,9,540,284,1171,118,301,29,356,344,1148,81,328
97,148,5,588,222,1060,146,201,7,300,443,1097,81,329
613,182,4,516,725,2040,503,252,18,454,793,2020,81,330
646,220,7,567,696,2136,430,299,8,456,886,2079,81,331
402,150,8,555,420,1535,226,237,11,499,557,1530,81,332
84,126,7,320,207,744,61,132,12,315,156,676,81,333
208,132,32,453,265,1090,107,229,47,328,372,1083,81,334
99,171,8,468,221,967,67,211,20,349,356,1003,81,335
104,198,12,434,285,1033,62,233,7,306,379,987,81,336
725,138,2,487,706,2058,549,269,3,432,785,2038,81,337
844,186,14,517,831,2392,516,367,15,427,969,2294,81,338
793,134,17,583,724,2251,475,345,17,436,926,2199,81,339
841,164,3,553,767,2328,461,385,7,493,919,2265,81,340
666,151,47,572,682,2118,425,288,64,523,681,1981,81,341
37,25,11,27,29,129,45,20,12,27,28,132,81,342
24,37,5,36,24,126,17,39,6,38,17,117,81,343
693,156,8,457,685,1999,493,314,11,424,784,2026,81,344
859,191,4,556,949,2559,477,370,8,478,1658,2991,81,345
895,160,14,835,679,2583,610,365,27,598,990,2590,81,346
867,197,17,565,826,2472,506,396,31,515,884,2332,81,347
639,274,10,522,752,2197,468,357,38,442,787,2092,81,348
174,183,18,807,349,1531,116,385,47,520,376,1444,81,349
96,121,2,378,206,803,60,201,8,261,287,817,81,350
698,144,1,536,673,2052,497,290,10,443,772,2012,81,351
838,241,12,517,770,2378,509,367,11,414,989,2290,81,352
776,226,15,614,666,2297,518,345,23,482,816,2184,81,353
671,163,7,531,727,2099,448,362,14,421,740,1985,81,354
418,210,3,501,584,1716,382,245,25,390,539,1581,81,355
100,120,10,333,255,818,81,180,20,248,268,797,81,356
66,97,8,336,209,716,40,146,10,220,284,700,81,357
260,119,8,379,329,1095,159,192,10,297,361,1019,81,358
163,98,7,292,163,723,103,110,11,224,209,657,81,359
35,55,3,130,114,337,29,103,9,105,98,344,81,360
181,108,20,305,209,823,139,170,30,238,268,845,81,361
166,126,9,333,216,850,140,161,16,230,263,810,81,362
67,104,9,230,142,552,47,114,21,159,175,516,81,363
55,111,9,226,217,618,40,111,97,148,203,599,81,364
237,145,2,320,340,1044,156,216,11,270,410,1063,81,365
288,167,45,395,284,1179,109,194,100,314,445,1162,81,366
181,176,10,354,314,1035,67,248,19,217,299,850,82,1
1097,236,5,668,518,2524,244,410,21,370,1029,2074,82,2
1490,238,5,734,604,3071,360,482,14,442,1297,2595,82,3
1433,259,14,719,534,2959,332,456,18,430,1292,2528,82,4
1298,271,19,704,620,2912,272,451,38,467,1106,2334,82,5
248,212,11,458,279,1208,95,300,55,221,287,958,82,6
217,232,4,512,310,1275,93,321,24,236,372,1046,82,7
1478,253,20,710,587,3048,316,522,36,408,1305,2587,82,8
1565,186,9,645,390,2795,343,348,27,507,1143,2368,82,9
1641,282,19,741,607,3290,375,517,44,431,1377,2744,82,10
1603,317,11,741,600,3272,350,618,26,443,1296,2733,82,11
1345,270,12,724,525,2876,284,461,37,468,1089,2339,82,12
295,263,18,592,378,1546,107,363,53,327,492,1342,82,13
212,193,18,480,260,1163,84,279,27,257,351,998,82,14
383,199,11,481,277,1351,128,321,18,236,420,1123,82,15
500,157,1,434,292,1384,128,316,16,268,470,1198,82,16
1268,237,17,816,520,2858,343,424,38,426,1217,2448,82,17
1607,235,7,658,566,3073,341,524,27,433,1330,2655,82,18
563,190,15,454,285,1507,184,323,46,302,502,1357,82,19
241,209,12,459,324,1245,86,324,46,246,378,1080,82,20
186,185,4,447,291,1113,86,316,14,229,310,955,82,21
1451,256,22,683,481,2893,292,471,39,346,1254,2402,82,22
1728,258,8,688,553,3235,355,577,18,435,1496,2881,82,23
1786,247,13,775,663,3484,414,551,21,501,1447,2934,82,24
1658,232,10,673,524,3097,366,646,26,449,1340,2827,82,25
1239,286,28,723,575,2851,335,589,65,478,1109,2576,82,26
247,240,10,625,346,1468,112,428,54,321,510,1425,82,27
212,202,2,503,264,1183,99,351,15,274,365,1104,82,28
1482,244,3,667,556,2952,340,484,16,460,1320,2620,82,29
1703,283,10,712,560,3268,385,509,21,448,1454,2817,82,30
1708,276,9,755,611,3359,377,584,31,442,1488,2922,82,31
1649,263,12,760,578,3262,340,555,27,493,1375,2790,82,32
1375,277,20,736,603,3011,318,570,50,471,1178,2587,82,33
273,265,19,579,349,1485,90,384,48,313,401,1236,82,34
205,224,9,496,306,1240,96,355,17,220,378,1066,82,35
1537,239,6,660,471,2913,320,531,16,469,1368,2704,82,36
1759,285,7,689,584,3324,344,540,10,468,1487,2849,82,37
1725,279,29,804,645,3482,390,578,45,522,1489,3024,82,38
1689,235,15,778,523,3240,373,572,30,468,1409,2852,82,39
1377,240,18,765,533,2933,319,548,76,494,1206,2643,82,40
250,250,12,636,390,1538,102,492,70,342,488,1494,82,41
220,167,10,480,240,1117,103,336,30,285,419,1173,82,42
1487,175,3,608,471,2744,342,493,21,415,1299,2570,82,43
1540,233,2,618,476,2869,340,597,15,412,1353,2717,82,44
1717,242,7,705,589,3260,382,563,35,576,1536,3092,82,45
1531,249,20,633,472,2905,342,557,56,454,1442,2851,82,46
1164,212,21,638,469,2504,265,535,71,507,1074,2452,82,47
226,189,4,519,322,1260,111,374,51,302,379,1217,82,48
173,188,5,475,264,1105,92,384,31,250,395,1152,82,49
481,177,23,527,343,1551,144,406,45,361,606,1562,82,50
1530,156,6,563,424,2679,304,591,18,432,1433,2778,82,51
1629,139,15,594,432,2809,383,520,35,417,1458,2813,82,52
1540,121,17,533,365,2576,332,517,40,366,1367,2622,82,53
1245,145,10,493,401,2294,267,445,43,404,1166,2325,82,54
226,134,5,490,279,1134,108,308,61,269,421,1167,82,55
163,118,0,381,191,853,89,321,18,199,311,938,82,56
1471,117,1,485,341,2415,289,466,13,331,1328,2427,82,57
1638,121,0,523,352,2634,325,524,13,359,1425,2646,82,58
1603,125,0,528,369,2625,360,491,10,367,1425,2653,82,59
1497,142,2,531,343,2515,312,490,20,374,1365,2561,82,60
1291,153,5,552,365,2366,262,464,44,421,1166,2357,82,61
207,144,5,421,194,971,86,322,29,230,410,1077,82,62
178,125,5,424,197,929,83,284,34,221,378,1000,82,63
1447,131,0,547,352,2477,285,455,14,409,1348,2511,82,64
1566,136,6,515,333,2556,288,458,16,375,1413,2550,82,65
1621,108,10,492,404,2635,357,480,16,393,1470,2716,82,66
1535,140,2,565,398,2640,322,580,16,398,1358,2674,82,67
1314,158,10,547,383,2412,261,481,58,434,1180,2414,82,68
236,113,5,488,222,1064,86,414,56,222,361,1139,82,69
168,125,1,366,158,818,88,277,14,186,321,886,82,70
1374,117,3,477,305,2276,283,458,26,276,1251,2294,82,71
1619,135,15,591,350,2710,304,532,30,427,1470,2763,82,72
1583,138,7,633,389,2750,331,591,21,391,1464,2798,82,73
1402,155,8,621,434,2620,327,545,29,412,1309,2622,82,74
1130,160,3,550,402,2245,271,488,68,434,1070,2331,82,75
309,173,5,693,268,1448,126,437,68,393,461,1485,82,76
181,101,2,380,217,881,82,331,20,232,332,997,82,77
1360,120,1,464,341,2286,270,443,22,349,1314,2398,82,78
1625,115,0,506,313,2559,340,521,11,345,1455,2672,82,79
1688,135,0,598,454,2875,374,601,16,406,1527,2924,82,80
1549,141,3,561,353,2607,305,544,29,350,1387,2615,82,81
1241,146,3,513,339,2242,261,498,49,357,1176,2341,82,82
214,131,2,424,220,991,71,392,39,213,362,1077,82,83
191,141,2,414,180,928,84,305,20,216,400,1025,82,84
1396,133,1,557,357,2444,268,493,22,369,1350,2502,82,85
1583,156,4,523,381,2647,267,563,20,360,1474,2684,82,86
1544,107,10,510,355,2526,317,487,25,413,1357,2599,82,87
1467,135,2,544,315,2463,309,496,23,375,1322,2525,82,88
1169,158,7,602,367,2303,243,517,53,418,1202,2433,82,89
270,156,11,574,260,1271,96,411,56,294,505,1362,82,90
176,117,3,374,181,851,75,293,18,208,351,945,82,91
1278,158,2,586,338,2362,287,552,25,316,1249,2429,82,92
1588,148,2,546,341,2625,307,549,22,370,1463,2711,82,93
1638,120,10,481,387,2636,375,606,23,338,1340,2682,82,94
1511,151,8,615,360,2645,317,620,40,383,1377,2737,82,95
1145,163,8,547,422,2285,279,540,57,364,1042,2282,82,96
256,172,11,514,249,1202,128,421,53,289,423,1314,82,97
211,127,2,524,196,1060,89,392,7,220,473,1181,82,98
1416,133,3,471,356,2379,286,438,18,356,1321,2419,82,99
1627,172,0,547,366,2712,308,532,21,364,1487,2712,82,100
1637,163,3,598,402,2803,364,554,18,430,1492,2858,82,101
1608,152,3,608,326,2697,342,483,20,407,1410,2662,82,102
1313,144,5,514,357,2333,263,529,46,403,1165,2406,82,103
285,131,11,551,237,1215,91,455,60,244,454,1304,82,104
202,131,4,446,207,990,95,375,13,212,388,1083,82,105
1250,130,8,569,387,2344,288,462,26,377,1203,2356,82,106
1334,147,4,518,377,2380,293,512,32,367,1272,2476,82,107
1450,142,7,575,411,2585,357,514,28,388,1104,2391,82,108
1370,199,4,583,410,2566,302,648,31,376,1275,2632,82,109
1151,174,5,563,402,2295,266,413,69,389,1048,2185,82,110
293,175,10,628,350,1456,99,543,83,293,513,1531,82,111
236,135,1,456,195,1023,84,330,22,250,451,1137,82,112
1493,150,11,553,403,2610,331,501,33,419,1425,2709,82,113
1720,158,2,596,450,2926,360,633,24,398,1506,2921,82,114
1754,158,3,633,476,3024,391,644,25,420,1531,3011,82,115
1659,147,2,658,404,2870,340,657,21,492,1414,2924,82,116
1406,159,11,597,417,2590,317,633,56,386,1271,2663,82,117
324,171,4,466,249,1214,126,405,62,303,467,1363,82,118
226,144,5,484,243,1102,104,433,26,246,422,1231,82,119
1579,141,2,555,367,2644,350,547,25,421,1370,2713,82,120
1783,176,1,613,419,2992,372,610,23,460,1476,2941,82,121
1744,189,16,613,469,3031,403,570,52,461,1564,3050,82,122
1619,167,9,594,432,2821,353,613,30,399,1423,2818,82,123
1421,209,5,648,440,2723,337,580,52,462,1277,2708,82,124
321,147,11,496,244,1219,145,437,58,308,411,1359,82,125
234,138,9,432,185,998,85,366,35,212,381,1079,82,126
1537,179,2,536,420,2674,328,556,21,378,1447,2730,82,127
1774,143,2,598,465,2982,354,685,30,427,1516,3012,82,128
1773,126,1,657,518,3075,411,389,6,453,1472,2731,82,129
1586,147,5,534,351,2623,364,577,36,415,1451,2843,82,130
1410,166,33,599,365,2573,324,508,53,428,1248,2561,82,131
352,168,10,561,296,1387,156,376,62,327,493,1414,82,132
238,153,14,395,172,972,104,317,18,238,350,1027,82,133
1457,173,4,573,414,2621,315,569,23,338,1431,2676,82,134
1656,167,9,592,365,2789,297,513,42,424,1660,2936,82,135
1734,163,5,592,420,2914,383,551,32,439,1494,2899,82,136
1680,189,2,634,395,2900,362,587,36,463,1514,2962,82,137
1423,166,17,646,421,2673,306,542,67,532,1300,2747,82,138
303,174,16,448,264,1205,125,381,80,291,370,1247,82,139
234,201,13,449,224,1121,111,370,46,246,351,1124,82,140
1595,161,4,617,430,2807,383,618,38,436,1419,2894,82,141
1768,159,5,613,446,2991,371,682,28,410,1599,3090,82,142
1788,168,3,705,401,3065,374,561,34,419,1625,3013,82,143
1543,172,3,634,354,2706,338,536,29,446,1390,2739,82,144
1195,198,10,691,422,2516,294,560,60,542,1073,2529,82,145
308,196,13,553,293,1363,138,510,71,291,401,1411,82,146
251,181,18,512,297,1259,106,404,30,292,417,1249,82,147
223,115,2,441,209,990,132,326,9,260,377,1104,82,148
1577,199,4,586,367,2733,339,585,25,431,1480,2860,82,149
1707,150,2,610,378,2847,418,521,27,418,1506,2890,82,150
1621,169,4,632,402,2828,361,570,24,410,1503,2868,82,151
1350,232,11,669,361,2623,311,559,62,472,1295,2699,82,152
267,188,5,527,323,1310,109,426,58,352,460,1405,82,153
217,162,7,428,218,1032,106,372,17,242,420,1157,82,154
1610,203,0,663,463,2939,384,560,18,431,1454,2847,82,155
1629,189,4,681,474,2977,357,690,19,494,1445,3005,82,156
1791,164,12,676,395,3038,386,614,18,461,1614,3093,82,157
1718,199,10,660,447,3034,363,681,30,480,1483,3037,82,158
1403,231,25,661,497,2817,302,706,81,498,1205,2792,82,159
334,290,9,785,551,1969,151,708,124,365,456,1804,82,160
260,228,18,558,312,1376,125,444,42,261,464,1336,82,161
1491,163,5,587,445,2691,348,546,27,466,1372,2759,82,162
1704,242,5,638,376,2965,374,647,27,472,1548,3068,82,163
1707,193,10,725,490,3125,366,626,47,516,1505,3060,82,164
1588,166,9,682,388,2833,330,539,52,438,1421,2780,82,165
1306,225,28,708,460,2727,325,601,83,494,1161,2664,82,166
331,201,10,580,308,1430,152,488,71,337,409,1457,82,167
261,202,12,466,226,1167,112,334,45,274,433,1198,82,168
1334,179,6,620,356,2495,329,499,26,431,1249,2534,82,169
1512,182,5,658,460,2817,370,649,40,496,1318,2873,82,170
557,172,35,633,298,1695,169,498,56,354,585,1662,82,171
1416,199,8,628,393,2644,296,557,41,424,1264,2582,82,172
1194,206,15,716,379,2510,331,526,70,511,1064,2502,82,173
303,218,50,571,248,1390,147,414,96,316,386,1359,82,174
246,166,17,405,224,1058,131,300,77,239,351,1098,82,175
1370,193,10,536,388,2497,337,487,36,419,1331,2610,82,176
1587,202,3,574,380,2746,358,539,28,444,1382,2751,82,177
1551,187,2,612,416,2768,361,544,24,477,1455,2861,82,178
1537,183,4,608,375,2707,332,544,33,422,1371,2702,82,179
1271,227,25,612,384,2519,309,521,69,434,1176,2509,82,180
270,177,6,454,234,1141,138,357,60,321,395,1271,82,181
237,153,8,370,187,955,126,322,26,236,322,1032,82,182
1388,199,1,620,438,2646,318,608,13,448,1332,2719,82,183
1636,159,3,647,444,2889,349,611,25,459,1378,2822,82,184
1518,218,1,697,468,2902,362,662,22,605,1174,2825,82,185
287,558,17,534,483,1879,120,833,64,308,560,1885,82,186
819,159,5,539,418,1940,230,486,50,364,825,1955,82,187
219,166,8,442,211,1046,106,363,52,220,371,1112,82,188
188,149,5,368,178,888,76,320,13,216,409,1034,82,189
1309,178,6,545,370,2408,322,519,24,400,1413,2678,82,190
1659,209,3,557,373,2801,343,561,21,449,1489,2863,82,191
1596,177,4,599,414,2790,389,501,20,440,1449,2799,82,192
1579,178,7,624,421,2809,313,524,22,459,1398,2716,82,193
1192,193,11,557,392,2345,288,490,68,465,1011,2322,82,194
258,189,9,502,393,1351,124,557,56,256,418,1411,82,195
195,154,7,370,192,918,90,332,23,220,379,1044,82,196
1354,150,7,574,310,2395,301,449,28,372,1180,2330,82,197
1532,168,3,573,333,2609,306,496,26,438,1249,2515,82,198
1512,147,3,588,369,2619,337,419,32,457,1410,2655,82,199
1426,173,12,568,340,2519,308,475,34,446,1268,2531,82,200
1042,185,8,509,416,2160,240,546,99,396,1005,2286,82,201
246,143,3,420,298,1110,112,397,53,283,369,1214,82,202
198,142,5,392,173,910,82,292,16,203,427,1020,82,203
1298,123,13,457,333,2224,303,405,23,338,1120,2189,82,204
1496,150,4,551,379,2580,297,536,22,397,1316,2568,82,205
1498,168,17,589,405,2677,350,526,40,402,1349,2667,82,206
1432,162,12,633,358,2597,274,446,28,517,1290,2555,82,207
1138,166,7,607,352,2270,271,440,47,418,1024,2200,82,208
248,189,8,513,290,1248,138,393,69,304,386,1290,82,209
186,133,5,423,194,941,113,343,23,208,331,1018,82,210
1315,170,7,526,431,2449,306,520,33,390,1197,2446,82,211
1579,184,2,609,352,2726,341,530,17,485,1359,2732,82,212
1564,188,10,614,385,2761,364,522,25,427,1298,2636,82,213
1405,184,36,611,342,2578,295,499,54,454,1276,2578,82,214
1183,169,8,659,374,2393,264,492,48,450,1019,2273,82,215
289,142,8,577,208,1224,140,330,41,316,391,1218,82,216
265,138,7,549,152,1111,166,290,23,353,409,1241,82,217
1266,140,5,599,372,2382,317,545,16,414,1219,2511,82,218
1552,166,2,624,426,2770,329,599,18,423,1402,2771,82,219
1481,168,3,579,352,2583,345,490,24,428,1237,2524,82,220
1339,143,1,543,340,2366,261,481,13,430,1178,2363,82,221
1070,175,14,505,317,2081,238,434,62,401,897,2032,82,222
272,223,7,432,291,1225,145,415,55,261,362,1238,82,223
222,167,13,390,209,1001,103,338,39,206,373,1059,82,224
1310,149,7,596,311,2373,298,426,24,388,1229,2365,82,225
1518,134,0,593,303,2548,291,450,13,410,1299,2463,82,226
1387,166,2,547,417,2519,304,468,14,420,1421,2627,82,227
1436,167,3,582,355,2543,273,520,18,417,1334,2562,82,228
1153,208,18,557,329,2265,258,477,64,359,1060,2218,82,229
271,150,5,415,244,1085,113,306,64,211,331,1025,82,230
182,162,14,375,227,960,81,325,32,228,338,1004,82,231
1342,145,1,483,354,2325,284,451,10,337,1305,2387,82,232
1539,178,4,574,379,2674,315,544,22,402,1357,2640,82,233
1538,143,9,617,429,2736,341,562,25,469,1318,2715,82,234
1452,179,15,674,346,2666,312,548,34,438,1434,2766,82,235
1228,191,26,578,413,2436,295,517,61,449,1180,2502,82,236
314,174,13,503,324,1328,152,334,73,314,389,1262,82,237
200,174,25,426,205,1030,102,317,53,273,340,1085,82,238
1437,145,4,512,421,2519,320,541,14,383,1314,2572,82,239
1652,185,3,582,400,2822,314,632,15,406,1447,2814,82,240
1609,137,7,531,393,2677,326,522,20,360,1452,2680,82,241
1650,171,14,585,344,2764,308,494,24,450,1417,2693,82,242
1326,152,10,552,386,2426,286,487,44,410,1036,2263,82,243
255,134,6,470,232,1097,137,343,48,276,372,1176,82,244
197,126,3,393,189,908,111,266,18,221,407,1023,82,245
228,160,2,421,248,1059,112,294,12,285,398,1101,82,246
1726,126,3,628,384,2867,396,483,15,437,1470,2801,82,247
1726,134,1,577,369,2807,342,492,10,457,1457,2758,82,248
1662,173,6,608,405,2854,356,571,19,386,1491,2823,82,249
1411,181,6,559,384,2541,316,479,54,407,1208,2464,82,250
262,147,4,444,253,1110,123,376,61,263,394,1217,82,251
213,128,2,350,183,876,103,288,10,258,315,974,82,252
1629,166,15,546,358,2714,338,489,31,349,1359,2566,82,253
1866,135,9,579,381,2970,377,554,26,404,1519,2880,82,254
1813,152,3,590,439,2997,378,586,22,406,1502,2894,82,255
1720,164,2,586,413,2885,342,609,22,421,1402,2796,82,256
1466,170,13,584,434,2667,332,510,62,397,1202,2503,82,257
263,149,6,533,258,1209,142,395,60,297,481,1375,82,258
192,123,5,410,199,929,96,280,10,256,381,1023,82,259
1595,149,4,556,352,2656,323,447,21,384,1279,2454,82,260
1812,126,1,564,383,2886,370,530,21,412,1521,2854,82,261
1794,143,2,550,362,2851,361,573,14,383,1330,2661,82,262
1763,147,4,611,409,2934,373,570,16,434,1456,2849,82,263
1401,169,9,663,416,2658,340,540,54,454,1123,2511,82,264
341,144,4,592,334,1415,147,485,67,350,432,1481,82,265
214,123,2,468,188,995,98,296,13,290,365,1062,82,266
1637,128,6,592,328,2691,340,483,28,406,1336,2593,82,267
1808,116,1,581,409,2915,403,538,20,370,1467,2798,82,268
1892,148,3,573,424,3040,428,530,25,409,1470,2862,82,269
1800,145,8,663,377,2993,413,559,37,431,1438,2878,82,270
1444,158,5,639,444,2690,349,539,38,449,1097,2472,82,271
256,176,9,599,371,1411,119,509,62,369,427,1486,82,272
187,113,13,410,204,927,97,312,19,217,365,1010,82,273
1578,117,16,526,336,2573,365,438,29,373,1295,2500,82,274
1830,159,13,549,474,3025,380,608,18,364,1798,3168,82,275
1830,132,4,556,484,3006,394,491,23,433,1692,3033,82,276
1760,172,5,570,444,2951,360,583,30,412,1678,3063,82,277
1411,196,4,551,413,2575,287,478,63,383,1250,2461,82,278
260,167,6,471,245,1149,96,345,50,287,430,1208,82,279
195,115,3,304,191,808,84,242,17,220,352,915,82,280
1649,134,8,522,422,2735,396,460,25,357,1530,2768,82,281
1883,157,5,587,424,3056,405,541,21,421,1561,2949,82,282
1881,191,32,694,498,3296,406,590,50,510,1701,3257,82,283
1561,130,2,607,399,2699,345,500,19,465,1367,2696,82,284
1262,175,8,569,399,2413,308,438,42,438,1015,2241,82,285
278,158,8,492,286,1222,127,420,55,313,380,1295,82,286
196,145,3,426,199,969,94,337,26,222,344,1023,82,287
671,118,15,476,272,1552,189,348,24,385,658,1604,82,288
1733,173,3,691,431,3031,396,627,21,428,1463,2935,82,289
1826,134,16,616,427,3019,406,486,33,531,1492,2948,82,290
1772,129,1,546,456,2904,399,536,22,388,1387,2732,82,291
1404,148,7,600,433,2592,333,505,52,421,1179,2490,82,292
267,184,3,506,271,1231,108,425,71,301,414,1319,82,293
148,132,2,374,184,840,69,304,16,243,297,929,82,294
1523,142,8,532,412,2617,371,407,43,390,1416,2627,82,295
1754,123,4,624,416,2921,407,450,15,433,1492,2797,82,296
1767,139,5,612,493,3016,370,543,31,455,1588,2987,82,297
1693,143,3,576,435,2850,357,542,20,409,1414,2742,82,298
1368,158,8,566,403,2503,316,429,50,436,1134,2365,82,299
244,129,8,473,263,1117,113,295,44,341,403,1196,82,300
231,128,0,364,180,903,106,265,12,246,308,937,82,301
1467,130,0,489,380,2466,349,455,25,328,1338,2495,82,302
1680,128,1,570,494,2873,417,533,24,424,1659,3057,82,303
1783,139,3,562,429,2916,406,495,14,428,1436,2779,82,304
1650,135,3,543,416,2747,389,431,24,416,1309,2569,82,305
1305,139,7,608,371,2430,299,438,32,476,1105,2350,82,306
237,145,5,463,236,1086,121,320,42,283,383,1149,82,307
181,128,2,372,186,869,85,227,14,232,296,854,82,308
1414,124,2,486,440,2466,394,408,22,324,1281,2429,82,309
1272,138,12,576,391,2389,394,379,39,481,1073,2366,82,310
1668,140,3,564,433,2808,439,470,29,388,1364,2690,82,311
1738,130,3,578,366,2815,431,433,15,422,1379,2680,82,312
1347,134,9,542,418,2450,328,382,38,390,1161,2299,82,313
232,113,7,424,226,1002,113,265,33,277,357,1045,82,314
184,91,6,399,153,833,93,227,13,253,324,910,82,315
614,156,8,522,258,1558,197,329,23,373,685,1607,82,316
1684,123,1,562,417,2787,397,418,21,418,1412,2666,82,317
1709,117,8,599,395,2828,430,462,28,409,1374,2703,82,318
1659,100,3,582,386,2730,435,407,19,427,1356,2644,82,319
1284,106,7,547,427,2371,374,391,41,440,1095,2341,82,320
240,142,2,456,205,1045,135,295,42,250,395,1117,82,321
182,111,4,300,181,778,100,249,16,198,290,853,82,322
1592,125,2,555,406,2680,404,414,26,359,1298,2501,82,323
1778,116,6,566,415,2881,403,447,26,386,1454,2716,82,324
1795,128,2,543,456,2924,427,491,25,398,1600,2941,82,325
1612,124,2,608,447,2793,358,464,15,406,1416,2659,82,326
1359,128,6,516,318,2327,310,419,33,433,1057,2252,82,327
266,120,4,477,218,1085,134,285,31,327,364,1141,82,328
183,98,5,442,187,915,96,219,12,309,357,993,82,329
1423,143,5,563,421,2555,375,460,34,380,1204,2453,82,330
1424,130,2,561,373,2490,343,415,25,406,1207,2396,82,331
1043,111,11,547,261,1973,315,301,29,584,706,1935,82,332
91,115,0,178,121,505,65,105,4,181,201,556,82,333
514,124,1,500,264,1403,156,281,34,327,534,1332,82,334
218,118,4,401,231,972,89,274,27,256,316,962,82,335
177,81,6,320,176,760,85,241,11,214,280,831,82,336
1421,95,3,523,419,2461,327,357,16,383,1322,2405,82,337
1613,103,2,556,413,2687,385,460,18,384,1363,2610,82,338
1624,110,5,553,410,2702,369,412,19,433,1306,2539,82,339
1531,100,5,551,467,2654,348,437,17,384,1557,2743,82,340
1370,123,9,542,487,2531,346,375,38,408,1186,2353,82,341
243,133,1,455,371,1203,118,403,49,257,466,1293,82,342
211,127,8,482,268,1096,125,319,17,247,381,1089,82,343
1620,117,9,522,460,2728,436,455,22,368,1278,2559,82,344
1835,120,5,639,479,3078,467,455,28,425,1561,2936,82,345
1739,96,9,546,416,2806,419,387,30,419,1358,2613,82,346
1657,113,7,539,475,2791,443,461,19,389,1394,2706,82,347
1305,120,3,485,407,2320,332,403,42,373,1096,2246,82,348
241,127,6,421,236,1031,94,282,39,287,400,1102,82,349
193,108,3,371,196,871,104,295,18,236,288,941,82,350
1447,125,7,495,424,2498,391,414,23,372,1322,2522,82,351
1729,125,2,609,519,2984,443,476,22,464,1432,2837,82,352
1639,134,3,546,451,2773,386,446,14,456,1299,2601,82,353
1552,115,1,549,421,2638,405,418,27,426,1235,2511,82,354
1258,128,5,542,384,2317,293,421,42,441,1017,2214,82,355
219,124,2,419,211,975,116,245,45,266,334,1006,82,356
157,86,2,385,178,808,80,226,20,230,310,866,82,357
997,116,2,544,342,2001,245,419,11,413,912,2000,82,358
639,77,2,399,160,1277,171,194,9,389,469,1232,82,359
75,70,2,181,91,419,61,84,4,132,147,428,82,360
694,113,1,437,289,1534,167,296,14,305,661,1443,82,361
795,114,3,517,290,1719,184,336,37,355,799,1711,82,362
235,115,2,389,215,956,104,292,34,241,347,1018,82,363
175,106,15,368,182,846,85,223,24,216,326,874,82,364
963,113,2,576,514,2168,294,385,18,389,992,2078,82,365
907,201,21,559,279,1967,265,305,64,512,729,1875,82,366
102,99,9,408,210,828,40,233,13,233,321,840,83,1
1200,176,3,729,502,2610,226,403,17,524,1343,2513,83,2
1606,230,1,765,751,3353,457,550,14,562,1760,3343,83,3
1551,184,4,790,815,3344,496,512,21,585,1545,3159,83,4
1168,234,11,790,848,3051,424,468,47,590,1281,2810,83,5
164,116,10,501,244,1035,84,201,47,329,290,951,83,6
153,108,7,603,268,1139,67,197,34,381,419,1098,83,7
1466,240,10,703,1102,3521,680,531,17,550,1610,3388,83,8
1728,165,5,736,704,3338,638,435,8,630,1500,3211,83,9
1680,146,2,786,753,3367,531,488,11,539,1728,3297,83,10
1587,218,7,682,950,3444,495,646,29,511,1751,3432,83,11
1233,203,17,1127,888,3468,662,424,45,649,1315,3095,83,12
588,408,20,2978,1070,5064,276,1054,140,1475,2482,5427,83,13
426,424,21,1553,782,3206,227,781,70,1168,1320,3566,83,14
274,109,12,684,286,1365,107,312,11,349,508,1287,83,15
508,144,5,532,392,1581,153,350,16,368,546,1433,83,16
1365,201,5,894,962,3427,250,517,9,787,1500,3063,83,17
1779,216,5,853,1034,3887,611,633,15,610,1726,3595,83,18
613,172,16,593,437,1831,191,366,39,450,683,1729,83,19
205,146,22,758,416,1547,77,331,68,458,456,1390,83,20
163,107,5,646,391,1312,67,261,17,438,467,1250,83,21
1525,152,4,754,1014,3449,656,464,13,575,1517,3225,83,22
1988,192,5,839,1089,4113,717,648,12,618,1936,3931,83,23
1971,260,12,891,1088,4222,747,658,23,650,1884,3962,83,24
1803,234,3,847,1087,3974,672,668,9,716,1718,3783,83,25
1212,293,15,1130,728,3378,493,596,41,689,1295,3114,83,26
471,527,49,1721,1123,3891,286,1227,183,1595,1990,5281,83,27
321,337,24,1271,688,2641,224,882,85,1248,1340,3779,83,28
1523,198,6,870,1045,3642,766,528,15,591,1569,3469,83,29
2027,216,2,869,1076,4190,752,620,7,656,1992,4027,83,30
2048,212,7,923,1135,4325,724,697,11,665,1950,4047,83,31
1823,239,4,830,1141,4037,718,642,25,618,1796,3799,83,32
1267,251,18,1119,948,3603,725,617,41,648,1356,3387,83,33
223,233,21,987,496,1960,108,380,58,565,771,1882,83,34
169,127,6,778,375,1455,58,328,22,477,589,1474,83,35
1551,184,5,816,1163,3719,717,554,17,619,1582,3489,83,36
2026,254,0,815,1208,4303,745,671,7,629,1993,4045,83,37
2017,273,1,846,1170,4307,711,779,10,701,1978,4179,83,38
1881,229,21,826,1181,4138,718,675,24,671,1801,3889,83,39
1287,302,7,1084,956,3636,728,550,54,667,1360,3359,83,40
253,1001,157,1151,1306,3868,598,554,33,1886,1185,4256,83,41
160,579,89,696,1093,2617,362,334,16,1112,725,2549,83,42
1551,164,11,760,1067,3553,669,568,13,589,1526,3365,83,43
1807,224,14,842,1085,3972,658,677,20,586,1471,3412,83,44
1883,225,6,916,1189,4219,654,645,13,645,1943,3900,83,45
1839,239,4,883,1173,4138,662,647,10,656,1834,3809,83,46
1089,255,22,1099,785,3250,487,548,57,608,1285,2985,83,47
236,225,14,788,624,1887,104,378,69,490,616,1657,83,48
192,155,18,798,342,1505,51,320,32,489,626,1518,83,49
461,165,0,788,438,1852,129,348,14,540,684,1715,83,50
1896,198,16,804,911,3825,454,602,20,608,1898,3582,83,51
1885,214,3,825,1114,4041,622,709,7,623,1870,3831,83,52
1772,241,17,790,1132,3952,711,666,34,620,1706,3737,83,53
1268,241,10,1086,941,3546,688,529,48,637,1333,3235,83,54
266,198,10,937,623,2034,105,452,58,580,705,1900,83,55
195,136,11,766,394,1502,82,350,18,486,563,1499,83,56
1547,230,5,820,1158,3760,708,586,11,617,1567,3489,83,57
2011,230,6,853,1100,4200,720,670,12,647,1926,3975,83,58
1954,170,11,865,1045,4045,745,646,11,652,1835,3889,83,59
1847,189,2,873,1163,4074,696,657,9,655,1731,3748,83,60
1313,243,5,1149,1028,3738,689,589,49,607,1368,3302,83,61
224,201,14,852,536,1827,88,392,65,477,689,1711,83,62
212,171,9,842,426,1660,90,337,18,535,626,1606,83,63
1598,184,2,848,1154,3786,741,567,21,638,1702,3669,83,64
2050,205,2,829,1169,4255,694,676,12,686,1936,4004,83,65
2015,225,6,955,1261,4462,740,812,24,706,2077,4359,83,66
1889,238,9,1022,1208,4366,765,723,31,693,1825,4037,83,67
1351,278,9,1157,1055,3850,735,618,63,793,1424,3633,83,68
270,209,9,873,448,1809,122,456,64,522,587,1751,83,69
173,158,8,754,389,1482,73,348,17,500,557,1495,83,70
1458,206,13,796,1021,3494,654,563,28,577,1494,3316,83,71
1998,261,10,953,1198,4420,730,781,20,675,2023,4229,83,72
1939,232,13,1056,1130,4370,676,781,13,718,1847,4035,83,73
1691,260,4,941,758,3654,293,790,28,623,1722,3456,83,74
1141,271,7,931,631,2981,229,515,61,678,1324,2807,83,75
344,334,23,1266,688,2655,107,662,99,751,927,2546,83,76
203,171,1,920,472,1767,93,453,16,581,659,1802,83,77
1591,211,4,870,1134,3810,639,608,11,628,1691,3577,83,78
1963,194,3,1002,1068,4230,714,678,6,683,1942,4023,83,79
1876,255,13,1025,1009,4178,703,940,27,720,1886,4276,83,80
1853,238,6,952,1332,4381,733,810,16,697,1894,4150,83,81
1282,317,16,1315,1132,4062,688,769,78,738,1544,3817,83,82
219,225,15,835,590,1884,100,502,76,440,644,1762,83,83
267,153,7,1004,454,1885,85,444,18,588,760,1895,83,84
1404,228,9,978,1205,3824,689,628,30,638,1725,3710,83,85
1839,250,4,1014,1302,4409,779,778,16,713,2035,4321,83,86
1807,217,4,838,1193,4059,710,694,12,623,1804,3843,83,87
1577,255,11,934,1279,4056,716,722,20,696,1729,3883,83,88
1150,308,10,1353,1047,3868,664,695,48,738,1514,3659,83,89
320,247,10,1353,621,2551,129,657,62,722,906,2476,83,90
235,144,3,751,437,1570,80,381,15,488,548,1512,83,91
1368,241,15,887,1068,3579,655,662,35,639,1546,3537,83,92
1956,227,20,877,1155,4235,710,774,39,636,2013,4172,83,93
1898,275,19,800,1117,4109,690,853,23,577,1775,3918,83,94
1888,251,6,1014,1365,4524,759,840,17,757,1989,4362,83,95
1286,318,16,1176,913,3709,537,651,54,707,1620,3569,83,96
355,228,17,1111,577,2288,146,503,67,678,745,2139,83,97
319,160,6,851,425,1761,96,410,21,626,629,1782,83,98
1566,257,7,921,1043,3794,674,614,25,646,1683,3642,83,99
1988,278,18,929,1282,4495,739,751,24,741,2034,4289,83,100
1981,288,16,1098,1236,4619,749,810,24,751,2065,4399,83,101
1942,240,8,959,1168,4317,756,754,15,747,1877,4149,83,102
1381,330,19,1178,1079,3987,684,752,59,704,1547,3746,83,103
329,280,19,1085,641,2354,124,634,86,679,805,2328,83,104
202,208,4,940,456,1810,84,489,15,582,704,1874,83,105
1362,260,10,808,641,3081,247,656,22,550,1558,3033,83,106
1741,280,11,894,708,3634,290,801,32,618,1833,3574,83,107
1742,269,12,982,623,3628,291,822,23,679,1833,3648,83,108
1708,309,15,892,746,3670,300,875,23,637,1768,3603,83,109
1188,295,15,900,719,3117,306,690,67,655,1345,3063,83,110
277,302,11,1169,762,2521,94,715,83,694,907,2493,83,111
190,176,8,760,384,1518,60,334,24,554,584,1556,83,112
1486,272,20,829,1104,3711,696,560,33,629,1731,3649,83,113
2028,293,15,1027,1194,4557,718,811,30,666,2053,4278,83,114
1992,343,15,1012,1221,4583,707,944,23,658,2035,4367,83,115
2145,321,9,1030,1249,4754,697,884,25,768,2011,4385,83,116
1407,374,16,1143,1247,4187,674,790,71,785,1508,3828,83,117
336,273,12,962,548,2131,134,548,63,601,675,2021,83,118
226,226,5,863,546,1866,92,468,30,580,605,1775,83,119
1593,296,3,818,1134,3844,699,629,24,596,1678,3626,83,120
2108,296,10,908,1182,4504,755,741,26,682,2069,4273,83,121
2025,313,4,1006,1213,4561,728,861,16,734,1984,4323,83,122
2002,302,4,1021,1243,4572,725,790,17,751,1941,4224,83,123
1374,330,15,1173,1112,4004,682,682,53,729,1446,3592,83,124
309,245,7,986,506,2053,112,497,51,496,650,1806,83,125
199,191,2,727,366,1485,86,382,10,486,523,1487,83,126
1582,258,8,855,1084,3787,654,664,21,612,1635,3586,83,127
2099,270,5,902,1298,4574,736,876,24,709,2054,4399,83,128
2010,296,15,959,1264,4544,743,869,23,744,1966,4345,83,129
1878,277,14,915,1087,4171,549,802,19,715,1940,4025,83,130
1291,321,8,940,869,3429,544,563,59,697,1509,3372,83,131
300,284,9,1116,666,2375,124,463,48,838,830,2303,83,132
197,167,18,723,368,1473,87,376,24,475,505,1467,83,133
1523,260,16,850,1100,3749,697,652,46,620,1688,3703,83,134
2060,262,17,919,1113,4371,752,723,32,683,2079,4269,83,135
2007,292,20,878,1192,4389,698,805,40,636,2067,4246,83,136
1935,314,20,925,1244,4438,778,850,40,714,1999,4381,83,137
1329,309,12,1109,1010,3769,725,668,53,747,1538,3731,83,138
293,1093,195,1101,1377,4059,808,642,33,2061,1264,4808,83,139
239,928,65,1050,1270,3552,559,487,13,1740,945,3744,83,140
1591,236,3,820,1099,3749,726,604,19,594,1660,3603,83,141
2029,286,24,879,1255,4473,774,838,45,670,2130,4457,83,142
2000,309,7,837,1098,4251,777,768,24,674,2059,4302,83,143
1749,266,8,829,1055,3907,715,656,11,644,1851,3877,83,144
1136,297,13,1167,1009,3622,690,632,64,730,1328,3444,83,145
268,256,18,873,588,2003,96,592,58,551,653,1950,83,146
201,186,4,842,394,1627,69,433,23,480,595,1600,83,147
203,128,8,611,297,1247,94,316,20,396,488,1314,83,148
1817,279,23,792,1067,3978,691,651,28,667,1920,3957,83,149
1891,255,4,839,955,3944,730,693,17,653,1916,4009,83,150
1875,293,5,870,1121,4164,759,817,17,676,1868,4137,83,151
1309,336,34,1133,931,3743,722,703,74,752,1460,3711,83,152
66,24,7,34,15,146,54,26,4,32,13,129,83,153
28,11,1,24,12,76,13,9,0,25,8,55,83,154
3,9,2,5,14,33,5,5,2,9,10,31,83,155
2,1,1,4,6,14,1,0,3,6,4,14,83,156
4,5,3,1,7,20,5,6,2,0,9,22,83,157
10,0,0,13,1,24,8,0,0,8,1,17,83,158
1,4,4,1,3,13,0,4,4,1,3,12,83,159
4,5,1,2,9,21,3,5,0,2,5,15,83,160
9,6,0,5,4,24,2,5,0,4,8,19,83,161
3,3,0,3,1,10,2,3,0,2,4,11,83,162
5,5,1,2,9,22,7,7,0,3,8,25,83,163
2,9,0,9,8,28,1,8,0,9,7,25,83,164
1,0,2,0,1,4,1,0,0,0,1,2,83,165
12,13,5,23,12,65,12,10,8,18,6,54,83,166
18,18,0,7,10,53,17,14,0,6,7,44,83,167
5,12,1,5,6,29,5,9,1,6,5,26,83,168
18,9,4,4,9,44,13,8,2,6,7,36,83,169
22,8,2,13,7,52,10,6,0,13,4,33,83,170
8,11,3,6,8,36,5,9,0,7,5,26,83,171
20,10,19,10,6,65,17,9,9,12,5,52,83,172
21,10,10,16,11,68,26,7,6,10,7,56,83,173
12,16,10,4,11,53,13,12,5,4,9,43,83,174
24,30,8,15,16,93,17,19,10,14,15,75,83,175
10,29,31,10,47,127,4,29,27,11,35,106,83,176
21,24,29,40,26,140,17,20,20,33,23,113,83,177
43,13,16,36,35,143,38,10,16,42,25,131,83,178
37,44,21,43,41,186,39,40,10,55,27,171,83,179
828,304,46,665,596,2439,230,763,98,623,1413,3127,83,180
293,291,41,903,555,2083,135,781,129,660,961,2666,83,181
263,180,19,753,490,1705,131,554,81,620,729,2115,83,182
1401,235,23,938,710,3307,353,949,60,662,1971,3995,83,183
1809,217,11,960,700,3697,401,1054,29,776,2097,4357,83,184
1560,314,15,1041,873,3803,370,1060,53,937,1926,4346,83,185
305,1312,51,1032,915,3615,187,1895,107,799,805,3793,83,186
879,294,35,952,597,2757,273,795,98,728,1294,3188,83,187
328,279,15,861,538,2021,139,750,107,698,836,2530,83,188
238,237,7,841,390,1713,110,602,39,595,871,2217,83,189
1582,245,20,825,582,3254,339,811,47,685,1959,3841,83,190
1964,241,22,928,665,3820,447,1056,45,817,2242,4607,83,191
1930,224,16,901,704,3775,423,1051,42,855,2228,4599,83,192
1920,309,15,1022,798,4064,458,1108,62,880,2233,4741,83,193
1354,345,20,889,818,3426,376,964,112,827,1663,3942,83,194
364,378,28,1146,742,2658,149,855,152,785,1070,3011,83,195
263,228,29,868,423,1811,120,642,53,640,760,2215,83,196
1655,243,21,840,625,3384,400,769,50,687,1936,3842,83,197
2018,231,26,839,724,3838,383,1015,48,729,2234,4409,83,198
2046,247,17,921,646,3877,443,853,34,827,2389,4546,83,199
1936,255,11,1034,798,4034,433,1066,48,884,2304,4735,83,200
1369,404,37,989,979,3778,354,1030,210,912,1675,4181,83,201
354,332,17,1057,764,2524,164,885,112,797,995,2953,83,202
260,223,11,1053,502,2049,116,633,40,779,958,2526,83,203
1711,208,13,852,601,3385,367,789,42,751,1899,3848,83,204
2143,269,18,1082,788,4300,442,1188,40,806,2428,4904,83,205
2087,301,15,1162,765,4330,455,1140,47,969,2565,5176,83,206
1997,326,10,1119,774,4226,412,1085,41,848,2321,4707,83,207
1420,428,12,1085,847,3792,385,976,112,859,1858,4190,83,208
391,364,12,1230,743,2740,128,935,171,852,1151,3237,83,209
292,284,12,947,525,2060,104,735,76,654,929,2498,83,210
1702,206,10,906,773,3597,354,929,85,788,2020,4176,83,211
2153,268,12,1055,707,4195,386,1010,37,801,2481,4715,83,212
2118,257,8,1000,694,4077,411,1071,30,813,2305,4630,83,213
2011,295,12,1008,803,4129,398,1064,49,823,2336,4670,83,214
1358,374,22,1087,943,3784,351,1138,136,868,1740,4233,83,215
393,300,13,1212,604,2522,132,852,108,816,1102,3010,83,216
320,188,6,1011,481,2006,142,604,35,710,938,2429,83,217
1547,284,7,841,658,3337,343,947,30,743,1861,3924,83,218
2002,269,20,941,743,3975,394,1080,45,792,2255,4566,83,219
2069,301,14,990,794,4168,447,1004,45,784,2311,4591,83,220
1838,219,20,1013,676,3766,379,828,56,876,2028,4167,83,221
1084,317,16,837,751,3005,304,844,108,683,1398,3337,83,222
333,382,13,1128,587,2443,147,846,107,797,1014,2911,83,223
306,251,10,1016,453,2036,121,648,40,766,885,2460,83,224
1604,220,7,952,660,3443,381,821,29,765,1917,3913,83,225
2013,272,12,1060,774,4131,410,1017,39,803,2393,4662,83,226
2042,297,13,1063,772,4187,434,995,39,875,2381,4724,83,227
1895,280,23,1090,881,4169,447,1029,73,842,2167,4558,83,228
1334,390,19,935,800,3478,434,945,151,859,1605,3994,83,229
340,309,9,1155,636,2449,127,753,114,815,1007,2816,83,230
251,224,7,878,459,1819,101,621,26,681,915,2344,83,231
1512,256,14,827,735,3344,391,767,57,775,1997,3987,83,232
1980,246,23,907,837,3993,426,1092,56,769,2461,4804,83,233
1930,302,9,1121,893,4255,468,1033,57,807,2496,4861,83,234
2020,295,17,1273,881,4486,499,1025,57,878,2446,4905,83,235
1411,347,17,1141,993,3909,464,1018,116,921,1835,4354,83,236
447,322,26,1212,689,2696,138,951,137,915,1175,3316,83,237
324,218,23,1012,496,2073,150,653,50,807,969,2629,83,238
1884,247,16,1012,1301,4460,830,945,43,769,2274,4861,83,239
2546,303,28,1022,1406,5305,942,1242,40,790,2807,5821,83,240
2548,277,29,1034,1335,5223,1054,1129,49,824,2724,5780,83,241
2254,305,19,1006,1291,4875,878,1018,52,865,2618,5431,83,242
1620,316,25,1320,1127,4408,774,926,112,992,1875,4679,83,243
369,313,53,1249,607,2591,145,879,136,802,1061,3023,83,244
235,179,9,927,420,1770,123,407,35,467,686,1718,83,245
179,136,4,712,312,1343,89,377,16,428,513,1423,83,246
1921,211,22,838,1061,4053,727,630,33,648,1947,3985,83,247
1962,271,11,813,1103,4160,753,735,21,570,2042,4121,83,248
1903,298,8,795,1204,4208,825,709,25,631,1943,4133,83,249
1238,301,16,976,994,3525,707,660,70,668,1378,3483,83,250
286,241,28,966,579,2100,113,534,111,707,631,2096,83,251
221,190,11,785,565,1772,92,415,17,769,559,1852,83,252
1677,230,2,758,1063,3730,838,665,18,573,1677,3771,83,253
2094,253,2,803,1166,4318,819,803,18,639,2067,4346,83,254
1938,271,14,908,1262,4393,885,847,28,685,2049,4494,83,255
1960,270,8,846,1250,4334,804,850,24,626,2067,4371,83,256
1364,576,14,1134,1152,4240,1110,781,74,702,1724,4391,83,257
306,316,17,1012,732,2383,122,668,81,682,694,2247,83,258
243,173,4,890,395,1705,137,392,26,570,713,1838,83,259
1688,250,8,815,1136,3897,848,591,22,651,1759,3871,83,260
2127,258,8,875,1159,4427,873,761,24,638,2219,4515,83,261
2093,275,1,852,1279,4500,755,825,28,627,2039,4274,83,262
2059,273,8,931,1336,4607,894,897,23,682,2094,4590,83,263
1402,361,16,1126,1072,3977,774,733,57,715,1609,3888,83,264
334,297,15,1138,682,2466,137,690,85,687,761,2360,83,265
191,149,4,834,387,1565,75,410,16,575,530,1606,83,266
1656,225,2,793,1106,3782,819,617,18,588,1753,3795,83,267
2121,214,5,884,1276,4500,818,770,47,639,2134,4408,83,268
2022,246,1,852,1334,4455,829,881,14,612,2083,4419,83,269
1864,258,6,905,1281,4314,729,800,22,693,1919,4163,83,270
1406,270,12,1086,1043,3817,784,707,60,668,1415,3634,83,271
289,294,18,1108,741,2450,113,733,90,754,773,2463,83,272
221,159,2,813,370,1565,87,376,17,542,576,1598,83,273
1656,225,9,827,1171,3888,811,622,23,602,1785,3843,83,274
2129,266,4,790,1287,4476,790,766,19,642,2190,4407,83,275
1998,224,2,889,1225,4338,799,744,7,726,2047,4323,83,276
1837,293,9,917,1283,4339,814,722,22,747,1925,4230,83,277
1352,313,10,1169,1162,4006,796,672,53,720,1536,3777,83,278
304,287,16,1092,685,2384,143,611,69,784,720,2327,83,279
246,202,4,1182,1059,2693,117,364,19,1488,721,2709,83,280
1667,209,7,754,1252,3889,787,654,22,649,1684,3796,83,281
2150,279,4,1093,1228,4754,857,828,17,717,2276,4695,83,282
2147,328,6,1003,1246,4730,835,806,11,781,2213,4646,83,283
1850,308,1,892,1058,4109,582,811,31,746,1876,4046,83,284
1191,336,10,1144,855,3536,526,677,51,710,1450,3414,83,285
311,263,23,1031,632,2260,136,636,63,562,758,2155,83,286
206,166,2,876,458,1708,105,484,22,569,613,1793,83,287
696,174,5,896,517,2288,193,502,11,596,1001,2303,83,288
2018,249,8,906,1316,4497,817,831,34,606,2139,4427,83,289
1962,245,3,1017,1203,4430,771,826,17,730,2122,4466,83,290
1918,266,4,885,1314,4387,835,820,23,667,1948,4293,83,291
1362,307,12,1142,1226,4049,756,721,73,719,1582,3851,83,292
334,298,10,1099,764,2505,105,651,80,813,809,2458,83,293
220,161,3,887,523,1794,77,540,30,575,602,1824,83,294
1630,221,6,845,1136,3838,778,675,22,587,1760,3822,83,295
2160,273,2,951,1340,4726,883,854,14,708,2249,4708,83,296
2097,274,13,988,1336,4708,907,849,27,705,2214,4702,83,297
1961,318,23,1001,1442,4745,891,932,36,741,2116,4716,83,298
1382,355,6,988,1077,3808,560,651,70,827,1556,3664,83,299
322,297,20,1001,624,2264,132,506,75,705,752,2170,83,300
324,161,3,884,435,1807,102,432,21,720,678,1953,83,301
1648,276,6,812,1152,3894,772,658,16,622,1878,3946,83,302
2060,260,11,888,1845,5064,824,1327,27,654,2085,4917,83,303
2098,274,6,962,1382,4722,865,818,23,745,2184,4635,83,304
1807,349,5,919,1293,4373,843,676,30,749,2060,4358,83,305
1418,312,23,1202,1128,4083,717,692,77,797,1545,3828,83,306
286,297,25,1101,717,2426,102,617,86,762,793,2360,83,307
235,160,13,878,433,1719,107,356,21,644,627,1755,83,308
1316,184,4,881,988,3373,558,620,17,640,1662,3497,83,309
1537,256,8,908,772,3481,333,567,49,840,1638,3427,83,310
1762,234,2,802,1231,4031,831,583,25,701,1970,4110,83,311
1923,248,4,943,1267,4385,845,714,16,662,1946,4183,83,312
1379,301,9,1202,1098,3989,794,667,52,723,1534,3770,83,313
299,244,27,1060,583,2213,123,426,65,695,801,2110,83,314
195,133,4,888,444,1664,108,333,25,569,686,1721,83,315
755,161,2,910,492,2320,190,458,14,623,1003,2288,83,316
2203,238,6,886,1299,4632,830,727,19,695,2258,4529,83,317
2123,231,19,877,1302,4552,817,798,24,706,2156,4501,83,318
2043,243,1,863,1213,4363,784,741,7,684,2106,4322,83,319
1360,301,21,1086,1079,3847,701,625,80,679,1517,3602,83,320
285,185,11,1050,517,2048,106,356,54,600,700,1816,83,321
157,106,1,675,294,1233,86,286,16,449,423,1260,83,322
1743,196,5,835,1193,3972,784,605,12,641,1840,3882,83,323
2259,189,4,878,1299,4629,882,769,7,664,2239,4561,83,324
2118,207,0,940,1313,4578,804,732,6,725,2154,4421,83,325
2013,231,0,953,1270,4467,882,814,9,741,2066,4512,83,326
1370,191,11,1087,942,3601,820,623,60,711,1527,3741,83,327
285,212,12,984,627,2120,111,511,60,656,741,2079,83,328
214,121,8,813,435,1591,100,359,23,520,571,1573,83,329
1474,171,3,863,846,3357,533,491,24,678,1638,3364,83,330
1588,217,7,1038,852,3702,448,601,18,749,1697,3513,83,331
932,245,9,958,594,2738,213,530,14,815,1070,2642,83,332
158,91,0,334,153,736,64,153,9,269,270,765,83,333
380,150,5,996,363,1894,128,470,22,546,893,2059,83,334
199,149,9,853,484,1694,96,390,32,537,798,1853,83,335
143,108,4,653,326,1234,75,422,15,462,555,1529,83,336
1603,172,3,787,1153,3718,802,663,12,678,1876,4031,83,337
2130,194,4,891,1202,4421,809,737,14,709,2312,4581,83,338
2126,212,10,891,1198,4437,739,743,19,720,2074,4295,83,339
1929,241,6,944,1145,4265,740,802,28,643,1971,4184,83,340
1322,232,28,1082,990,3654,691,639,70,653,1476,3529,83,341
243,230,14,930,643,2060,97,586,65,611,678,2037,83,342
178,130,5,935,486,1734,89,461,11,603,618,1782,83,343
1621,213,0,762,1150,3746,741,628,13,564,1712,3658,83,344
2158,248,0,920,1255,4581,812,826,13,659,2249,4559,83,345
2071,263,5,813,953,4105,703,819,13,593,1971,4099,83,346
2018,249,4,973,1321,4565,699,889,24,738,2073,4423,83,347
1253,287,11,1236,1074,3861,681,667,74,740,1577,3739,83,348
305,253,9,1027,756,2350,88,567,67,685,770,2177,83,349
182,131,1,810,392,1516,74,397,7,517,495,1490,83,350
1499,184,4,775,1107,3569,727,579,15,593,1667,3581,83,351
1978,194,3,992,1333,4500,714,764,19,737,2073,4307,83,352
2022,222,8,929,1207,4388,756,734,26,731,1981,4228,83,353
1745,206,5,947,1313,4216,738,766,19,717,1790,4030,83,354
1141,261,19,1124,911,3456,603,675,54,726,1273,3331,83,355
240,163,8,928,525,1864,91,417,44,562,621,1735,83,356
152,106,4,721,394,1377,77,358,14,401,439,1289,83,357
685,120,1,916,532,2254,196,393,11,554,1025,2179,83,358
446,117,3,673,300,1539,149,232,11,530,519,1441,83,359
81,71,4,298,179,633,38,134,6,161,250,589,83,360
525,128,5,779,399,1836,136,399,22,490,794,1841,83,361
545,149,9,852,436,1991,167,486,34,569,978,2234,83,362
172,160,13,727,409,1481,70,396,57,406,573,1502,83,363
155,117,4,719,353,1348,71,306,25,404,534,1340,83,364
728,153,4,864,537,2286,165,510,28,609,1010,2322,83,365
699,315,94,915,426,2449,190,335,183,729,959,2396,83,366
45,131,8,298,267,749,80,110,10,373,266,839,84,1
495,247,5,539,910,2196,618,235,13,626,900,2392,84,2
761,316,17,639,1451,3184,1080,279,18,753,1212,3342,84,3
686,294,6,658,1408,3052,1063,256,9,724,1172,3224,84,4
454,346,11,615,1391,2817,933,353,20,740,922,2968,84,5
106,216,21,450,396,1189,148,250,26,536,304,1264,84,6
81,210,15,541,407,1254,98,192,13,612,466,1381,84,7
649,337,5,736,1436,3163,1053,314,16,769,1134,3286,84,8
823,222,14,759,1161,2979,1117,224,19,758,1016,3134,84,9
853,425,13,956,1516,3763,1168,388,21,930,1454,3961,84,10
898,410,15,780,1603,3706,1216,451,28,864,1355,3914,84,11
465,340,9,757,1439,3010,1031,315,25,978,996,3345,84,12
119,363,14,977,676,2149,215,421,32,791,985,2444,84,13
89,229,20,670,537,1545,143,297,25,719,755,1939,84,14
144,324,3,798,652,1921,248,397,7,807,832,2291,84,15
284,334,16,615,809,2058,429,398,26,613,727,2193,84,16
667,766,9,1090,1832,4364,846,429,17,1646,1735,4673,84,17
933,820,25,928,2006,4712,1346,668,35,1174,1673,4896,84,18
275,643,44,757,1010,2729,366,588,112,796,812,2674,84,19
105,411,32,1046,873,2467,178,568,45,913,790,2494,84,20
106,276,12,839,637,1870,160,373,14,743,709,1999,84,21
822,796,21,791,1786,4216,1331,373,19,1188,1603,4514,84,22
1023,841,11,926,2028,4829,1412,512,13,1372,1859,5168,84,23
1104,865,16,970,2032,4987,1330,540,24,1425,1954,5273,84,24
919,822,22,860,1901,4524,1329,576,28,1310,1716,4959,84,25
494,775,19,1048,1655,3991,879,749,122,1136,1276,4162,84,26
161,430,25,1193,948,2757,231,612,64,930,1059,2896,84,27
130,267,8,867,579,1851,159,317,15,851,740,2082,84,28
828,764,13,837,1855,4297,1344,391,27,1222,1652,4636,84,29
1032,821,11,933,1955,4752,1444,482,17,1309,1920,5172,84,30
1071,799,7,983,1953,4813,1364,572,14,1375,1848,5173,84,31
994,839,6,882,1928,4649,1297,547,17,1396,1775,5032,84,32
571,933,29,963,2030,4526,1166,704,129,1176,1341,4516,84,33
126,361,22,883,613,2005,135,340,28,689,681,1873,84,34
86,188,14,660,488,1436,116,225,13,573,469,1396,84,35
852,721,22,760,1796,4151,1319,422,31,1188,1586,4546,84,36
1054,828,7,857,2008,4754,1386,555,10,1198,1913,5062,84,37
1051,728,9,1065,2049,4902,1355,574,12,1438,1907,5286,84,38
1008,839,16,945,2028,4836,1331,544,19,1277,1868,5039,84,39
610,787,24,1034,1852,4307,1212,699,109,1077,1351,4448,84,40
193,548,21,1326,945,3033,244,738,93,986,1129,3190,84,41
97,255,4,963,635,1954,176,405,19,754,833,2187,84,42
824,720,6,839,1976,4365,1347,448,9,1263,1614,4681,84,43
998,814,10,1065,1966,4853,1410,733,12,1389,1803,5347,84,44
1078,808,7,1111,2117,5121,1466,587,22,1428,2052,5555,84,45
994,883,14,1147,1905,4943,1325,615,19,1313,1738,5010,84,46
499,695,41,1094,1425,3754,750,657,115,1025,1217,3764,84,47
127,472,43,1211,816,2669,214,535,107,869,916,2641,84,48
124,327,9,914,645,2019,161,441,14,831,789,2236,84,49
225,641,13,802,988,2669,512,341,16,1095,890,2854,84,50
1025,755,5,902,1971,4658,1363,546,13,1284,1851,5057,84,51
1070,806,4,1036,1969,4885,1298,539,11,1372,1975,5195,84,52
1103,744,8,959,2020,4834,1319,582,7,1335,1777,5020,84,53
696,704,65,1039,1984,4488,1158,723,120,1158,1342,4501,84,54
113,19,122,27,9,290,94,17,132,42,11,296,84,55
23,33,12,0,8,76,27,19,10,5,6,67,84,56
885,695,4,778,1843,4205,1363,493,7,1068,1608,4539,84,57
1111,804,6,911,1966,4798,1478,584,13,1240,1953,5268,84,58
1054,809,11,1028,1847,4749,1385,497,17,1297,1931,5127,84,59
985,777,13,1073,2008,4856,1384,540,24,1351,1832,5131,84,60
647,721,14,996,2031,4409,1116,783,81,1092,1377,4449,84,61
140,515,27,1042,875,2599,160,565,84,842,928,2579,84,62
134,288,11,945,649,2027,135,411,20,880,914,2360,84,63
800,724,12,811,1885,4232,1330,455,14,1165,1601,4565,84,64
1005,731,12,947,2001,4696,1352,502,13,1197,1887,4951,84,65
1064,730,7,1108,2025,4934,1371,594,21,1389,1901,5276,84,66
1001,771,9,1030,2102,4913,1365,685,17,1162,1794,5023,84,67
618,628,25,1210,2217,4698,1104,660,55,1064,1294,4177,84,68
216,267,18,1074,614,2189,162,421,37,726,560,1906,84,69
90,273,1,658,503,1525,113,303,4,525,617,1562,84,70
769,454,9,805,1541,3578,1118,443,15,866,1337,3779,84,71
969,454,6,891,1671,3991,1152,623,9,963,1567,4314,84,72
964,504,5,999,1672,4144,1234,619,14,949,1549,4365,84,73
749,468,11,993,1379,3600,823,637,27,965,1400,3852,84,74
505,448,16,900,1150,3019,751,509,67,859,1133,3319,84,75
179,393,24,1026,728,2350,173,713,70,1046,955,2957,84,76
84,268,8,777,656,1793,110,727,13,933,933,2716,84,77
895,648,11,893,1843,4290,1342,493,13,1347,1578,4773,84,78
1183,752,15,1010,2094,5054,1397,659,14,1372,1987,5429,84,79
1187,827,8,1295,2169,5486,1389,807,22,1597,2003,5818,84,80
1150,838,10,1106,2121,5225,1367,728,20,1501,1960,5576,84,81
728,724,30,1224,2077,4783,1135,913,63,1245,1511,4867,84,82
137,574,34,986,979,2710,188,766,64,766,926,2710,84,83
130,379,5,1169,812,2495,133,583,12,986,1210,2924,84,84
815,753,6,901,1935,4410,1222,564,24,1225,1704,4739,84,85
1167,765,13,1130,2083,5158,1315,638,22,1493,1942,5410,84,86
1096,745,18,1025,1853,4737,1264,596,16,1418,1694,4988,84,87
914,830,15,1091,1923,4773,1226,599,12,1326,1762,4925,84,88
581,799,25,1394,2003,4802,1092,801,59,1399,1417,4768,84,89
147,579,21,1515,1009,3271,214,844,80,1044,1315,3497,84,90
131,282,15,1041,608,2077,150,504,25,857,849,2385,84,91
748,684,7,952,1735,4126,1088,546,6,1245,1514,4399,84,92
1009,819,35,987,2047,4897,1385,643,35,1376,1831,5270,84,93
1106,736,28,961,1953,4784,1349,679,35,1232,1790,5085,84,94
982,818,20,1093,2180,5093,1437,743,26,1306,1877,5389,84,95
544,779,30,1211,1954,4518,955,889,96,1183,1451,4574,84,96
223,619,33,1463,1119,3457,324,866,67,1257,1159,3673,84,97
230,344,4,1044,642,2264,169,460,7,1072,901,2609,84,98
804,724,15,930,1780,4253,1266,447,27,1280,1618,4638,84,99
1064,789,3,1014,1994,4864,1420,581,15,1313,1915,5244,84,100
1085,786,8,1091,1994,4964,1348,708,10,1377,1904,5347,84,101
1030,794,8,984,2006,4822,1355,672,10,1326,1777,5140,84,102
602,781,29,1101,2059,4572,1152,815,83,1165,1396,4611,84,103
203,569,41,1347,1064,3224,239,815,75,1034,1097,3260,84,104
137,348,1,1031,716,2233,159,498,12,1098,918,2685,84,105
670,667,8,855,1400,3600,913,540,32,1196,1367,4048,84,106
792,754,10,990,1509,4055,940,641,17,1236,1722,4556,84,107
914,779,9,1080,1510,4292,970,671,26,1386,1707,4760,84,108
751,879,19,1045,1577,4271,943,813,41,1239,1561,4597,84,109
522,594,34,1076,1627,3853,826,779,81,1065,1293,4044,84,110
176,605,39,1380,986,3186,218,832,100,983,1283,3416,84,111
117,338,10,902,620,1987,134,398,20,872,780,2204,84,112
792,698,8,866,1849,4213,1296,470,15,1189,1634,4604,84,113
1003,729,7,1008,2216,4963,1381,751,28,1316,1834,5310,84,114
1053,755,17,1138,2112,5075,1332,727,20,1381,1933,5393,84,115
1050,770,10,1080,2062,4972,1385,789,32,1313,1792,5311,84,116
685,831,65,1116,2158,4855,1235,806,159,1285,1327,4812,84,117
200,538,31,1041,780,2590,220,678,83,905,836,2722,84,118
145,393,10,864,677,2089,154,507,46,1002,751,2460,84,119
844,731,3,830,1861,4269,1356,527,13,1134,1568,4598,84,120
1060,567,8,1091,2064,4790,1381,654,25,1153,1833,5046,84,121
1071,581,10,1040,1912,4614,1256,634,24,1413,1719,5046,84,122
949,703,28,1065,1875,4620,1243,676,43,1352,1613,4927,84,123
611,763,24,1043,2076,4517,1081,829,77,1477,1351,4815,84,124
156,480,26,1067,850,2579,184,590,43,952,957,2726,84,125
107,333,28,786,532,1786,122,425,42,772,672,2033,84,126
790,560,10,852,1762,3974,1134,512,22,1285,1426,4379,84,127
1026,644,6,1058,1981,4715,1270,750,28,1346,1772,5166,84,128
1009,583,11,1036,2045,4684,1169,873,143,1443,1634,5262,84,129
869,552,9,941,1835,4206,1069,600,23,1258,1553,4503,84,130
707,508,27,979,1759,3980,1171,558,29,1242,1238,4238,84,131
147,437,21,975,694,2274,327,353,38,947,731,2396,84,132
103,268,14,573,442,1400,129,277,24,634,533,1597,84,133
783,453,9,823,1615,3683,1176,495,10,994,1363,4038,84,134
999,392,4,869,1703,3967,1247,441,9,932,1537,4166,84,135
970,432,6,823,1784,4015,1239,559,29,972,1437,4236,84,136
900,510,8,889,1725,4032,1223,584,23,995,1500,4325,84,137
543,519,21,814,1571,3468,1077,482,38,953,1194,3744,84,138
98,324,24,690,682,1818,174,375,27,777,606,1959,84,139
117,333,1,702,588,1741,130,342,5,808,694,1979,84,140
912,446,3,858,1801,4020,1276,505,8,1077,1460,4326,84,141
1135,550,6,843,1954,4488,1380,617,23,1132,1690,4842,84,142
1080,541,6,870,1829,4326,1403,600,15,1004,1728,4750,84,143
911,523,38,833,1699,4004,1284,524,57,969,1454,4288,84,144
590,447,26,934,1714,3711,1098,570,46,1312,1063,4089,84,145
151,379,12,799,623,1964,204,536,47,683,610,2080,84,146
97,310,1,649,468,1525,116,342,8,685,661,1812,84,147
102,275,19,558,390,1344,143,250,25,622,535,1575,84,148
1105,469,13,856,1763,4206,1272,393,25,1064,1586,4340,84,149
1197,399,15,958,1646,4215,1273,514,23,1164,1524,4498,84,150
992,455,3,842,1601,3893,1196,528,18,962,1510,4214,84,151
628,483,20,832,1544,3507,1125,535,34,955,1107,3756,84,152
119,364,20,838,563,1904,204,435,37,766,598,2040,84,153
87,266,4,671,459,1487,150,291,10,726,587,1764,84,154
995,371,5,896,1605,3872,1199,515,8,1012,1474,4208,84,155
1080,405,5,853,1285,3628,900,620,8,895,1651,4074,84,156
1291,439,11,878,1667,4286,1182,581,17,1109,1690,4579,84,157
1222,455,0,885,1785,4347,1231,628,12,1112,1643,4626,84,158
714,517,16,929,1770,3946,1093,811,67,1029,1154,4154,84,159
153,528,21,1170,932,2804,206,972,56,848,1075,3157,84,160
126,401,5,852,578,1962,136,598,9,767,829,2339,84,161
1042,393,13,777,1471,3696,1125,448,16,997,1509,4095,84,162
1400,487,5,932,1673,4497,1269,714,17,1172,1819,4991,84,163
1261,455,22,1003,1631,4372,1240,794,29,1175,1595,4833,84,164
1254,519,4,918,1537,4232,1187,658,14,1086,1685,4630,84,165
820,489,27,997,1407,3740,1036,622,60,1083,1170,3971,84,166
158,422,21,883,708,2192,215,589,50,791,767,2412,84,167
97,257,6,764,448,1572,135,315,6,775,616,1847,84,168
911,414,28,826,1204,3383,935,467,42,887,1393,3724,84,169
1123,449,7,837,1172,3588,861,603,26,903,1588,3981,84,170
309,382,7,873,761,2332,429,541,9,806,838,2623,84,171
1055,460,2,765,1154,3436,833,601,12,791,1521,3758,84,172
619,433,15,751,1151,2969,750,517,33,764,1036,3100,84,173
126,471,20,735,635,1987,207,624,89,714,583,2217,84,174
113,259,4,603,448,1427,152,329,12,706,552,1751,84,175
891,360,6,674,1056,2987,839,434,15,758,1370,3416,84,176
1115,421,4,787,1213,3540,935,600,12,826,1621,3994,84,177
1127,417,3,889,1152,3588,981,561,13,923,1591,4069,84,178
1083,452,15,932,1267,3749,939,668,19,929,1521,4076,84,179
705,470,22,894,1142,3233,765,571,45,953,1102,3436,84,180
126,388,29,819,657,2019,160,575,44,741,710,2230,84,181
114,269,9,574,395,1361,139,302,30,590,536,1597,84,182
843,369,6,805,1192,3215,891,570,13,813,1318,3605,84,183
996,382,6,852,1243,3479,871,585,11,864,1485,3816,84,184
770,386,1,981,1273,3411,845,617,21,1044,1228,3755,84,185
140,1124,18,814,772,2868,184,1473,36,695,601,2989,84,186
324,347,19,669,814,2173,476,482,32,683,689,2362,84,187
111,328,12,682,444,1577,161,421,45,621,559,1807,84,188
96,264,10,672,485,1527,137,341,14,665,627,1784,84,189
901,385,7,855,1072,3220,853,511,12,859,1410,3645,84,190
1185,374,4,926,1190,3679,952,619,13,899,1616,4099,84,191
1084,364,14,986,1223,3671,1000,549,24,898,1681,4152,84,192
1062,420,5,938,1278,3703,901,647,14,906,1573,4041,84,193
714,384,38,848,1130,3114,739,525,76,898,1036,3274,84,194
151,385,38,813,640,2027,194,528,51,741,682,2196,84,195
86,269,24,662,464,1505,158,323,36,709,643,1869,84,196
904,441,8,792,1032,3177,882,441,9,814,1371,3517,84,197
1081,385,11,855,1268,3600,956,590,18,839,1588,3991,84,198
1116,415,3,759,1215,3508,934,532,8,843,1596,3913,84,199
1092,419,3,896,1233,3643,923,615,8,960,1536,4042,84,200
641,500,15,882,1228,3266,754,645,102,886,1039,3426,84,201
110,361,15,896,666,2048,172,612,69,765,675,2293,84,202
126,262,6,780,477,1651,145,368,10,731,673,1927,84,203
889,337,8,780,1054,3068,833,433,9,799,1288,3362,84,204
1078,381,5,878,1253,3595,934,589,9,810,1692,4034,84,205
1051,404,1,987,1271,3714,966,568,8,877,1675,4094,84,206
1030,410,1,825,1190,3456,862,608,11,897,1437,3815,84,207
588,435,18,766,1148,2955,765,467,65,891,1074,3262,84,208
123,362,11,878,585,1959,151,453,72,763,706,2145,84,209
104,268,12,682,455,1521,135,311,24,686,600,1756,84,210
827,355,6,788,1141,3117,782,452,43,866,1340,3483,84,211
1039,372,4,833,1193,3441,883,547,9,884,1548,3871,84,212
974,406,3,795,1120,3298,1479,556,8,724,1348,4115,84,213
883,386,2,815,1075,3161,817,524,6,795,1392,3534,84,214
567,391,19,788,1096,2861,766,534,53,786,1012,3151,84,215
120,282,20,788,487,1697,156,353,35,710,621,1875,84,216
101,271,5,630,416,1423,144,298,4,687,559,1692,84,217
656,380,9,759,1016,2820,835,412,7,755,1208,3217,84,218
841,364,8,730,1136,3079,858,490,11,766,1311,3436,84,219
781,402,13,676,1113,2985,815,415,19,740,1302,3291,84,220
734,348,24,684,1046,2836,774,427,18,728,1123,3070,84,221
382,352,19,590,948,2291,597,426,55,614,811,2503,84,222
94,325,11,678,600,1708,168,385,56,702,547,1858,84,223
94,258,16,611,371,1350,119,292,22,683,517,1633,84,224
549,374,9,650,1104,2686,825,393,11,769,1068,3066,84,225
725,404,15,705,1132,2981,866,454,22,803,1293,3438,84,226
683,395,8,727,1204,3017,891,466,10,840,1207,3414,84,227
643,450,14,718,1099,2924,814,447,13,791,1156,3221,84,228
401,435,17,744,1064,2661,704,434,36,813,851,2838,84,229
92,339,18,840,649,1938,172,392,56,868,614,2102,84,230
95,280,2,733,519,1629,171,294,5,717,654,1841,84,231
545,484,5,910,1260,3204,897,456,18,921,1253,3545,84,232
662,573,6,1346,1469,4056,973,639,13,949,1709,4283,84,233
662,683,3,1224,1537,4109,969,682,28,1108,1563,4350,84,234
620,754,27,1519,1529,4449,1024,692,26,1278,1655,4675,84,235
414,882,20,1184,1527,4027,940,805,187,1259,1181,4372,84,236
161,809,27,1373,1001,3371,204,862,175,1055,1202,3498,84,237
118,377,5,1008,630,2138,195,421,30,988,930,2564,84,238
713,841,4,797,1923,4278,1386,475,9,1242,1574,4686,84,239
891,909,16,959,2162,4937,1548,635,12,1240,1784,5219,84,240
884,963,13,1066,2318,5244,1410,891,17,1507,1744,5569,84,241
823,830,11,883,2047,4594,1432,605,19,1313,1619,4988,84,242
511,823,21,1082,2001,4438,1193,766,117,1216,1126,4418,84,243
123,539,31,1210,844,2747,148,700,138,889,1110,2985,84,244
121,603,9,1200,746,2679,142,773,38,942,1054,2949,84,245
111,334,2,941,639,2027,179,478,10,822,876,2365,84,246
1007,995,6,918,2064,4990,1585,569,12,1277,1985,5428,84,247
1105,960,23,1136,2065,5289,1566,587,23,1567,2049,5792,84,248
953,957,12,1003,2108,5033,1588,585,27,1416,1796,5412,84,249
657,961,33,995,2093,4739,1403,766,128,1223,1420,4940,84,250
182,757,26,1422,1094,3481,239,891,233,1122,1178,3663,84,251
154,318,8,992,697,2169,163,477,8,1051,852,2551,84,252
883,971,7,880,2072,4813,1502,544,14,1327,1792,5179,84,253
1091,1024,21,924,2238,5298,1628,672,18,1330,2119,5767,84,254
1177,1100,10,1228,2293,5808,1551,770,19,1592,2388,6320,84,255
1035,1114,17,1025,2202,5393,1539,754,24,1465,2068,5850,84,256
681,1087,33,1117,2372,5290,1410,1072,148,1267,1451,5348,84,257
217,859,25,1517,1127,3745,202,1045,174,1162,1194,3777,84,258
134,374,8,1212,695,2423,187,489,13,1105,1029,2823,84,259
901,939,8,870,2042,4760,1554,527,14,1340,1876,5311,84,260
1167,978,16,926,2378,5465,1676,683,33,1303,2075,5770,84,261
1195,1006,7,1076,2285,5569,1511,696,28,1720,2094,6049,84,262
1104,1027,10,1032,2385,5558,1600,900,22,1436,1923,5881,84,263
707,1062,31,1158,2255,5213,1486,831,157,1408,1548,5430,84,264
195,621,29,1630,1147,3622,281,839,110,1159,1293,3682,84,265
156,357,3,1013,652,2181,162,472,7,993,821,2455,84,266
939,884,22,881,2146,4872,1606,496,20,1352,1804,5278,84,267
1108,930,21,996,2379,5434,1724,712,32,1272,2127,5867,84,268
1165,954,8,1258,2213,5598,1571,732,14,1567,2171,6055,84,269
986,1022,6,1142,2303,5459,1474,749,19,1438,2038,5718,84,270
647,959,27,1236,2521,5390,1529,1059,103,1472,1458,5621,84,271
238,1062,32,1855,1343,4530,321,1273,106,1369,1514,4583,84,272
165,405,9,1276,765,2620,211,478,16,1101,1025,2831,84,273
849,928,10,859,2070,4716,1480,548,21,1343,1816,5208,84,274
1185,876,7,939,2165,5172,1590,615,15,1380,2065,5665,84,275
1150,941,4,1192,2255,5542,1545,682,45,1652,2110,6034,84,276
977,1056,5,1041,2206,5285,1502,703,34,1457,1861,5557,84,277
644,1178,32,1204,2214,5272,1442,920,100,1328,1741,5531,84,278
184,694,37,1396,1042,3353,218,794,106,1056,1161,3335,84,279
172,371,31,982,679,2235,172,462,43,970,909,2556,84,280
920,877,15,892,2110,4814,1617,527,18,1376,1812,5350,84,281
1190,958,7,1097,2418,5670,1734,651,11,1455,2170,6021,84,282
1199,1032,1,1292,2398,5922,1662,734,16,1669,2227,6308,84,283
866,1124,11,1323,2156,5480,1199,841,34,1443,1923,5440,84,284
679,668,21,1478,1582,4428,878,786,101,1262,1577,4604,84,285
234,603,20,1337,940,3134,187,811,101,1048,1111,3258,84,286
159,391,4,1005,654,2213,143,712,24,1062,1031,2972,84,287
320,700,13,899,1201,3133,683,468,25,1323,1094,3593,84,288
1152,942,12,1105,2340,5551,1648,691,17,1423,2159,5938,84,289
1214,964,13,1374,2257,5822,1582,766,25,1567,2296,6236,84,290
1027,1041,9,1085,2332,5494,1602,827,17,1389,1941,5776,84,291
671,1020,33,1234,2434,5392,1407,1020,119,1344,1613,5503,84,292
214,716,30,1438,1245,3643,275,1015,103,1232,1125,3750,84,293
118,376,9,1108,774,2385,172,551,22,1039,924,2708,84,294
858,911,10,967,2195,4941,1516,595,17,1357,1932,5417,84,295
1315,951,3,1143,2320,5732,1611,698,13,1575,2237,6134,84,296
1219,1008,2,1394,2300,5923,1602,815,41,1714,2227,6399,84,297
1094,1152,5,1089,2424,5764,1610,863,23,1542,2153,6191,84,298
775,944,29,1335,2254,5337,1348,863,119,1719,1590,5639,84,299
186,632,26,1426,1136,3406,282,933,96,1131,1101,3543,84,300
286,353,6,1060,799,2504,192,555,14,1144,928,2833,84,301
917,914,8,918,2092,4849,1502,532,14,1399,1911,5358,84,302
1203,913,15,1226,3427,6784,1638,2072,14,1484,2124,7332,84,303
1254,962,6,1340,2475,6037,1619,807,17,1713,2463,6619,84,304
959,1341,13,1318,2330,5961,1548,886,61,1535,2158,6188,84,305
669,931,35,1261,2166,5062,1282,743,103,1434,1616,5178,84,306
151,668,55,1358,1176,3408,272,919,129,1049,1199,3568,84,307
156,315,5,1071,701,2248,168,424,6,1092,857,2547,84,308
807,906,15,974,1797,4499,1161,569,28,1386,1839,4983,84,309
849,485,8,1252,1441,4035,815,635,50,1273,1715,4488,84,310
1040,751,48,1078,2136,5053,1551,605,57,1501,1879,5593,84,311
1019,895,26,976,2237,5153,1600,658,39,1309,1935,5541,84,312
734,849,27,1241,2187,5038,1439,792,120,1392,1500,5243,84,313
170,545,23,1551,1063,3352,259,756,74,1163,1307,3559,84,314
94,335,15,1186,714,2344,151,406,32,1093,1019,2701,84,315
363,713,29,944,1382,3431,799,414,37,1328,1225,3803,84,316
1151,903,17,1069,2408,5548,1640,610,23,1488,2249,6010,84,317
1247,896,15,1407,2410,5975,1683,778,14,1715,2267,6457,84,318
1102,898,11,1147,2286,5444,1617,649,17,1592,2048,5923,84,319
810,800,31,1207,2304,5152,1544,740,119,1539,1646,5588,84,320
189,546,24,1490,991,3240,224,683,79,1138,1303,3427,84,321
148,327,7,972,775,2229,143,527,13,951,944,2578,84,322
932,871,10,923,2076,4812,1575,524,10,1382,1904,5395,84,323
1167,938,12,1099,2423,5639,1660,676,12,1540,2259,6147,84,324
1217,903,5,1499,2269,5893,1601,686,12,1828,2207,6334,84,325
1131,885,11,1086,2519,5632,1524,853,20,1497,2047,5941,84,326
756,588,23,1316,2326,5009,1337,715,71,1241,1320,4684,84,327
216,453,20,1367,932,2988,199,681,45,1015,889,2829,84,328
144,333,4,852,661,1994,129,372,5,839,764,2109,84,329
785,532,10,956,1876,4159,1327,418,13,1303,1601,4662,84,330
825,560,10,1003,1889,4287,1175,564,20,1124,1406,4289,84,331
444,341,11,971,964,2731,598,383,24,943,952,2900,84,332
79,86,4,291,190,650,74,130,9,329,176,718,84,333
151,235,11,850,537,1784,249,396,21,717,704,2087,84,334
80,283,14,714,588,1679,157,514,26,800,825,2322,84,335
104,265,4,781,637,1791,193,639,19,1035,1086,2972,84,336
841,803,4,925,1925,4498,1416,477,8,1412,1749,5062,84,337
1195,819,9,1067,2284,5374,1489,768,20,1557,2031,5865,84,338
1308,882,4,1292,2095,5581,1429,717,21,1698,2146,6011,84,339
1085,784,26,1017,2277,5189,1426,806,29,1389,1907,5557,84,340
707,722,24,1034,2309,4796,1307,882,80,1329,1430,5028,84,341
147,543,33,1411,1427,3561,189,1126,72,1104,1189,3680,84,342
112,395,13,1032,903,2455,155,598,24,1033,979,2789,84,343
857,696,2,1042,2040,4637,1417,625,11,1268,1579,4900,84,344
1230,653,11,1311,2266,5471,1493,795,18,1500,1998,5804,84,345
1305,562,42,1201,2075,5185,1406,705,52,1358,1762,5283,84,346
1131,816,8,1296,2338,5589,1400,929,16,1344,2061,5750,84,347
798,584,20,1623,2438,5463,1381,833,64,1484,1627,5389,84,348
240,437,26,1390,1060,3153,217,688,54,1001,1011,2971,84,349
119,306,9,944,639,2017,199,377,12,825,655,2068,84,350
830,466,6,836,1692,3830,1307,442,8,1008,1542,4307,84,351
1033,395,18,939,1899,4284,1362,624,18,1122,1621,4747,84,352
1017,473,4,1030,1673,4197,1327,544,16,1021,1591,4499,84,353
871,457,7,920,1809,4064,1238,585,14,1042,1413,4292,84,354
496,387,28,960,1436,3307,1063,474,27,953,951,3468,84,355
81,246,9,659,509,1504,170,301,26,621,597,1715,84,356
79,191,5,634,420,1329,116,242,8,503,501,1370,84,357
298,259,5,782,759,2103,459,271,9,742,799,2280,84,358
166,160,3,544,391,1264,345,105,5,537,429,1421,84,359
41,62,2,151,125,381,48,78,2,198,101,427,84,360
152,215,3,526,581,1477,311,278,5,521,505,1620,84,361
186,240,10,604,618,1658,349,317,17,620,618,1921,84,362
55,227,10,514,419,1225,124,285,19,491,411,1330,84,363
83,183,3,537,378,1184,92,216,10,537,494,1349,84,364
269,289,2,737,835,2132,453,339,2,770,759,2323,84,365
254,381,84,698,579,1996,412,406,138,688,717,2361,84,366
98,112,2,263,169,644,51,201,9,185,234,680,85,1
825,133,1,504,403,1866,255,293,19,331,924,1822,85,2
965,140,3,453,499,2060,298,388,14,353,1005,2058,85,3
946,138,3,464,458,2009,281,382,13,319,992,1987,85,4
726,181,6,513,508,1934,221,421,38,390,788,1858,85,5
168,123,5,355,218,869,81,245,47,275,243,891,85,6
157,124,1,445,241,968,53,297,19,258,380,1007,85,7
941,135,5,472,430,1983,290,363,16,328,963,1960,85,8
1104,90,3,471,355,2023,318,303,15,407,922,1965,85,9
1194,150,12,552,524,2432,314,459,24,418,1147,2362,85,10
1077,147,11,549,559,2343,316,474,20,371,1087,2268,85,11
779,155,6,526,477,1943,249,364,48,407,836,1904,85,12
193,174,5,809,386,1567,77,405,65,394,643,1584,85,13
157,111,13,506,280,1067,54,289,36,315,418,1112,85,14
245,165,19,440,264,1133,150,279,23,306,420,1178,85,15
485,94,8,388,278,1253,187,269,7,292,446,1201,85,16
947,112,7,525,433,2024,293,412,26,333,919,1983,85,17
1107,155,9,521,558,2350,320,497,32,383,1103,2335,85,18
477,169,11,371,325,1353,184,298,58,272,502,1314,85,19
177,121,3,461,324,1086,90,351,43,281,356,1121,85,20
128,98,2,441,245,914,47,242,16,265,339,909,85,21
970,135,12,501,437,2055,267,401,20,365,1000,2053,85,22
1234,144,12,555,515,2460,378,442,13,379,1217,2429,85,23
1185,144,4,576,555,2464,354,509,23,380,1204,2470,85,24
1146,140,5,566,524,2381,301,504,24,367,1130,2326,85,25
836,214,5,598,541,2194,261,469,48,389,968,2135,85,26
233,170,12,765,436,1616,93,439,80,466,598,1676,85,27
188,114,15,587,282,1186,67,289,28,333,445,1162,85,28
964,147,5,487,427,2030,276,400,25,343,1001,2045,85,29
1246,150,9,530,554,2489,353,466,19,392,1247,2477,85,30
1178,142,13,558,605,2496,328,506,36,393,1176,2439,85,31
1131,191,13,553,528,2416,300,489,33,394,1197,2413,85,32
841,205,5,540,544,2135,284,419,65,384,863,2015,85,33
175,178,3,490,357,1203,83,266,53,355,408,1165,85,34
137,114,20,377,227,875,47,213,26,292,277,855,85,35
974,147,17,521,480,2139,281,368,41,385,1024,2099,85,36
1225,154,25,567,582,2553,378,483,42,428,1243,2574,85,37
1194,179,23,588,580,2564,355,495,39,421,1222,2532,85,38
1123,180,2,567,565,2437,340,504,21,381,1131,2377,85,39
821,242,5,625,531,2224,287,423,70,417,925,2122,85,40
195,225,6,664,494,1584,85,513,74,406,514,1592,85,41
151,147,4,567,279,1148,45,233,23,314,545,1160,85,42
940,132,10,533,433,2048,290,344,25,377,959,1995,85,43
1063,132,5,493,540,2233,318,489,28,313,1129,2277,85,44
1221,186,7,622,600,2636,371,517,36,425,1277,2626,85,45
1139,169,2,540,522,2372,307,469,26,393,1161,2356,85,46
816,230,6,542,483,2077,256,425,52,446,907,2086,85,47
182,147,4,526,337,1196,76,313,63,353,373,1178,85,48
170,155,16,504,301,1146,57,320,28,362,399,1166,85,49
369,135,13,488,369,1374,150,273,33,385,538,1379,85,50
1179,169,12,569,587,2516,388,509,27,413,1199,2536,85,51
1174,184,10,635,548,2551,383,531,30,420,1217,2581,85,52
1122,162,2,585,563,2434,374,490,20,396,1201,2481,85,53
816,201,9,555,521,2102,282,400,66,381,952,2081,85,54
197,133,13,486,292,1121,80,274,40,295,306,995,85,55
138,110,4,358,245,855,52,222,7,269,266,816,85,56
1042,168,2,512,489,2213,329,467,20,431,1028,2275,85,57
1276,133,3,594,601,2607,394,493,28,413,1271,2599,85,58
1220,155,3,536,521,2435,362,468,19,409,1169,2427,85,59
1188,193,3,557,537,2478,378,511,30,425,1192,2536,85,60
855,220,4,581,588,2248,277,523,69,424,876,2169,85,61
189,176,2,516,356,1239,72,328,84,331,362,1177,85,62
168,140,3,575,333,1219,68,322,14,332,511,1247,85,63
1037,162,7,465,461,2132,335,448,32,369,987,2171,85,64
1264,142,5,562,550,2523,373,481,23,417,1204,2498,85,65
1223,132,6,543,603,2507,369,496,33,401,1254,2553,85,66
1190,218,6,668,651,2733,376,564,37,487,1200,2664,85,67
882,225,6,638,673,2424,368,501,53,459,1027,2408,85,68
203,131,5,421,234,994,64,243,31,256,278,872,85,69
109,105,5,372,212,803,43,183,14,218,266,724,85,70
972,182,5,531,452,2142,318,435,25,379,1037,2194,85,71
1241,184,2,636,649,2712,444,557,28,422,1274,2725,85,72
1306,236,4,725,659,2930,382,628,27,424,1325,2786,85,73
1198,274,5,733,649,2859,365,639,40,461,1178,2683,85,74
869,205,2,629,579,2284,276,428,52,443,927,2126,85,75
180,150,9,619,329,1287,78,335,62,316,375,1166,85,76
120,103,3,452,214,892,50,231,14,283,308,886,85,77
1059,153,2,537,483,2234,317,461,19,379,1069,2245,85,78
1270,198,19,621,622,2730,393,574,27,413,1302,2709,85,79
1283,161,16,730,649,2839,382,647,21,453,1280,2783,85,80
1210,188,5,641,589,2633,344,627,26,453,1202,2652,85,81
913,227,21,729,599,2489,290,554,73,430,986,2333,85,82
157,209,7,551,380,1304,70,392,64,282,479,1287,85,83
202,161,8,881,346,1598,67,405,18,381,690,1561,85,84
1015,179,15,675,513,2397,299,474,44,381,1144,2342,85,85
1212,165,4,764,615,2760,374,559,23,399,1359,2714,85,86
1113,166,6,601,507,2393,357,486,14,416,1089,2362,85,87
1038,178,8,622,583,2429,298,469,25,394,1109,2295,85,88
787,236,9,760,599,2391,247,536,85,429,1009,2306,85,89
420,188,7,1134,412,2161,94,543,58,473,881,2049,85,90
197,125,6,656,305,1289,51,365,9,326,498,1249,85,91
879,171,5,631,457,2143,267,492,17,359,1064,2199,85,92
1247,159,6,562,512,2486,345,508,23,374,1239,2489,85,93
1232,180,3,560,519,2494,322,594,19,364,1219,2518,85,94
1193,196,12,696,608,2705,362,644,31,423,1205,2665,85,95
939,233,6,592,616,2386,280,573,70,407,990,2320,85,96
309,223,6,754,385,1677,109,476,86,453,546,1670,85,97
256,139,4,707,343,1449,66,432,15,432,542,1487,85,98
1069,150,2,559,424,2204,298,441,16,399,1020,2174,85,99
1233,231,2,588,588,2642,347,566,70,430,1287,2700,85,100
1216,187,3,725,603,2734,398,552,26,460,1288,2724,85,101
1164,205,12,613,579,2573,375,621,33,380,1165,2574,85,102
927,207,12,592,631,2369,309,505,78,401,925,2218,85,103
316,179,7,801,442,1745,91,514,58,402,644,1709,85,104
196,145,4,710,310,1365,82,342,26,398,544,1392,85,105
1047,172,1,567,510,2297,300,515,24,397,1051,2287,85,106
1351,189,4,627,600,2771,391,586,31,418,1254,2680,85,107
1346,190,7,637,660,2840,381,555,42,437,1285,2700,85,108
1195,208,2,654,634,2693,367,591,47,422,1215,2642,85,109
887,210,16,628,616,2357,271,562,69,453,915,2270,85,110
231,211,12,934,433,1821,90,611,67,371,618,1757,85,111
173,150,9,566,292,1190,76,269,24,351,443,1163,85,112
940,160,8,566,424,2098,284,418,31,348,1018,2099,85,113
1237,179,5,611,607,2639,377,540,27,447,1260,2651,85,114
1253,168,35,605,629,2690,356,592,38,407,1198,2591,85,115
1304,196,19,744,560,2823,340,623,36,468,1262,2729,85,116
857,244,17,632,647,2397,281,550,91,441,919,2282,85,117
215,180,13,623,395,1426,102,468,80,432,418,1500,85,118
178,157,1,638,314,1288,57,376,32,366,468,1299,85,119
1057,160,10,556,451,2234,311,463,26,407,1049,2256,85,120
1297,184,27,570,602,2680,415,495,47,442,1264,2663,85,121
1307,197,9,629,584,2726,399,588,35,404,1272,2698,85,122
1229,205,9,643,529,2615,335,569,40,409,1186,2539,85,123
938,238,12,610,542,2340,281,533,74,465,929,2282,85,124
218,157,2,596,345,1318,95,337,51,304,483,1270,85,125
154,138,2,480,267,1041,64,309,9,282,364,1028,85,126
1035,168,2,525,469,2199,321,453,29,345,1027,2175,85,127
1271,181,1,664,609,2726,420,577,26,452,1263,2738,85,128
1306,178,3,636,621,2744,400,595,42,409,1246,2692,85,129
1219,210,8,629,564,2630,377,568,33,453,1131,2562,85,130
856,215,5,601,513,2190,266,458,58,395,848,2025,85,131
265,166,7,707,327,1472,92,366,66,394,577,1495,85,132
187,130,2,486,245,1050,67,284,18,383,391,1143,85,133
1070,190,11,607,497,2375,327,496,32,373,1112,2340,85,134
1255,139,5,653,518,2570,395,499,35,440,1224,2593,85,135
1288,178,5,613,607,2691,363,580,40,416,1254,2653,85,136
1262,239,13,685,606,2805,397,590,70,445,1213,2715,85,137
934,276,17,671,554,2452,301,532,78,504,985,2400,85,138
258,234,17,632,390,1531,106,480,126,388,511,1611,85,139
253,180,1,750,310,1494,71,442,19,402,585,1519,85,140
1072,185,3,621,567,2448,317,540,20,385,1174,2436,85,141
1309,187,1,618,614,2729,400,571,20,410,1292,2693,85,142
1253,209,1,698,580,2741,381,551,25,416,1302,2675,85,143
1161,203,5,573,564,2506,342,529,35,444,1152,2502,85,144
767,244,11,663,553,2238,267,492,76,487,859,2181,85,145
196,228,7,725,432,1588,89,509,68,381,509,1556,85,146
187,167,3,631,322,1310,62,344,45,368,498,1317,85,147
189,131,5,458,246,1029,73,257,24,278,423,1055,85,148
1222,180,1,591,535,2529,383,514,35,427,1216,2575,85,149
1307,176,18,615,500,2616,378,541,36,395,1273,2623,85,150
1218,214,4,666,553,2655,373,599,27,414,1176,2589,85,151
917,246,16,687,562,2428,311,507,63,472,971,2324,85,152
281,260,9,827,472,1849,108,550,93,447,585,1783,85,153
209,175,13,677,316,1390,80,399,25,399,516,1419,85,154
1335,174,5,616,540,2670,350,591,24,430,1345,2740,85,155
1672,202,2,692,660,3228,418,707,21,508,1598,3252,85,156
1647,191,7,766,672,3283,439,723,33,440,1583,3218,85,157
1499,229,9,706,716,3159,404,795,43,468,1521,3231,85,158
1141,282,16,761,707,2907,338,694,121,492,1258,2903,85,159
354,274,13,1283,640,2564,128,985,124,500,743,2480,85,160
254,160,9,831,396,1650,67,508,24,418,652,1669,85,161
1318,174,3,710,596,2801,358,557,20,470,1413,2818,85,162
1642,205,9,745,684,3285,446,717,35,468,1635,3301,85,163
1626,267,13,779,724,3409,456,769,110,461,1627,3423,85,164
1500,197,4,763,646,3110,385,686,34,496,1473,3074,85,165
1152,250,24,740,720,2886,311,834,285,526,1147,3103,85,166
306,253,9,844,499,1911,126,669,87,439,603,1924,85,167
225,163,4,713,295,1400,71,376,18,405,518,1388,85,168
1243,181,7,687,516,2634,315,541,28,401,1360,2645,85,169
1536,180,1,735,655,3107,410,649,33,507,1509,3108,85,170
582,177,2,753,489,2003,251,535,19,476,752,2033,85,171
1425,259,3,778,631,3096,382,651,33,460,1454,2980,85,172
1005,257,13,684,580,2539,329,605,98,452,1061,2545,85,173
314,265,16,673,492,1760,92,580,117,449,529,1767,85,174
234,146,3,577,328,1288,77,384,38,383,454,1336,85,175
1290,191,4,607,565,2657,381,542,31,382,1366,2702,85,176
1665,187,1,708,638,3199,425,654,22,488,1663,3252,85,177
1690,199,1,714,623,3227,423,691,21,475,1559,3169,85,178
1553,236,8,790,610,3197,383,721,42,448,1521,3115,85,179
1073,270,10,772,622,2747,309,603,92,482,1175,2661,85,180
320,255,8,842,462,1887,121,575,77,469,654,1896,85,181
247,162,10,622,324,1365,81,382,32,345,471,1311,85,182
1211,205,14,765,693,2888,382,661,33,439,1418,2933,85,183
1439,237,4,777,684,3141,441,658,24,475,1512,3110,85,184
1302,230,6,837,682,3057,367,768,45,539,1317,3036,85,185
300,799,11,831,1111,3052,104,1898,150,393,665,3210,85,186
695,255,11,670,542,2173,234,555,77,486,832,2184,85,187
296,239,16,684,379,1614,113,510,63,344,558,1588,85,188
210,167,2,555,303,1237,86,362,13,379,482,1322,85,189
1183,168,7,647,474,2479,324,514,33,429,1279,2579,85,190
1416,168,17,621,622,2844,399,627,46,460,1435,2967,85,191
1410,163,3,731,600,2907,443,661,33,471,1399,3007,85,192
1355,224,3,720,636,2938,395,663,37,465,1457,3017,85,193
958,218,11,662,622,2471,307,583,78,407,1046,2421,85,194
284,277,29,746,475,1811,111,611,93,436,542,1793,85,195
245,183,5,597,283,1313,101,384,24,416,416,1341,85,196
1177,172,3,572,499,2423,327,536,21,397,1248,2529,85,197
1465,191,9,656,550,2871,403,616,44,416,1416,2895,85,198
1525,203,25,774,559,3086,429,582,45,482,1492,3030,85,199
1478,283,8,787,589,3145,407,697,39,479,1481,3103,85,200
1020,204,9,651,692,2576,315,597,130,463,1037,2542,85,201
290,210,5,763,521,1789,86,621,88,444,540,1779,85,202
245,147,16,692,326,1426,70,419,50,437,503,1479,85,203
1190,148,2,593,527,2460,320,569,24,400,1273,2586,85,204
1514,170,2,655,586,2927,387,663,13,456,1493,3012,85,205
1462,144,2,743,648,2999,400,682,36,443,1453,3014,85,206
1436,182,9,676,541,2844,381,617,35,458,1419,2910,85,207
1029,233,10,679,537,2488,294,546,87,444,1075,2446,85,208
311,216,10,756,500,1793,95,550,99,397,611,1752,85,209
259,118,1,584,310,1272,75,373,25,367,473,1313,85,210
1202,140,2,635,550,2529,351,525,83,418,1231,2608,85,211
1447,135,5,680,600,2867,377,562,24,449,1531,2943,85,212
1455,173,8,648,613,2897,412,596,34,414,1418,2874,85,213
1296,186,2,692,557,2733,331,562,42,474,1322,2731,85,214
1045,192,22,712,648,2619,318,696,124,435,1040,2613,85,215
344,148,8,843,403,1746,104,588,84,424,581,1781,85,216
270,144,2,714,249,1379,69,387,16,332,516,1320,85,217
1090,149,11,553,479,2282,303,467,27,368,1174,2339,85,218
1401,156,12,657,599,2825,395,585,34,416,1425,2855,85,219
1384,170,7,599,597,2757,378,564,37,417,1397,2793,85,220
1274,127,4,611,565,2581,345,539,40,402,1211,2537,85,221
806,205,7,531,497,2046,230,511,98,351,870,2060,85,222
291,194,7,690,452,1634,86,536,59,389,616,1686,85,223
239,151,3,630,292,1315,67,362,13,349,515,1306,85,224
1085,172,2,642,487,2388,309,491,21,409,1250,2480,85,225
1402,166,3,630,610,2811,394,644,17,461,1432,2948,85,226
1400,201,4,702,638,2945,359,622,26,455,1477,2939,85,227
1324,170,10,647,616,2767,350,581,57,386,1393,2767,85,228
971,223,9,702,512,2417,296,534,91,433,1033,2387,85,229
274,234,6,634,387,1535,96,480,76,414,513,1579,85,230
210,123,2,600,340,1275,63,349,19,382,439,1252,85,231
1085,143,4,589,461,2282,313,466,21,397,1176,2373,85,232
1395,165,3,625,557,2745,369,602,19,383,1400,2773,85,233
1403,201,2,712,650,2968,381,627,53,450,1459,2970,85,234
1269,168,9,745,591,2782,341,637,25,428,1333,2764,85,235
907,262,10,707,601,2487,268,615,92,497,998,2470,85,236
304,213,6,831,441,1795,100,577,66,406,673,1822,85,237
240,130,8,674,318,1370,82,411,20,357,560,1430,85,238
1140,144,2,592,507,2385,307,523,21,387,1219,2457,85,239
1455,167,7,689,643,2961,366,668,30,388,1488,2940,85,240
1427,139,6,619,636,2827,365,650,29,357,1426,2827,85,241
1374,142,2,651,578,2747,345,553,40,435,1408,2781,85,242
906,207,10,687,618,2428,283,572,88,552,945,2440,85,243
306,176,9,792,446,1729,92,554,76,442,588,1752,85,244
244,114,2,734,325,1419,66,354,31,392,511,1354,85,245
191,109,2,517,299,1118,83,303,10,352,427,1175,85,246
1271,158,3,573,520,2525,384,541,14,384,1305,2628,85,247
1303,157,1,609,610,2680,395,534,22,363,1332,2646,85,248
1237,207,3,670,524,2641,370,558,24,374,1264,2590,85,249
879,215,6,578,522,2200,288,423,65,410,971,2157,85,250
239,211,17,650,432,1549,96,438,100,427,498,1559,85,251
189,140,6,622,342,1299,79,367,19,409,473,1347,85,252
1080,159,2,585,502,2328,318,470,16,367,1166,2337,85,253
1345,177,6,612,564,2704,394,529,24,421,1370,2738,85,254
1340,193,2,601,647,2783,376,634,26,458,1314,2808,85,255
1271,189,2,640,614,2716,361,614,25,414,1283,2697,85,256
929,219,16,698,640,2502,294,606,78,423,1040,2441,85,257
246,153,8,604,349,1360,102,381,60,316,384,1243,85,258
140,101,2,467,199,909,68,232,19,265,323,907,85,259
1072,167,4,541,503,2287,358,500,29,390,1070,2347,85,260
1279,153,2,636,617,2687,438,525,21,474,1318,2776,85,261
1284,176,3,629,616,2708,355,557,23,443,1275,2653,85,262
1267,198,3,676,690,2834,419,656,26,470,1278,2849,85,263
883,249,17,563,649,2361,325,492,106,416,936,2275,85,264
268,209,5,771,474,1727,111,456,97,475,545,1684,85,265
188,117,6,505,272,1088,81,306,19,311,389,1106,85,266
1098,145,5,572,489,2309,325,456,24,387,1155,2347,85,267
1286,163,2,582,637,2670,384,583,21,410,1372,2770,85,268
1227,161,1,624,727,2740,407,610,17,363,1325,2722,85,269
1333,207,8,650,615,2813,442,630,52,408,1255,2787,85,270
908,237,13,570,621,2349,314,538,118,436,943,2349,85,271
234,225,11,903,544,1917,120,639,84,501,630,1974,85,272
183,132,3,602,321,1241,72,321,9,361,490,1253,85,273
1061,156,3,494,478,2192,314,430,26,356,1055,2181,85,274
1288,159,10,514,543,2514,358,515,34,390,1223,2520,85,275
1258,172,1,587,545,2563,381,492,21,411,1285,2590,85,276
1156,176,8,614,537,2491,344,533,27,420,1181,2505,85,277
874,235,10,588,521,2228,294,490,102,442,936,2264,85,278
227,220,18,748,406,1619,105,461,82,427,552,1627,85,279
189,145,7,586,266,1193,74,293,20,345,467,1199,85,280
1057,167,2,549,502,2277,319,432,17,363,1164,2295,85,281
1326,138,12,628,593,2697,394,512,30,413,1345,2694,85,282
1328,197,5,611,602,2743,381,534,36,413,1354,2718,85,283
1244,212,2,587,657,2702,359,597,31,419,1244,2650,85,284
840,215,25,608,604,2292,293,485,91,449,940,2258,85,285
25,0,0,0,0,25,15,0,0,1,0,16,85,286
1234,169,7,609,601,2620,359,560,32,437,1286,2674,85,289
1241,188,12,582,619,2642,392,546,42,408,1311,2699,85,290
1179,190,0,625,637,2631,363,590,32,439,1202,2626,85,291
847,218,8,687,529,2289,260,512,63,452,898,2185,85,292
240,238,11,699,458,1646,98,451,105,463,561,1678,85,293
165,137,4,587,355,1248,68,379,18,342,471,1278,85,294
1054,159,3,577,474,2267,333,484,25,362,1164,2368,85,295
1273,172,2,617,604,2668,402,557,10,413,1354,2736,85,296
1324,156,1,697,680,2858,387,618,15,409,1364,2793,85,297
1284,193,7,658,637,2779,384,602,34,399,1222,2641,85,298
898,284,14,704,650,2550,317,535,111,443,996,2402,85,299
268,284,19,681,497,1749,108,467,94,460,616,1745,85,300
257,134,3,617,370,1381,85,310,36,436,549,1416,85,301
1028,132,2,532,501,2195,301,452,18,327,1169,2267,85,302
1268,176,2,674,719,2839,392,671,31,479,1297,2870,85,303
1370,175,5,692,652,2894,407,578,25,431,1373,2814,85,304
1132,217,4,640,607,2600,347,479,41,394,1221,2482,85,305
839,219,16,648,616,2338,288,467,75,452,933,2215,85,306
248,239,7,709,476,1679,100,461,110,443,568,1682,85,307
186,138,5,538,289,1156,80,273,15,377,400,1145,85,308
1053,139,3,532,520,2247,336,423,16,366,1167,2308,85,309
1036,132,2,537,503,2210,334,404,28,420,1109,2295,85,310
1148,175,2,575,612,2512,404,528,25,353,1229,2539,85,311
1254,202,2,602,592,2652,396,489,28,430,1339,2682,85,312
877,209,9,569,705,2369,277,459,80,535,1032,2383,85,313
214,170,5,513,320,1222,96,271,32,394,390,1183,85,314
139,97,4,413,222,875,62,200,11,276,321,870,85,315
498,113,11,424,326,1372,175,255,22,303,479,1234,85,316
1307,147,1,521,575,2551,413,472,15,394,1335,2629,85,317
1361,159,1,579,659,2759,389,541,23,423,1400,2776,85,318
1185,160,13,570,573,2501,334,487,44,393,1264,2522,85,319
845,214,18,573,616,2266,263,478,72,481,977,2271,85,320
228,257,11,644,435,1575,101,415,95,469,656,1736,85,321
216,139,6,603,353,1317,81,320,18,431,537,1387,85,322
1065,154,7,557,528,2311,337,469,20,403,1197,2426,85,323
1310,154,6,611,634,2715,405,530,21,464,1326,2746,85,324
1336,152,4,652,636,2780,406,550,24,360,1354,2694,85,325
1211,177,9,644,653,2694,389,551,29,441,1298,2708,85,326
856,173,8,523,483,2043,267,394,42,422,866,1991,85,327
226,204,12,706,456,1604,108,432,77,480,536,1633,85,328
172,90,1,569,334,1166,83,294,9,338,478,1202,85,329
969,144,5,571,500,2189,277,428,23,404,1057,2189,85,330
1002,134,7,576,557,2276,314,476,11,396,1107,2304,85,331
759,169,8,714,481,2131,249,387,22,632,849,2139,85,332
95,114,2,268,158,637,49,143,8,240,226,666,85,333
329,134,7,680,351,1501,125,350,40,397,587,1499,85,334
168,150,11,599,335,1263,91,347,47,327,516,1328,85,335
159,101,2,466,297,1025,73,265,13,320,424,1095,85,336
984,126,4,520,457,2091,288,384,17,346,1040,2075,85,337
1212,129,1,572,594,2508,371,553,20,412,1237,2593,85,338
1268,149,9,588,572,2586,363,567,32,419,1225,2606,85,339
1153,152,7,557,613,2482,344,554,34,359,1210,2501,85,340
826,201,3,607,558,2195,266,452,70,377,946,2111,85,341
218,185,4,633,510,1550,95,458,88,415,502,1558,85,342
147,131,5,622,427,1332,78,388,21,372,500,1359,85,343
1039,124,2,507,476,2148,294,435,16,333,1133,2211,85,344
1361,166,3,601,593,2724,386,526,21,368,1389,2690,85,345
1340,142,4,598,531,2615,401,561,23,391,1257,2633,85,346
1263,175,1,718,631,2788,361,616,33,429,1332,2771,85,347
934,227,3,646,622,2432,277,519,111,423,992,2322,85,348
240,214,7,749,602,1812,92,510,93,468,629,1792,85,349
184,103,1,513,301,1102,69,282,12,343,418,1124,85,350
971,143,1,473,467,2055,285,412,16,346,1049,2108,85,351
1247,172,1,618,680,2718,372,523,59,431,1364,2749,85,352
1218,172,1,611,581,2583,347,487,40,407,1246,2527,85,353
1051,170,1,648,653,2523,341,584,19,432,1114,2490,85,354
763,196,8,615,531,2113,236,471,72,420,848,2047,85,355
202,182,6,605,408,1403,93,368,49,371,477,1358,85,356
167,98,1,528,312,1106,75,343,11,318,368,1115,85,357
605,121,6,628,467,1827,200,381,16,374,806,1777,85,358
347,86,1,411,261,1106,130,215,11,356,379,1091,85,359
56,46,11,200,108,421,35,91,13,136,155,430,85,360
419,125,3,544,353,1444,163,382,7,310,553,1415,85,361
414,159,3,571,433,1580,180,390,49,371,650,1640,85,362
157,184,9,424,313,1087,70,310,50,270,377,1077,85,363
138,93,1,500,272,1004,56,241,5,299,434,1035,85,364
547,127,2,638,500,1814,206,441,12,384,750,1793,85,365
508,240,43,549,387,1727,193,304,140,441,592,1670,85,366
57,249,3,245,432,986,70,69,7,464,329,939,86,1
218,344,3,351,868,1784,462,117,6,593,621,1799,86,2
238,338,6,325,918,1825,594,175,7,534,612,1922,86,3
249,426,4,375,905,1959,582,178,5,604,662,2031,86,4
161,457,8,353,645,1624,299,190,24,538,689,1740,86,5
52,408,10,300,557,1327,107,152,6,682,373,1320,86,6
46,318,5,389,510,1268,60,142,6,637,398,1243,86,7
241,305,3,307,692,1548,439,136,3,464,518,1560,86,8
280,291,1,270,686,1528,584,95,4,463,450,1596,86,9
362,398,2,417,892,2071,698,167,2,592,607,2066,86,10
306,469,4,361,1052,2192,625,234,13,611,670,2153,86,11
182,387,9,288,523,1389,267,134,12,454,505,1372,86,12
60,484,10,489,616,1659,92,238,12,680,617,1639,86,13
34,271,4,262,477,1048,55,89,10,577,321,1052,86,14
110,278,11,285,471,1155,179,119,9,533,338,1178,86,15
126,272,9,221,524,1152,293,126,9,414,388,1230,86,16
275,315,43,281,797,1711,578,144,52,456,529,1759,86,17
304,400,13,327,911,1955,618,195,23,485,582,1903,86,18
130,277,8,234,481,1130,183,131,13,401,486,1214,86,19
61,471,18,407,764,1721,112,155,36,850,640,1793,86,20
39,288,1,296,619,1243,61,84,3,681,436,1265,86,21
244,303,5,276,647,1475,431,141,6,385,555,1518,86,22
317,374,4,311,871,1877,642,152,8,450,593,1845,86,23
323,394,15,351,916,1999,646,194,25,483,627,1975,86,24
304,415,19,344,903,1985,626,183,25,546,603,1983,86,25
223,492,8,440,762,1925,352,275,29,634,739,2029,86,26
73,558,17,502,869,2019,115,233,27,851,799,2025,86,27
38,305,5,361,515,1224,56,99,9,650,379,1193,86,28
273,263,4,312,635,1487,447,144,7,448,514,1560,86,29
331,353,3,306,875,1868,682,162,8,447,611,1910,86,30
342,331,1,300,906,1880,657,203,5,492,587,1944,86,31
313,479,4,325,914,2035,731,209,12,491,645,2088,86,32
198,494,9,313,630,1644,340,203,19,523,684,1769,86,33
52,648,12,526,835,2073,139,183,9,997,799,2127,86,34
37,303,7,385,633,1365,53,138,9,699,443,1342,86,35
240,265,8,298,613,1424,407,119,7,439,520,1492,86,36
325,344,6,272,959,1906,714,165,6,456,586,1927,86,37
343,332,1,334,963,1973,689,204,4,489,616,2002,86,38
334,329,8,333,876,1880,646,171,11,498,631,1957,86,39
193,481,12,386,703,1775,289,204,16,577,722,1808,86,40
58,590,27,500,793,1968,118,276,47,788,723,1952,86,41
49,268,3,313,537,1170,45,101,9,589,416,1160,86,42
232,296,1,303,600,1432,396,132,6,395,511,1440,86,43
287,357,3,285,838,1770,558,217,4,417,568,1764,86,44
352,344,3,299,882,1880,494,194,9,540,617,1854,86,45
294,356,3,339,863,1855,600,199,8,467,576,1850,86,46
193,502,25,358,722,1800,339,226,29,605,651,1850,86,47
58,577,14,484,728,1861,102,176,12,883,695,1868,86,48
46,412,4,432,693,1587,61,146,12,786,611,1616,86,49
108,342,11,396,771,1628,254,135,14,696,528,1627,86,50
352,328,4,269,926,1879,661,164,4,432,588,1849,86,51
374,358,5,353,985,2075,682,189,12,551,690,2124,86,52
300,360,2,323,971,1956,697,171,3,501,595,1967,86,53
217,399,21,319,615,1571,312,163,14,472,672,1633,86,54
65,548,17,486,800,1916,119,219,29,967,706,2040,86,55
43,325,2,334,625,1329,61,132,6,729,415,1343,86,56
237,306,4,323,678,1548,469,135,12,483,527,1626,86,57
321,347,1,333,905,1907,677,174,5,465,592,1913,86,58
304,344,2,332,883,1865,681,137,8,483,607,1916,86,59
309,393,4,375,937,2018,666,189,11,574,652,2092,86,60
186,493,10,370,791,1850,312,225,19,609,729,1894,86,61
54,598,15,443,821,1931,94,190,18,1034,659,1995,86,62
40,372,3,399,659,1473,69,144,5,781,503,1502,86,63
226,340,3,338,648,1555,421,187,6,460,508,1582,86,64
295,410,2,392,1078,2177,540,174,2,732,740,2188,86,65
327,387,2,342,980,2038,670,206,8,582,668,2134,86,66
284,473,2,377,1021,2157,705,222,19,547,686,2179,86,67
255,532,12,417,736,1952,380,265,20,611,757,2033,86,68
62,614,11,439,810,1936,119,178,28,932,732,1989,86,69
53,349,4,395,615,1416,55,148,10,769,531,1513,86,70
235,378,5,287,710,1615,428,184,4,468,574,1658,86,71
340,396,4,391,974,2105,683,238,10,530,722,2183,86,72
358,463,3,425,1073,2322,678,276,18,607,730,2309,86,73
327,480,6,465,988,2266,622,285,16,612,770,2305,86,74
210,531,13,434,773,1961,349,254,23,685,742,2053,86,75
140,642,19,706,821,2328,101,354,41,986,914,2396,86,76
84,375,7,516,737,1719,66,197,6,778,588,1635,86,77
278,333,2,350,635,1598,429,221,5,482,586,1723,86,78
387,438,2,345,958,2130,662,246,6,502,766,2182,86,79
409,401,3,447,1018,2278,669,301,13,597,730,2310,86,80
327,457,2,477,1011,2274,645,260,6,634,750,2295,86,81
204,535,9,585,795,2128,315,426,19,637,833,2230,86,82
76,721,25,537,1022,2381,103,342,28,1008,896,2377,86,83
108,401,5,769,708,1991,66,261,10,880,792,2009,86,84
238,406,7,673,857,2181,446,314,17,577,847,2201,86,85
314,403,9,521,992,2239,631,240,8,572,723,2174,86,86
319,463,4,324,975,2085,628,231,10,596,638,2103,86,87
251,510,5,466,998,2230,600,210,11,681,788,2290,86,88
219,698,9,661,876,2463,303,416,18,765,1072,2574,86,89
87,652,12,1023,1010,2784,107,473,29,1066,1173,2848,86,90
95,163,4,476,327,1065,57,146,5,427,392,1027,86,91
233,362,4,437,709,1745,378,265,9,521,621,1794,86,92
349,460,3,461,1002,2275,650,263,5,617,775,2310,86,93
317,450,4,416,944,2131,600,275,7,652,664,2198,86,94
359,478,5,509,1002,2353,674,312,10,577,862,2435,86,95
252,563,13,573,875,2276,341,287,24,733,975,2360,86,96
96,737,11,648,945,2437,92,299,30,1061,1016,2498,86,97
93,383,5,474,671,1626,87,185,8,852,519,1651,86,98
265,347,3,375,636,1626,444,186,11,473,591,1705,86,99
335,440,15,376,940,2106,676,256,30,519,698,2179,86,100
375,445,8,436,1119,2383,675,293,14,648,857,2487,86,101
358,531,5,376,1041,2311,705,205,9,577,862,2358,86,102
255,564,18,473,810,2120,340,327,20,689,809,2185,86,103
118,732,14,740,975,2579,97,319,41,1191,904,2552,86,104
78,415,4,550,666,1713,62,144,5,881,614,1706,86,105
294,351,8,448,815,1916,460,244,10,575,608,1897,86,106
391,470,4,443,1003,2311,671,288,6,647,771,2383,86,107
449,438,4,451,1027,2369,599,268,11,598,766,2242,86,108
373,544,3,418,986,2324,709,262,12,585,751,2319,86,109
293,483,17,409,890,2092,382,375,15,641,731,2144,86,110
105,675,13,723,869,2385,111,424,38,895,977,2445,86,111
66,338,6,427,666,1503,65,137,7,778,465,1452,86,112
284,343,6,314,699,1646,425,188,6,500,557,1676,86,113
346,390,4,338,1052,2130,725,213,10,515,684,2147,86,114
364,461,2,422,1047,2296,692,325,5,564,685,2271,86,115
380,477,6,453,993,2309,647,326,12,565,756,2306,86,116
222,545,12,510,756,2045,335,343,27,649,734,2088,86,117
122,599,13,517,812,2063,121,240,33,1009,717,2120,86,118
118,383,21,485,712,1719,77,150,28,844,556,1655,86,119
261,374,4,370,736,1745,439,221,10,554,584,1808,86,120
367,455,7,361,989,2179,741,224,12,522,675,2174,86,121
419,491,15,385,1033,2343,696,254,16,598,801,2365,86,122
336,438,7,393,1057,2231,738,209,9,620,727,2303,86,123
237,587,13,461,780,2078,322,323,18,682,764,2109,86,124
98,635,12,584,818,2147,104,270,23,1069,699,2165,86,125
63,418,8,427,702,1618,77,169,5,825,486,1562,86,126
302,389,3,349,703,1746,467,179,13,555,569,1783,86,127
360,499,3,411,1036,2309,730,292,6,671,768,2467,86,128
374,471,7,398,1070,2320,713,272,16,578,752,2331,86,129
391,513,8,448,1095,2455,709,234,12,657,821,2433,86,130
248,515,11,394,786,1954,343,211,23,676,782,2035,86,131
154,630,22,587,822,2215,134,257,24,936,887,2238,86,132
60,412,6,432,692,1602,78,154,9,825,535,1601,86,133
282,371,4,373,746,1776,449,205,10,559,666,1889,86,134
385,508,2,376,1020,2291,692,226,9,645,803,2375,86,135
381,516,3,382,1090,2372,760,285,15,551,795,2406,86,136
379,540,12,454,1150,2535,737,307,20,682,883,2629,86,137
246,499,11,505,809,2070,384,283,26,737,770,2200,86,138
93,748,20,570,865,2296,81,263,25,996,897,2262,86,139
105,446,5,523,719,1798,90,193,9,817,585,1694,86,140
291,409,3,413,827,1943,475,232,6,596,696,2005,86,141
354,490,10,418,1192,2464,761,283,16,679,779,2518,86,142
357,417,5,449,1084,2312,729,237,16,656,717,2355,86,143
355,411,16,434,1036,2252,715,228,20,613,686,2262,86,144
206,588,16,466,764,2040,286,330,24,696,761,2097,86,145
119,649,10,658,923,2359,112,293,31,1163,800,2399,86,146
62,464,3,560,763,1852,71,213,22,836,711,1853,86,147
76,395,6,424,763,1664,99,175,8,871,525,1678,86,148
335,427,5,401,989,2157,703,221,15,536,679,2154,86,149
392,380,3,436,1050,2261,757,203,8,604,687,2259,86,150
349,495,16,455,1073,2388,678,258,15,678,759,2388,86,151
228,543,10,421,741,1943,377,242,10,641,696,1966,86,152
83,683,22,570,801,2159,114,301,55,936,731,2137,86,153
63,410,6,512,753,1744,84,176,11,929,538,1738,86,154
298,409,5,416,800,1928,529,236,4,587,648,2004,86,155
388,476,6,406,1252,2528,812,289,6,648,786,2541,86,156
381,461,5,433,1083,2363,749,248,7,611,811,2426,86,157
372,531,12,460,1198,2573,732,300,19,735,802,2588,86,158
250,619,20,530,983,2402,395,386,47,741,820,2389,86,159
107,715,18,824,971,2635,120,554,37,1038,843,2592,86,160
63,389,3,572,779,1806,82,236,7,882,620,1827,86,161
311,405,3,451,828,1998,513,220,4,617,690,2044,86,162
394,525,2,415,1193,2529,761,281,11,626,815,2494,86,163
412,502,3,517,1199,2633,810,287,11,704,838,2650,86,164
409,556,4,486,1219,2674,740,290,13,732,873,2648,86,165
246,493,15,526,988,2268,386,346,55,802,714,2303,86,166
93,639,19,710,954,2415,135,392,33,1007,833,2400,86,167
79,401,7,467,709,1663,84,169,5,790,576,1624,86,168
284,399,4,373,867,1927,536,214,5,592,624,1971,86,169
354,604,3,404,1279,2644,816,267,7,770,816,2676,86,170
134,550,3,590,1069,2346,419,363,5,999,689,2475,86,171
349,571,5,479,1126,2530,736,280,6,723,864,2609,86,172
247,609,20,477,808,2161,426,267,28,732,781,2234,86,173
85,678,15,595,932,2305,110,351,33,1093,730,2317,86,174
75,404,6,474,727,1686,99,151,22,834,564,1670,86,175
302,391,5,389,862,1949,557,229,5,577,626,1994,86,176
374,536,5,422,1261,2598,839,254,10,689,814,2606,86,177
405,563,6,444,1269,2687,828,290,7,766,851,2742,86,178
383,530,7,453,1166,2539,750,268,8,761,846,2633,86,179
292,635,16,548,842,2333,384,373,32,760,854,2403,86,180
98,723,18,649,934,2422,145,320,33,1066,841,2405,86,181
70,451,9,471,706,1707,93,180,10,834,589,1706,86,182
313,436,4,409,807,1969,474,217,4,574,700,1969,86,183
335,450,2,432,1031,2250,643,267,9,681,710,2310,86,184
281,527,13,511,880,2212,481,283,15,746,737,2262,86,185
106,853,16,648,920,2543,112,989,54,786,505,2446,86,186
166,618,20,483,718,2005,221,306,17,802,733,2079,86,187
104,703,17,608,887,2319,126,314,19,1013,790,2262,86,188
96,458,9,439,686,1688,107,172,15,836,534,1664,86,189
291,446,5,408,842,1992,532,226,11,613,685,2067,86,190
370,526,3,427,1223,2549,842,240,8,708,788,2586,86,191
369,524,7,402,1289,2591,860,251,15,648,825,2599,86,192
368,571,6,416,1273,2634,853,284,17,674,832,2660,86,193
260,618,22,468,826,2194,434,256,38,720,812,2260,86,194
101,760,16,591,958,2426,116,361,15,1138,789,2419,86,195
44,416,4,460,668,1592,83,167,7,856,531,1644,86,196
332,399,5,386,784,1906,538,190,9,613,596,1946,86,197
387,546,4,438,1137,2512,855,252,8,738,736,2589,86,198
410,509,3,436,1151,2509,810,197,6,672,876,2561,86,199
383,572,9,541,1266,2771,867,245,14,736,838,2700,86,200
288,675,18,481,851,2313,383,311,68,714,831,2307,86,201
115,724,13,666,1108,2626,140,410,23,1158,845,2576,86,202
103,474,8,532,801,1918,102,169,24,959,659,1913,86,203
282,427,9,450,906,2074,564,296,14,547,652,2073,86,204
373,522,7,414,1294,2610,837,285,8,701,774,2605,86,205
381,537,2,483,1323,2726,870,287,11,692,828,2688,86,206
359,645,12,470,1300,2786,762,288,14,746,1002,2812,86,207
276,668,27,472,848,2291,370,339,36,756,860,2361,86,208
86,763,21,675,1027,2572,126,325,52,1177,881,2561,86,209
91,501,4,465,822,1883,93,189,4,919,598,1803,86,210
324,467,2,415,840,2048,502,253,19,630,691,2095,86,211
376,610,3,428,1171,2588,836,230,4,710,842,2622,86,212
365,510,8,451,1114,2448,826,237,9,686,813,2571,86,213
348,558,7,487,1228,2628,754,264,7,730,841,2596,86,214
282,573,13,589,853,2310,377,362,25,793,773,2330,86,215
118,739,24,723,859,2463,93,311,48,1139,880,2471,86,216
86,462,8,506,723,1785,88,189,12,863,620,1772,86,217
292,415,20,413,799,1939,471,223,19,575,712,2000,86,218
398,512,4,441,1256,2611,779,277,7,693,810,2566,86,219
392,567,9,481,1210,2659,758,261,12,778,874,2683,86,220
316,581,2,435,1074,2408,605,230,8,720,823,2386,86,221
218,567,14,338,711,1848,296,245,23,603,699,1866,86,222
104,671,26,709,944,2454,130,339,23,1162,805,2459,86,223
52,411,5,503,717,1688,90,161,6,834,582,1673,86,224
282,493,2,441,860,2078,474,218,8,609,728,2037,86,225
343,506,5,435,1216,2505,744,242,8,743,803,2540,86,226
363,566,4,472,1123,2528,729,255,3,747,834,2568,86,227
341,515,3,458,1177,2494,721,255,7,739,840,2562,86,228
252,568,18,521,800,2159,333,311,24,808,714,2190,86,229
112,621,12,676,866,2287,128,272,30,1068,757,2255,86,230
69,407,2,493,769,1740,84,148,6,855,588,1681,86,231
267,420,3,401,894,1985,489,213,5,658,674,2039,86,232
387,534,5,398,1183,2507,759,272,9,636,841,2517,86,233
393,540,3,466,1256,2658,709,239,10,816,882,2656,86,234
349,569,3,486,1134,2541,696,296,8,690,837,2527,86,235
271,662,7,468,844,2252,352,297,22,749,847,2267,86,236
116,742,12,637,958,2465,115,304,21,1134,874,2448,86,237
69,417,2,454,799,1741,93,132,8,818,643,1694,86,238
307,365,3,377,816,1868,503,266,3,562,600,1934,86,239
407,447,4,457,1237,2552,797,299,9,672,735,2512,86,240
397,489,7,403,1101,2397,707,291,11,621,739,2369,86,241
356,429,2,408,958,2153,649,235,14,640,678,2216,86,242
235,501,17,462,845,2060,344,247,28,755,738,2112,86,243
66,644,16,693,968,2387,134,330,30,1115,818,2427,86,244
69,515,8,566,867,2025,97,186,23,956,733,1995,86,245
62,399,11,458,805,1735,108,163,9,836,573,1689,86,246
367,375,8,370,990,2110,704,208,8,575,664,2159,86,247
380,400,7,383,1052,2222,792,251,10,534,663,2250,86,248
376,461,1,387,1073,2298,753,254,5,598,728,2338,86,249
247,584,11,463,728,2033,409,288,18,666,698,2079,86,250
87,627,17,549,987,2267,155,293,51,1042,686,2227,86,251
71,385,3,463,708,1630,98,173,3,845,551,1670,86,252
326,402,5,366,769,1868,525,196,10,543,648,1922,86,253
403,424,3,380,1127,2337,815,244,7,583,697,2346,86,254
412,499,5,423,1136,2475,771,272,9,697,764,2513,86,255
396,529,6,434,1078,2443,812,271,4,660,759,2506,86,256
289,603,11,410,869,2182,378,317,13,691,827,2226,86,257
101,867,17,604,1121,2710,143,408,32,1090,1063,2736,86,258
73,371,1,505,748,1698,111,176,7,871,610,1775,86,259
320,389,3,394,771,1877,519,214,4,551,659,1947,86,260
464,468,4,396,1138,2470,790,269,2,665,799,2525,86,261
386,443,4,387,1090,2310,754,271,7,650,745,2427,86,262
371,527,12,435,1164,2509,830,315,18,682,763,2608,86,263
273,634,9,498,856,2270,404,313,27,779,827,2350,86,264
112,742,12,687,988,2541,113,314,46,1155,929,2557,86,265
60,391,3,461,701,1616,86,162,6,895,488,1637,86,266
316,373,9,439,777,1914,497,238,14,630,659,2038,86,267
400,482,1,408,1102,2393,800,266,4,600,780,2450,86,268
412,501,3,395,1156,2467,793,264,8,676,762,2503,86,269
424,583,3,474,1108,2592,745,313,11,711,824,2604,86,270
294,641,15,439,827,2216,360,297,31,731,867,2286,86,271
111,736,22,682,1174,2725,149,367,35,1112,1007,2670,86,272
66,412,4,487,751,1720,77,205,8,814,564,1668,86,273
314,393,3,370,777,1857,488,220,5,623,649,1985,86,274
410,458,2,411,1100,2381,806,211,10,648,735,2410,86,275
414,462,3,423,1182,2484,841,291,5,696,761,2594,86,276
364,518,5,546,1200,2633,760,259,3,803,875,2700,86,277
279,635,26,567,799,2306,421,286,26,715,852,2300,86,278
106,843,19,641,1043,2652,121,352,38,1170,953,2634,86,279
69,429,1,495,826,1820,86,194,5,840,667,1792,86,280
330,440,2,388,818,1978,545,243,9,571,689,2057,86,281
427,465,3,477,1204,2576,870,268,8,702,780,2628,86,282
415,512,1,460,1058,2446,703,305,13,718,830,2569,86,283
428,517,10,471,1244,2670,787,241,27,818,851,2724,86,284
269,614,25,579,926,2413,383,298,18,864,920,2483,86,285
111,710,18,701,1045,2585,133,358,29,1179,909,2608,86,286
89,476,5,514,857,1941,93,184,29,931,690,1927,86,287
214,490,1,579,1071,2355,437,228,3,1013,762,2443,86,288
396,491,1,447,1174,2509,790,276,3,723,741,2533,86,289
413,533,1,461,1214,2622,790,281,7,734,901,2713,86,290
397,614,1,467,1296,2775,793,271,9,725,937,2735,86,291
281,686,21,456,890,2334,384,303,24,757,942,2410,86,292
101,807,23,625,1113,2669,139,319,26,1178,1072,2734,86,293
79,420,3,580,796,1878,103,260,4,874,649,1890,86,294
339,487,6,405,833,2070,546,283,12,589,701,2131,86,295
467,503,7,457,1254,2688,829,248,8,766,829,2680,86,296
426,536,3,464,1252,2681,784,340,4,691,864,2683,86,297
428,569,2,537,1284,2820,801,311,8,758,916,2794,86,298
269,710,19,535,911,2444,358,322,26,813,901,2420,86,299
123,777,28,706,1114,2748,141,328,43,1231,939,2682,86,300
178,465,3,545,828,2019,96,172,21,1024,741,2054,86,301
330,404,3,463,859,2059,551,234,10,621,752,2168,86,302
430,546,6,478,1412,2872,893,376,7,727,903,2906,86,303
416,580,5,491,1310,2802,783,308,8,802,954,2855,86,304
338,436,4,504,1195,2477,694,277,19,711,791,2492,86,305
297,568,18,490,896,2269,411,300,27,838,806,2382,86,306
114,730,22,627,1000,2493,143,391,23,1084,874,2515,86,307
70,395,2,446,813,1726,103,139,6,949,548,1745,86,308
349,404,3,441,938,2135,550,205,11,694,742,2202,86,309
306,403,3,497,1152,2361,704,170,19,804,699,2396,86,310
339,454,8,402,1158,2361,762,252,11,678,696,2399,86,311
377,528,3,455,1173,2536,788,248,9,703,820,2568,86,312
300,609,12,519,927,2367,434,312,24,760,890,2420,86,313
105,709,14,659,1054,2541,153,304,18,1177,913,2565,86,314
81,407,4,541,788,1821,86,138,8,1014,613,1859,86,315
197,435,2,572,915,2121,425,197,3,865,655,2145,86,316
429,442,3,417,1243,2534,870,217,8,628,812,2535,86,317
406,509,2,436,1305,2658,906,243,6,677,891,2723,86,318
423,486,6,418,1184,2517,810,221,7,682,830,2550,86,319
271,653,30,476,885,2315,410,286,31,779,963,2469,86,320
96,757,21,660,1054,2588,132,250,20,1262,931,2595,86,321
73,427,2,447,839,1788,103,156,4,962,613,1838,86,322
299,417,1,414,811,1942,535,225,8,568,696,2032,86,323
431,531,6,447,1152,2567,872,225,6,651,856,2610,86,324
442,482,5,426,1199,2554,829,232,8,702,856,2627,86,325
382,545,3,506,1234,2670,824,297,9,721,818,2669,86,326
251,577,13,430,772,2043,400,216,21,715,786,2138,86,327
86,787,17,588,1106,2584,127,287,23,1338,900,2675,86,328
67,442,2,472,919,1902,120,146,4,965,598,1833,86,329
298,439,6,413,869,2025,462,167,10,663,774,2076,86,330
297,482,8,461,1033,2281,503,254,10,775,844,2386,86,331
226,623,4,607,967,2427,342,237,5,1019,781,2384,86,332
52,136,5,170,144,507,42,56,9,186,204,497,86,333
130,1347,18,1209,2311,5015,456,275,13,2465,1554,4763,86,334
75,671,8,592,1101,2447,172,233,8,1187,900,2500,86,335
46,407,8,456,775,1692,105,133,4,906,566,1714,86,336
285,428,17,358,792,1880,459,179,27,554,717,1936,86,337
405,460,7,363,1245,2480,791,295,16,631,781,2514,86,338
393,485,8,349,1146,2381,743,245,13,641,771,2413,86,339
388,461,5,437,1118,2409,756,270,8,695,827,2556,86,340
246,630,24,442,816,2158,396,240,23,786,816,2261,86,341
107,721,13,577,1131,2549,163,367,23,1177,861,2591,86,342
86,430,4,536,901,1957,122,183,8,1034,587,1934,86,343
267,429,2,412,792,1902,521,174,4,654,730,2083,86,344
407,611,10,438,1255,2721,828,233,12,740,936,2749,86,345
409,479,5,368,1203,2464,763,248,11,716,778,2516,86,346
372,526,4,459,1229,2590,677,301,8,789,867,2642,86,347
251,671,10,457,859,2248,404,316,29,777,875,2401,86,348
129,743,21,666,1182,2741,150,356,28,1387,949,2870,86,349
57,541,5,458,841,1902,119,153,8,1019,555,1854,86,350
291,482,5,395,869,2042,483,169,9,646,810,2117,86,351
370,594,6,455,1247,2672,740,247,26,753,982,2748,86,352
341,579,31,457,1219,2627,660,256,37,778,971,2702,86,353
302,580,16,517,1128,2543,628,304,18,809,903,2662,86,354
227,618,20,454,831,2150,364,361,30,836,812,2403,86,355
93,700,15,585,985,2378,178,228,14,1147,861,2428,86,356
71,494,5,437,766,1773,116,175,7,843,598,1739,86,357
165,555,9,433,865,2027,290,203,13,818,851,2175,86,358
110,198,8,423,678,1417,235,102,4,699,354,1394,86,359
45,83,2,120,125,375,29,74,7,135,115,360,86,360
132,581,6,494,814,2027,222,230,13,817,795,2077,86,361
118,537,5,510,774,1944,226,198,5,801,767,1997,86,362
59,555,11,440,815,1880,118,199,16,927,681,1941,86,363
55,425,7,430,698,1615,81,171,28,799,513,1592,86,364
190,520,4,544,863,2121,309,222,11,785,869,2196,86,365
143,374,36,570,761,1884,261,157,95,867,571,1951,86,366
88,481,18,668,611,1866,131,414,16,701,656,1918,87,1
812,575,12,724,1112,3235,534,585,9,816,1584,3528,87,2
1111,835,71,854,1329,4200,785,701,51,931,1862,4330,87,3
1078,732,21,888,1303,4022,741,656,17,887,1857,4158,87,4
727,1051,160,972,1548,4458,727,1219,90,986,1720,4742,87,5
131,795,164,1030,770,2890,188,947,75,1036,970,3216,87,6
116,579,30,1295,1000,3020,171,522,25,1281,1134,3133,87,7
1112,759,25,868,1492,4256,804,775,25,889,1782,4275,87,8
1408,481,6,873,1008,3776,792,526,9,963,1609,3899,87,9
1468,878,28,1067,1396,4837,833,916,15,1100,2062,4926,87,10
1329,868,21,883,1436,4537,767,1005,11,876,1971,4630,87,11
810,980,181,1019,1626,4616,751,1150,67,1093,1805,4866,87,12
179,1492,239,1552,1402,4864,226,1303,67,1354,2325,5275,87,13
105,956,16,1355,1095,3527,192,717,13,1307,1396,3625,87,14
217,688,10,1149,843,2907,269,603,11,1013,1125,3021,87,15
507,619,11,618,871,2626,303,648,10,690,989,2640,87,16
1336,787,26,936,1290,4375,512,850,16,971,2060,4409,87,17
1432,1022,17,929,1526,4926,795,1084,16,958,2199,5052,87,18
540,1101,175,828,978,3622,330,1145,100,813,1427,3815,87,19
151,1163,283,1519,1347,4463,218,1325,105,1465,1544,4657,87,20
117,652,23,1494,1109,3395,221,542,13,1321,1289,3386,87,21
1119,700,17,834,1420,4090,817,691,6,862,1760,4136,87,22
1587,1290,36,919,1553,5385,851,1032,18,899,2563,5363,87,23
1517,1053,28,991,1571,5160,814,1091,15,1032,2279,5231,87,24
1387,1115,45,952,1550,5049,825,1123,30,917,2225,5120,87,25
825,1825,354,1065,1563,5632,669,1886,162,1081,2320,6118,87,26
167,1522,255,1608,1419,4971,251,1471,100,1437,1807,5066,87,27
121,778,38,1380,1004,3321,191,595,43,1283,1230,3342,87,28
1166,703,13,890,1411,4183,851,759,7,901,1742,4260,87,29
1579,917,11,942,1507,4956,873,910,11,994,2259,5047,87,30
1518,870,20,982,1491,4881,783,1009,10,996,2140,4938,87,31
1392,1061,20,1022,1574,5069,867,1001,13,1030,2165,5076,87,32
868,1456,239,1184,1670,5417,789,1732,114,1166,2135,5936,87,33
151,1315,247,1565,1271,4549,250,1219,125,1497,1824,4915,87,34
128,645,26,1305,1062,3166,220,561,23,1345,1241,3390,87,35
1149,759,16,937,1410,4271,811,708,9,899,1799,4226,87,36
1537,1098,7,975,1570,5187,860,1038,6,931,2469,5304,87,37
1522,1204,15,1067,1476,5284,858,1044,8,989,2301,5200,87,38
1368,1153,29,1015,1520,5085,837,1048,27,971,2280,5163,87,39
839,1692,260,1089,1647,5527,794,1677,152,1075,2270,5968,87,40
189,1608,293,1657,1557,5304,256,1769,169,1537,1959,5690,87,41
108,1086,17,1347,1135,3693,212,672,40,1206,1518,3648,87,42
1059,823,10,928,1352,4172,822,719,12,949,1852,4354,87,43
1507,1145,23,929,1521,5125,783,1088,19,944,2241,5075,87,44
1498,1449,37,1140,1513,5637,842,1159,22,1176,2518,5717,87,45
1352,1175,25,1064,1493,5109,805,1026,25,1062,2207,5125,87,46
717,1921,262,1016,1480,5396,576,1744,109,1064,2165,5658,87,47
161,1664,283,1538,1420,5066,199,1437,153,1407,2070,5266,87,48
138,860,36,1289,1100,3423,230,723,32,1385,1333,3703,87,49
341,628,15,1168,1064,3216,335,575,18,1131,1273,3332,87,50
1389,1221,20,980,1512,5122,856,1004,7,985,2437,5289,87,51
1435,1040,20,1053,1497,5045,856,976,11,1038,2288,5169,87,52
1384,1203,59,1051,1509,5206,801,1182,61,1032,2318,5394,87,53
883,1625,239,1146,1481,5374,811,1476,100,1121,2263,5771,87,54
189,1358,253,1522,1471,4793,219,1474,168,1454,1852,5167,87,55
133,682,8,1352,1112,3287,205,585,16,1310,1191,3307,87,56
1175,961,20,859,1522,4537,844,849,13,878,1891,4475,87,57
1529,976,18,1009,1454,4986,917,891,17,996,2327,5148,87,58
1585,1009,27,1051,1406,5078,845,1023,35,1015,2121,5039,87,59
1428,1386,51,996,1550,5411,864,1196,48,989,2343,5440,87,60
946,1476,231,1113,1875,5641,828,1723,108,1129,2172,5960,87,61
185,1451,304,1439,1295,4674,226,1599,125,1270,1803,5023,87,62
136,890,27,1568,1206,3827,228,658,29,1429,1457,3801,87,63
1150,913,19,868,1441,4391,821,844,21,949,1873,4508,87,64
1630,1249,14,925,1418,5236,788,1107,15,901,2313,5124,87,65
1576,1088,40,1042,1363,5109,829,1132,31,973,2215,5180,87,66
1431,1388,26,1062,1499,5406,785,1196,44,1027,2369,5421,87,67
879,1578,296,1086,1552,5391,755,1746,108,1068,2269,5946,87,68
191,1519,237,1437,1148,4532,210,1452,98,1423,1691,4874,87,69
115,796,19,1425,1132,3487,181,587,11,1230,1325,3334,87,70
1204,743,12,1016,1449,4424,784,812,9,976,1913,4494,87,71
1526,1184,50,998,1499,5257,857,1085,40,936,2320,5238,87,72
1478,1133,31,1108,1622,5372,783,1203,30,1011,2209,5236,87,73
1275,1614,24,1101,1663,5677,635,1408,95,1009,2365,5512,87,74
751,1406,254,1084,1594,5089,530,1540,163,985,2031,5249,87,75
392,2277,361,2363,1722,7115,421,1934,139,2387,2639,7520,87,76
157,1106,27,1429,1164,3883,252,871,21,1420,1379,3943,87,77
1126,950,25,950,1424,4475,783,784,15,900,1970,4452,87,78
1535,1207,44,954,1522,5262,783,1113,34,862,2432,5224,87,79
1544,1415,11,1086,1629,5685,796,1345,14,988,2511,5654,87,80
1447,1554,22,1070,1631,5724,778,1499,27,1037,2288,5629,87,81
939,1818,247,1182,1848,6034,809,2002,91,1113,2362,6377,87,82
155,1723,275,1429,1580,5162,202,1904,84,1339,1906,5435,87,83
168,1174,9,1731,1359,4441,231,867,10,1584,1773,4465,87,84
1149,1054,20,1033,1620,4876,812,1065,17,972,2091,4957,87,85
1478,1308,44,1105,1560,5495,800,1143,43,908,2424,5318,87,86
1459,1237,15,1174,1354,5239,804,1083,8,996,2286,5177,87,87
1299,1287,16,1212,1591,5405,794,1137,11,1039,2362,5343,87,88
806,1730,295,1391,1818,6040,758,1950,112,1244,2264,6328,87,89
198,1788,245,1925,1800,5956,272,1964,93,1669,2304,6302,87,90
155,854,16,1655,1104,3784,322,647,17,1404,1367,3757,87,91
1028,843,16,1135,1482,4504,790,902,12,922,1895,4521,87,92
1474,904,14,1067,1451,4910,857,876,6,914,2303,4956,87,93
1577,971,19,1004,1566,5137,759,1047,7,934,2178,4925,87,94
1390,1370,25,1177,1721,5683,842,1328,20,1048,2384,5622,87,95
852,1908,246,1264,1858,6128,656,2042,119,1144,2462,6423,87,96
229,1727,296,2182,1881,6315,278,2282,95,1910,2191,6756,87,97
461,958,16,1777,1261,4473,245,799,10,1749,1447,4250,87,98
1096,917,14,995,1336,4358,735,824,15,923,1775,4272,87,99
1456,1155,20,943,1441,5015,860,984,17,856,2308,5025,87,100
1504,1263,10,1155,1497,5429,866,1049,5,1041,2336,5297,87,101
1375,1192,12,1022,1534,5135,843,1091,12,936,2241,5123,87,102
1034,1560,254,1169,1758,5775,802,1562,110,1151,2153,5778,87,103
248,1693,321,1892,1870,6024,265,2135,142,1939,2171,6652,87,104
145,1195,25,1591,1251,4207,200,788,15,1603,1626,4232,87,105
1010,940,16,880,1300,4146,593,942,10,862,1774,4181,87,106
1352,1149,15,944,1146,4606,556,1188,11,874,2081,4710,87,107
1393,1201,14,983,1079,4670,619,1062,10,941,1726,4358,87,108
1297,1526,28,967,1277,5095,558,1235,16,968,2269,5046,87,109
749,1749,269,1077,1783,5627,581,2112,118,1101,2181,6093,87,110
230,2135,386,2144,1924,6819,240,2472,174,1597,2868,7351,87,111
128,725,13,1459,1049,3374,206,553,16,1359,1256,3390,87,112
1059,815,10,865,1373,4122,788,702,7,875,1754,4126,87,113
1413,1089,33,938,1684,5157,822,1218,33,889,2159,5121,87,114
1416,1022,13,990,1682,5123,811,1231,7,980,2044,5073,87,115
1336,1507,23,1090,1662,5618,828,1383,17,1021,2426,5675,87,116
800,1698,309,1150,1926,5883,779,2039,147,1105,2195,6265,87,117
241,1483,295,1626,1521,5166,278,1972,316,1474,1731,5771,87,118
149,1084,25,1452,1335,4045,218,897,66,1412,1468,4061,87,119
1203,711,19,946,1432,4311,815,778,9,880,1794,4276,87,120
1475,1179,17,1039,1448,5158,873,1083,11,937,2267,5171,87,121
1529,1134,15,1155,1564,5397,862,1072,15,1035,2263,5247,87,122
1393,1232,21,1102,1554,5302,804,1076,9,943,2180,5012,87,123
889,1578,228,1109,1946,5750,793,2022,144,1140,1962,6061,87,124
197,1633,258,1307,1445,4840,218,1562,95,1446,1726,5047,87,125
124,1046,22,1499,1188,3879,204,875,13,1348,1438,3878,87,126
1083,1010,9,992,1389,4483,754,908,3,913,1815,4393,87,127
1533,1213,31,1028,1725,5530,791,1379,21,949,2246,5386,87,128
1509,1205,29,1150,1799,5692,853,1446,26,1028,2262,5615,87,129
1305,1229,34,1072,1593,5233,819,1141,21,1055,2147,5183,87,130
831,1277,278,1137,1567,5090,773,1506,108,1111,1901,5399,87,131
246,1344,292,1400,1358,4640,286,1352,78,1624,1579,4919,87,132
141,747,27,1239,909,3063,206,663,21,1202,1100,3192,87,133
1071,863,43,872,1392,4241,761,705,30,951,1834,4281,87,134
1512,1089,62,895,1456,5014,878,1058,56,938,2291,5221,87,135
1519,1206,59,1037,1467,5288,927,1199,50,1047,2160,5383,87,136
1351,1484,48,982,1614,5479,853,1265,46,1003,2474,5641,87,137
839,1641,286,1135,1671,5572,808,1585,100,1156,2272,5921,87,138
180,1589,320,1463,1330,4882,217,1723,109,1388,1764,5201,87,139
170,1193,33,1322,1191,3909,230,852,11,1427,1447,3967,87,140
1106,950,19,910,1608,4593,796,1076,14,947,1891,4724,87,141
1508,1077,29,1024,1742,5380,886,1210,19,1029,2220,5364,87,142
1467,1287,23,1173,1509,5459,856,1064,21,1105,2401,5447,87,143
1285,1120,22,994,1495,4916,811,963,17,1022,2100,4913,87,144
774,1369,278,1216,1986,5623,756,1902,138,1236,1827,5859,87,145
218,1503,228,1702,1491,5142,222,1996,106,1367,1746,5437,87,146
178,1407,32,1618,1072,4307,224,1115,17,1282,1771,4409,87,147
157,759,14,1136,782,2848,191,536,16,1052,1119,2914,87,148
1303,993,23,951,1418,4688,813,899,8,1021,1989,4730,87,149
1441,1035,22,1036,1404,4938,841,824,22,1092,2202,4981,87,150
1244,1401,26,969,1572,5212,810,1068,10,976,2378,5242,87,151
846,1413,283,1118,1692,5352,796,1754,115,1122,1931,5718,87,152
217,1457,307,1484,1387,4852,252,1807,106,1542,1576,5283,87,153
121,770,16,1361,985,3253,265,643,10,1259,1199,3376,87,154
1257,921,11,1009,1510,4708,864,978,12,984,1935,4773,87,155
1524,1202,18,869,1478,5091,677,1242,11,910,2283,5123,87,156
1550,1087,24,1034,1408,5103,884,1041,20,1013,2199,5157,87,157
1401,1454,30,1089,2117,6091,846,2238,24,985,2276,6369,87,158
877,1788,332,1131,2605,6733,740,2752,249,1229,2228,7198,87,159
252,5210,946,1917,5563,13888,314,4231,446,6420,6072,17483,87,160
211,1643,41,1930,1585,5410,244,2223,36,1570,2008,6081,87,161
1179,1083,23,948,1450,4683,844,842,14,911,1944,4555,87,162
1601,1176,23,1031,1635,5466,856,1206,5,958,2316,5341,87,163
1583,1320,16,1048,1753,5720,851,1552,21,985,2291,5700,87,164
1445,1374,19,1088,1573,5499,791,1234,17,1064,2330,5436,87,165
881,1648,265,1140,2055,5989,753,2185,163,1189,2136,6426,87,166
225,1556,305,1555,1758,5399,263,2228,189,1486,1697,5863,87,167
147,991,30,1560,964,3692,256,711,29,1325,1429,3750,87,168
1113,796,15,952,1263,4139,737,760,14,977,1757,4245,87,169
1404,1164,32,1004,1516,5120,632,1280,35,940,2209,5096,87,170
452,1793,23,1462,1655,5385,413,1332,22,1415,2340,5522,87,171
1216,1335,24,982,1311,4868,579,1145,15,918,2126,4783,87,172
758,1766,265,1013,1489,5291,549,1817,96,1079,2099,5640,87,173
209,2038,343,1342,1298,5230,247,2335,263,1314,1671,5830,87,174
144,901,22,1352,1004,3423,246,704,10,1368,1213,3541,87,175
1125,856,17,931,1192,4121,699,765,9,989,1678,4140,87,176
1508,1113,15,884,1324,4844,707,1005,8,885,2205,4810,87,177
1489,1238,17,944,1370,5058,730,973,9,927,2325,4964,87,178
1300,1586,23,1026,1349,5284,666,1428,16,1027,2229,5366,87,179
844,1546,296,1095,1520,5301,671,1789,114,1062,2105,5741,87,180
194,1391,294,1429,1509,4817,231,1811,147,1440,1538,5167,87,181
156,699,13,1299,992,3159,186,570,11,1291,1165,3223,87,182
1008,943,19,957,1428,4355,717,977,12,944,1756,4406,87,183
1242,920,22,1075,1416,4675,697,912,23,1031,1970,4633,87,184
1021,1406,52,1122,1772,5373,677,1613,64,1099,1973,5426,87,185
196,2298,83,1649,1263,5489,185,2758,116,1361,1658,6078,87,186
393,1266,245,1097,1350,4351,400,1579,98,1053,1485,4615,87,187
175,1173,254,1322,1175,4099,231,1574,105,1253,1399,4562,87,188
143,708,15,1347,977,3190,249,567,11,1252,1299,3378,87,189
1066,746,13,918,1202,3945,677,781,6,900,1709,4073,87,190
1423,991,21,916,1326,4677,706,979,14,949,2081,4729,87,191
1440,965,25,1031,1401,4862,811,970,15,964,2093,4853,87,192
1337,1213,21,1042,1362,4975,684,1116,9,953,2171,4933,87,193
829,1499,245,1039,1556,5168,646,1814,120,1012,1900,5492,87,194
196,1412,348,1470,1570,4996,236,2002,176,1368,1653,5435,87,195
133,986,33,1282,1096,3530,224,706,23,1490,1328,3771,87,196
1079,735,14,917,1153,3898,704,644,11,900,1620,3879,87,197
1413,894,21,926,1349,4603,681,1058,19,934,1958,4650,87,198
1456,965,12,988,1235,4656,727,778,9,881,2201,4596,87,199
1315,1267,20,935,1362,4899,599,1133,17,956,2105,4810,87,200
746,1559,304,999,2315,5923,633,2330,638,1053,1820,6474,87,201
171,1405,262,1374,1567,4779,258,2129,153,1346,1488,5374,87,202
133,965,7,1398,994,3497,209,833,4,1284,1341,3671,87,203
1077,670,6,804,1036,3593,669,719,5,785,1532,3710,87,204
1447,906,18,950,1463,4784,720,1085,16,957,2061,4839,87,205
1289,964,19,1027,1471,4770,682,1087,12,955,2056,4792,87,206
1319,1169,31,1002,1323,4844,578,1099,21,931,2193,4822,87,207
764,1266,319,1000,1475,4824,582,1865,163,1021,1729,5360,87,208
187,1367,281,1425,1381,4641,236,1989,258,1385,1533,5401,87,209
143,891,19,1238,1186,3477,241,863,42,1239,1193,3578,87,210
1032,783,29,864,1439,4147,651,927,33,935,1669,4215,87,211
1420,1179,24,943,1218,4784,693,1088,17,897,2106,4801,87,212
1356,1021,24,990,1186,4577,684,984,15,972,1972,4627,87,213
1219,1121,17,1000,1278,4635,638,996,11,999,2047,4691,87,214
735,1337,198,1065,1595,4930,550,1788,165,1048,1639,5190,87,215
198,1067,276,1556,1308,4405,222,1260,95,1286,1768,4631,87,216
158,662,14,1320,973,3127,195,601,12,1212,1088,3108,87,217
931,728,7,858,1207,3731,602,766,4,844,1545,3761,87,218
1278,890,27,862,1344,4401,627,1077,23,836,1857,4420,87,219
1249,1064,10,947,1285,4555,592,1007,14,844,1998,4455,87,220
1083,865,17,932,1065,3962,507,795,23,845,1719,3889,87,221
547,1146,242,854,1297,4086,475,1572,139,776,1376,4338,87,222
192,1334,198,1308,1481,4513,248,1688,117,1281,1449,4783,87,223
139,988,13,1229,979,3348,201,733,12,1227,1265,3438,87,224
868,696,8,769,1264,3605,555,712,7,787,1482,3543,87,225
1154,1045,27,816,1206,4248,568,927,14,872,2017,4398,87,226
1150,1152,34,942,1258,4536,641,907,33,897,1981,4459,87,227
1025,1125,54,915,1302,4421,553,1013,71,883,1872,4392,87,228
667,1331,266,1014,1450,4728,555,1770,139,1002,1691,5157,87,229
185,1219,327,1284,1113,4128,246,1493,129,1220,1545,4633,87,230
129,702,18,1425,961,3235,236,600,20,1222,1263,3341,87,231
916,738,16,837,1106,3613,602,623,14,783,1536,3558,87,232
1170,944,31,840,1328,4313,619,963,32,813,1887,4314,87,233
1130,1099,27,892,1442,4590,619,1109,29,867,1942,4566,87,234
1065,1183,18,909,1239,4414,560,897,14,888,2000,4359,87,235
679,1561,233,983,1525,4981,547,1757,147,1014,1784,5249,87,236
218,1323,414,1490,1674,5119,223,1850,181,1503,1666,5423,87,237
139,1042,37,1349,1139,3706,162,807,38,1285,1445,3737,87,238
1030,806,21,903,1584,4344,781,826,19,873,1675,4174,87,239
1389,1063,14,920,1726,5112,831,1184,15,886,2136,5052,87,240
1332,961,12,993,1638,4936,882,1111,13,933,2017,4956,87,241
1156,894,15,1001,1395,4461,822,819,18,925,1896,4480,87,242
714,1213,192,1103,1884,5106,747,1619,133,1041,1715,5255,87,243
233,1484,226,1439,1438,4820,226,1652,127,1359,1840,5204,87,244
154,1148,23,1290,1116,3731,139,1074,7,1160,1623,4003,87,245
134,667,10,1032,822,2665,156,600,11,1075,1083,2925,87,246
1285,838,27,899,1458,4507,884,799,14,904,2091,4692,87,247
1457,1006,45,1027,1360,4895,894,933,26,982,2092,4927,87,248
1299,1176,29,974,1389,4867,793,995,22,966,2084,4860,87,249
859,1435,322,1081,1589,5286,776,1809,143,1065,2040,5833,87,250
170,1817,282,1671,1572,5512,249,2126,212,1374,2155,6116,87,251
165,918,10,1408,1135,3636,230,604,9,1498,1206,3547,87,252
1208,1075,14,917,1407,4621,863,897,10,807,1941,4518,87,253
1580,1281,14,932,1572,5379,875,1276,14,917,2166,5248,87,254
1594,1279,30,1088,1623,5614,916,1259,24,1042,2297,5538,87,255
1467,1290,20,995,1756,5528,880,1442,9,982,2297,5610,87,256
957,1876,334,1205,1969,6341,796,2234,129,1146,2353,6658,87,257
222,1649,333,1762,1694,5660,276,2232,161,1621,1792,6082,87,258
200,952,19,1895,1119,4185,250,719,32,1455,1651,4107,87,259
1169,967,15,927,1442,4520,850,789,11,879,1923,4452,87,260
1650,1116,25,1015,1481,5287,909,1045,10,931,2454,5349,87,261
1648,1591,21,1028,1462,5750,822,1334,25,914,2319,5414,87,262
1508,1236,17,1083,1814,5658,921,1350,6,1007,2254,5538,87,263
944,2176,306,1135,1700,6261,842,1975,179,1065,2511,6572,87,264
234,1802,380,1838,1682,5936,232,2464,221,1552,2079,6548,87,265
161,1122,12,1428,1166,3889,235,737,5,1364,1538,3879,87,266
1200,956,12,955,1447,4570,814,1030,7,915,1891,4657,87,267
1648,1033,19,1033,1568,5301,893,1185,7,1012,2351,5448,87,268
1621,1238,13,1131,1566,5569,835,1214,11,985,2369,5414,87,269
1454,1594,18,1179,1650,5895,825,1252,22,1018,2582,5699,87,270
938,1870,294,1153,1811,6066,801,2048,135,1148,2223,6355,87,271
226,2540,452,1812,1842,6872,261,2884,247,1539,2575,7506,87,272
146,944,11,1631,1043,3775,256,736,17,1350,1574,3933,87,273
1186,983,21,956,1480,4626,892,914,4,972,1922,4704,87,274
1667,1276,18,991,1492,5444,851,1127,13,972,2349,5312,87,275
1560,1029,26,1139,1514,5268,923,1062,16,989,2242,5232,87,276
1319,1296,18,1125,1628,5386,860,1029,19,1008,2400,5316,87,277
867,1533,248,1044,1626,5318,770,1700,117,1067,2085,5739,87,278
215,1999,324,1845,1676,6059,235,2271,124,1575,2262,6467,87,279
157,847,13,1588,1071,3676,244,657,10,1505,1325,3741,87,280
1152,986,25,994,1453,4610,859,893,19,984,1977,4732,87,281
1523,1267,25,980,1647,5442,920,1097,20,975,2366,5378,87,282
1511,1236,19,1250,1542,5558,857,1146,20,1092,2286,5401,87,283
1310,1552,31,1053,1486,5432,653,1373,12,984,2401,5423,87,284
770,1882,270,1321,1595,5838,621,1908,126,1200,2197,6052,87,285
234,1708,282,1767,1535,5526,228,1915,121,1472,2253,5989,87,286
213,1070,27,1531,1377,4218,249,1077,25,1466,1489,4306,87,287
518,860,11,1227,1143,3759,421,838,8,1106,1500,3873,87,288
1511,1518,37,1049,1696,5811,916,1295,25,1026,2574,5836,87,289
1598,1142,13,1227,1651,5631,970,1025,17,1065,2497,5574,87,290
1425,1542,35,1162,1750,5914,900,1490,32,1026,2445,5893,87,291
869,3012,527,1221,2019,7648,827,2576,146,1394,2790,7733,87,292
264,3374,464,1850,2306,8258,298,3408,345,1988,2743,8782,87,293
154,1328,16,1594,1520,4612,244,1331,9,1537,1577,4698,87,294
1118,963,12,1014,1562,4669,870,821,6,948,1996,4641,87,295
1545,1091,13,1026,1650,5325,928,946,10,982,2397,5263,87,296
1524,1169,20,1090,1711,5514,909,1155,18,1022,2312,5416,87,297
1415,1574,36,1167,1712,5904,908,1453,11,1071,2546,5989,87,298
932,1684,323,1185,1756,5880,840,1897,105,1175,2277,6294,87,299
226,2144,592,1608,1483,6053,253,2256,198,1652,2226,6585,87,300
401,954,27,1679,1273,4334,245,888,28,1697,1460,4318,87,301
1144,1028,9,1026,1494,4701,860,837,8,951,1967,4623,87,302
1531,1290,26,1118,1801,5766,949,1498,22,998,2312,5779,87,303
1557,1392,18,1153,1662,5782,931,1322,14,984,2431,5682,87,304
1301,1786,46,1065,1676,5874,797,2009,43,1019,2386,6254,87,305
812,1767,467,1155,1755,5956,755,2079,155,1146,2196,6331,87,306
233,1910,358,1540,1702,5743,274,2074,174,1637,2036,6195,87,307
183,751,18,1502,1214,3668,245,617,11,1530,1172,3575,87,308
1106,827,33,943,1249,4158,649,816,34,933,1800,4232,87,309
1224,1462,67,1085,1318,5156,634,1218,42,1059,2421,5374,87,310
1186,1218,28,1129,1809,5370,849,884,20,1075,2203,5031,87,311
1316,1237,36,1084,1523,5196,838,958,33,989,2292,5110,87,312
812,1533,281,1046,1784,5456,777,1708,121,1130,2095,5831,87,313
191,1874,255,1525,1482,5327,241,1729,105,1551,2069,5695,87,314
133,843,22,1739,1137,3874,231,640,11,1378,1783,4043,87,315
460,1166,12,1134,1092,3864,390,776,16,1132,1605,3919,87,316
1633,1037,13,1084,1533,5300,895,930,20,931,2389,5165,87,317
1661,973,19,1128,1630,5411,917,1059,27,1033,2325,5361,87,318
1518,1273,21,1012,1538,5362,848,1147,11,955,2518,5479,87,319
963,1493,264,1136,1756,5612,760,1549,93,1126,2341,5869,87,320
242,2001,400,2004,1545,6192,271,1959,130,1637,2777,6774,87,321
152,1348,19,1371,1218,4108,226,866,11,1425,1644,4172,87,322
1208,1013,17,972,1399,4609,819,879,11,872,2120,4701,87,323
1628,1180,21,946,1564,5339,903,970,15,932,2585,5405,87,324
1598,1008,34,1073,1506,5219,888,980,31,1008,2355,5262,87,325
1459,1471,15,1034,1612,5591,837,1247,8,984,2471,5547,87,326
906,1553,204,1135,1574,5372,784,1421,89,1125,2122,5541,87,327
184,1516,313,1554,1562,5129,230,1614,80,1576,1923,5423,87,328
158,683,9,1417,1175,3442,208,584,14,1395,1136,3337,87,329
884,798,10,1000,1372,4064,721,631,14,917,1637,3920,87,330
969,818,23,1048,1424,4282,735,747,20,931,1712,4145,87,331
559,742,53,1163,1174,3691,456,736,46,1058,1185,3481,87,332
104,175,8,522,311,1120,111,243,16,324,299,993,87,333
179,591,100,903,770,2543,227,726,52,937,1006,2948,87,334
121,1034,136,980,934,3205,195,1121,55,1191,1311,3873,87,335
93,559,4,976,843,2475,199,650,9,1091,1068,3017,87,336
1047,798,28,832,1307,4012,817,802,25,910,1816,4370,87,337
1575,847,13,941,1549,4925,869,1048,13,957,2338,5225,87,338
1637,981,15,1046,1470,5149,844,1001,10,974,2329,5158,87,339
1500,1240,31,1038,1673,5482,771,1291,26,970,2515,5573,87,340
924,1453,258,1172,1630,5437,737,1604,80,1141,2148,5710,87,341
182,1870,276,1532,1914,5774,204,2017,142,1746,2135,6244,87,342
128,979,27,1485,1291,3910,230,819,23,1404,1528,4004,87,343
1284,1050,19,984,1355,4692,803,887,15,933,2222,4860,87,344
1672,1167,13,1111,1630,5593,846,1056,16,912,2663,5493,87,345
1736,1308,13,1069,1408,5534,790,1161,20,992,2580,5543,87,346
1598,1701,28,1412,1800,6539,842,1687,24,1201,2687,6441,87,347
953,1644,323,1360,1848,6128,789,1768,105,1213,2492,6367,87,348
217,1801,397,1850,2022,6287,236,2016,124,2055,2115,6546,87,349
112,1125,8,1487,1197,3929,196,852,10,1327,1501,3886,87,350
1108,771,24,898,1444,4245,766,772,20,866,1882,4306,87,351
1512,967,18,1031,1584,5112,797,948,16,967,2257,4985,87,352
1402,1019,34,1162,1470,5087,764,968,35,1041,2205,5013,87,353
1167,949,28,1006,1531,4681,759,971,20,946,1913,4609,87,354
730,1109,192,1080,1507,4618,661,1193,87,1036,1691,4668,87,355
132,905,131,1240,1041,3449,176,837,51,1198,1320,3582,87,356
140,449,9,978,786,2362,157,385,4,844,857,2247,87,357
447,478,4,927,983,2839,395,379,8,793,954,2529,87,358
252,283,9,744,599,1887,295,234,11,663,502,1705,87,359
70,166,3,260,230,729,43,182,3,207,222,657,87,360
216,483,7,664,709,2079,270,513,3,690,845,2321,87,361
234,696,118,798,962,2808,346,805,36,811,1116,3114,87,362
106,706,142,776,754,2484,148,906,79,944,1043,3120,87,363
100,641,18,824,741,2324,138,463,17,883,914,2415,87,364
457,790,9,970,1101,3327,354,688,9,996,1290,3337,87,365
427,1105,1577,1134,1014,5257,350,1916,784,1094,1279,5423,87,366
192,1320,11,1722,1684,4929,252,356,13,1485,917,3023,88,1
3130,1332,14,2302,3721,10499,2748,538,26,2497,3764,9573,88,2
3973,1149,24,2315,4459,11920,3139,760,37,2609,4790,11335,88,3
3786,1181,12,2358,4237,11574,3190,775,21,2757,4614,11357,88,4
2367,1328,63,2442,3752,9952,2496,895,55,2808,3441,9695,88,5
324,1097,56,1959,1277,4713,442,620,56,1677,1068,3863,88,6
206,1049,4,1987,1709,4955,294,545,15,1534,1254,3642,88,7
3693,1251,12,2512,4528,11996,3414,748,14,2539,4319,11034,88,8
4541,1065,9,2769,4577,12961,4045,616,13,3263,4573,12510,88,9
4694,1486,13,2704,5546,14443,4315,976,28,3237,5934,14490,88,10
4293,1617,22,2848,5471,14251,4137,1092,27,3403,5851,14510,88,11
2577,1557,83,2592,4528,11337,2697,1018,69,3369,4512,11665,88,12
413,1268,108,3278,2588,7655,598,1023,69,2863,2879,7432,88,13
227,1170,22,2291,2062,5772,343,553,31,2134,1626,4687,88,14
394,1873,12,2544,2259,7082,696,651,14,2083,1823,5267,88,15
1110,1200,23,1822,2505,6660,1539,818,34,2080,1681,6152,88,16
3039,1333,10,2934,4934,12250,3516,912,19,3021,4685,12153,88,17
4555,1810,7,2858,5767,14997,4099,1495,11,3337,6002,14944,88,18
1302,1747,62,2995,7101,13207,1996,1016,56,3057,2667,8792,88,19
373,1184,55,2443,2074,6129,560,915,100,2752,1878,6205,88,20
243,1230,13,2306,2159,5951,360,646,13,2041,1600,4660,88,21
3956,1316,17,2404,4920,12613,3600,774,21,2650,4646,11691,88,22
5430,1331,24,2738,5636,15159,4553,1134,42,3005,6012,14746,88,23
5331,1544,28,2712,6022,15637,4664,1170,27,3230,6251,15342,88,24
4666,1586,9,2603,5527,14391,4247,1353,17,3270,5844,14731,88,25
2659,1797,68,3072,4403,11999,3174,1353,76,3587,4221,12411,88,26
360,1399,68,2415,2323,6565,566,1063,54,2496,1916,6095,88,27
236,1760,14,2086,1985,6081,389,596,18,2111,1547,4661,88,28
3882,1296,14,2507,4934,12633,3628,794,19,2654,4508,11603,88,29
5304,1323,10,2579,5622,14838,4496,1047,10,2781,5952,14286,88,30
5155,1656,7,2484,5731,15033,4624,1164,10,3213,6244,15255,88,31
4585,1628,13,2686,5489,14401,4426,1178,27,3372,5749,14752,88,32
2882,1575,82,2755,4625,11919,3156,1333,64,3230,4426,12209,88,33
337,1172,58,2296,2154,6017,517,912,74,2252,1736,5491,88,34
252,1427,20,2329,2054,6082,350,572,16,2062,1664,4664,88,35
4142,1353,24,2391,4777,12687,3664,768,25,2802,4585,11844,88,36
5444,1601,21,2574,5725,15365,4629,1110,23,2922,6121,14805,88,37
5268,1511,15,2613,5896,15303,4757,1130,19,3329,5999,15234,88,38
4632,1637,12,2769,5403,14453,4504,1183,19,3218,5915,14839,88,39
2839,1806,71,2917,4680,12313,3249,1216,82,3584,4381,12512,88,40
398,1149,70,2664,2255,6536,581,998,82,2529,1802,5992,88,41
232,1471,22,2272,2009,6006,326,654,39,1817,1769,4605,88,42
3923,1458,20,2406,4632,12439,3363,811,21,2736,4667,11598,88,43
4845,1341,15,2509,5160,13870,3807,1100,21,2888,5413,13229,88,44
5177,1438,15,2660,5953,15243,4285,1106,26,3352,6134,14903,88,45
4655,1625,12,3236,5422,14950,4121,1218,19,3579,6229,15166,88,46
2599,1850,71,3105,4524,12149,3063,1295,98,3928,4541,12925,88,47
448,1459,94,2753,2573,7327,763,922,74,2965,2192,6916,88,48
273,1435,10,2638,2188,6544,451,699,8,2447,1948,5553,88,49
827,1985,14,2834,2869,8529,949,788,18,2546,2169,6470,88,50
5244,1306,11,2821,5234,14616,4087,1097,25,2913,5759,13881,88,51
5379,1318,24,2829,5481,15031,4477,1101,26,3124,6251,14979,88,52
4831,1598,13,2724,5246,14412,4014,1282,23,3292,6076,14687,88,53
2979,1610,69,2793,4657,12108,3097,1184,82,3402,4680,12445,88,54
392,1219,65,2549,2426,6651,635,966,55,2540,2077,6273,88,55
279,1481,8,2438,2210,6416,478,763,6,2060,1770,5077,88,56
4057,1531,8,2563,4958,13117,3868,859,12,2769,4859,12367,88,57
5465,1421,35,2710,5890,15521,4709,1070,42,2990,6226,15037,88,58
5276,1656,18,2697,5892,15539,4957,1118,24,3253,6258,15610,88,59
4793,1890,6,2877,5648,15214,4463,1319,24,3504,6076,15386,88,60
2917,1829,86,3028,4952,12812,3209,1447,105,3551,4845,13157,88,61
361,1369,93,2574,2177,6574,646,954,102,2480,1776,5958,88,62
285,1536,8,2629,2338,6796,509,633,4,2263,1804,5213,88,63
4080,1477,19,2696,5139,13411,3854,889,26,3086,5043,12898,88,64
5598,1661,13,2907,5912,16091,4692,1043,21,3327,6274,15357,88,65
5339,1908,19,3147,6269,16682,5095,1115,24,3597,6616,16447,88,66
4646,2417,35,3078,5992,16168,4722,1657,30,3729,6633,16771,88,67
2975,2020,60,3080,5081,13216,3558,1435,97,4194,5303,14587,88,68
425,1296,46,2801,2425,6993,807,1030,71,2862,1896,6666,88,69
254,1681,10,2660,2699,7304,388,815,12,2495,2130,5840,88,70
4095,1851,21,2992,5167,14126,3817,1053,23,3301,5184,13378,88,71
5415,2141,4,3161,6324,17045,4766,1309,10,3761,6532,16378,88,72
5242,1984,28,3531,6539,17324,4991,1366,24,4151,6724,17256,88,73
4481,2223,25,3571,5895,16195,4413,1502,61,4084,6292,16352,88,74
2758,2294,80,3580,4962,13674,3356,1438,112,4227,4873,14006,88,75
715,2073,86,4317,3242,10433,932,1622,81,3836,2779,9250,88,76
334,2509,14,3320,3474,9651,677,1062,8,3214,2406,7367,88,77
4191,1864,7,3502,5568,15132,4026,1097,11,3649,5193,13976,88,78
5743,1991,15,3361,6358,17468,5069,1295,19,3748,6773,16904,88,79
5439,2205,44,3556,6916,18160,5251,1573,35,4212,6975,18046,88,80
4973,2193,19,3738,6532,17455,4969,1701,21,4250,6735,17676,88,81
3045,2410,44,4178,5823,15500,3605,1727,68,4685,5505,15590,88,82
494,1848,49,3243,3086,8720,737,1465,76,3422,2778,8478,88,83
414,1929,12,4160,3572,10087,655,1243,26,4121,3745,9790,88,84
4102,1831,16,3785,5524,15258,3851,1350,16,4143,5714,15074,88,85
5239,1759,11,3990,6311,17310,4595,1431,20,4508,6966,17520,88,86
5108,1852,11,3699,6082,16752,4188,1490,14,4665,7054,17411,88,87
4422,2341,8,3754,5739,16264,4034,1517,15,4648,6540,16754,88,88
2703,2273,73,4405,5286,14740,2946,1742,80,5050,5340,15158,88,89
570,1876,66,4069,3508,10089,923,1556,81,4186,2999,9745,88,90
394,2122,17,3186,2798,8517,602,832,19,3142,2327,6922,88,91
3940,2238,16,3921,5360,15475,3235,1212,25,3881,5175,13528,88,92
5576,1691,12,3835,6520,17634,4223,1132,15,4421,6874,16665,88,93
5418,1845,6,3621,6175,17065,4335,1486,10,4217,6538,16586,88,94
5042,2287,37,3799,6313,17478,4430,1705,32,4451,7274,17892,88,95
3108,2411,61,4142,5434,15156,3307,1826,64,5084,5338,15619,88,96
655,1727,61,3898,2931,9272,940,1381,91,4070,2593,9075,88,97
552,1788,15,3108,2567,8030,730,1031,17,3149,2337,7264,88,98
4040,1755,23,3035,5091,13944,3981,1049,39,3488,4885,13442,88,99
5431,2065,7,3529,6194,17226,4860,1267,10,3854,6548,16539,88,100
5299,2070,9,3566,6535,17479,4873,1262,15,4234,6561,16945,88,101
4856,2189,11,3330,5900,16286,4918,1388,19,4251,6589,17165,88,102
3100,2295,33,3588,5518,14534,3574,1571,72,4310,5226,14753,88,103
604,1842,63,3445,3081,9035,913,1302,81,3379,2501,8176,88,104
373,2005,15,3224,2819,8436,592,909,21,3107,2417,7046,88,105
3924,1631,11,3191,5283,14040,3863,1198,15,3734,4724,13534,88,106
4836,2059,8,3414,5963,16280,4680,1257,17,3779,5964,15697,88,107
5096,2120,14,3375,6120,16725,4879,1359,18,4011,6151,16418,88,108
4518,2312,40,3577,5935,16382,4724,1510,45,4259,6323,16861,88,109
2851,2129,58,3707,5126,13871,3473,1485,85,4503,4809,14355,88,110
518,2024,89,2985,3232,8848,843,1520,61,3245,2423,8092,88,111
336,1816,15,3063,2612,7842,560,948,19,2720,2002,6249,88,112
4052,1671,3,3375,4846,13947,3713,960,9,3148,4855,12685,88,113
5435,1773,2,3330,5924,16464,4521,1327,4,3711,6376,15939,88,114
5248,1762,15,3444,6032,16501,4553,1408,16,4020,6375,16372,88,115
5074,1879,0,3403,5879,16235,4383,1558,6,4230,6536,16713,88,116
3094,2124,78,3365,5423,14084,3477,1529,76,4060,5319,14461,88,117
485,1493,84,2933,2681,7676,902,1178,138,3156,2011,7385,88,118
341,1910,13,2792,2668,7724,587,857,15,2725,2096,6280,88,119
4031,1943,19,3122,4790,13905,3998,955,15,3419,5046,13433,88,120
5539,2018,20,2835,6006,16418,4839,1132,30,3712,6507,16220,88,121
5245,2057,15,3148,6197,16662,4915,1240,15,4017,6566,16753,88,122
4725,2186,21,3342,5842,16116,4747,1343,37,4046,6420,16593,88,123
2901,2221,39,3374,5029,13564,3463,1589,64,4172,4835,14123,88,124
534,1342,73,3034,2322,7305,839,1086,52,2753,2099,6829,88,125
305,1597,16,2607,2288,6813,522,760,18,2443,1783,5526,88,126
4079,1772,8,3006,5120,13985,3861,964,9,3415,4738,12987,88,127
5503,1940,10,3166,6089,16708,4836,1315,21,3730,6338,16240,88,128
5268,2190,18,3194,6418,17088,5156,1350,20,3989,6467,16982,88,129
4603,2269,7,3147,6004,16030,4724,1427,19,4007,6362,16539,88,130
2814,2029,66,3529,5036,13474,3481,1319,76,4148,4887,13911,88,131
592,1585,71,3031,2679,7958,900,1086,78,3097,2286,7447,88,132
351,1971,15,2503,2347,7187,560,732,16,2504,1857,5669,88,133
4004,2187,17,3132,5559,14899,4045,1106,20,3617,4952,13740,88,134
5435,1909,8,3460,6164,16976,4748,1316,10,4073,6742,16889,88,135
5515,2380,5,3520,6181,17601,4969,1352,12,4259,6950,17542,88,136
4764,2341,13,3675,6266,17059,5011,1514,18,4338,6607,17488,88,137
2959,2195,71,3888,5032,14145,3487,1471,100,4418,4989,14465,88,138
508,1694,42,2902,2686,7832,794,1019,68,2923,1990,6794,88,139
387,1894,32,3064,2716,8093,646,855,20,2686,2043,6250,88,140
4218,1801,5,3443,5496,14963,4221,1065,12,3703,5461,14462,88,141
5556,2235,41,3565,6402,17799,5007,1379,37,4217,6913,17553,88,142
5186,2091,20,3358,6525,17180,5296,1309,22,4190,6886,17703,88,143
4488,2130,8,3341,5893,15860,4813,1320,14,4241,6331,16719,88,144
2557,2338,67,3682,4540,13184,3241,1598,98,4620,4757,14314,88,145
645,1776,53,3015,2551,8040,1028,1410,58,3329,2174,7999,88,146
534,2032,25,3111,2142,7844,670,1132,31,2917,2246,6996,88,147
397,2018,70,2531,2957,7973,752,704,23,2757,1890,6126,88,148
5055,1877,20,3252,5504,15708,4309,1120,17,3585,6079,15110,88,149
5365,1747,14,3166,5887,16179,4672,1168,22,3912,6516,16290,88,150
4647,2155,26,3134,5628,15590,4514,1441,33,3910,6367,16265,88,151
2975,1982,45,3132,4908,13042,3372,1410,74,4069,4798,13723,88,152
450,1548,55,2747,2316,7116,803,1019,69,2888,1990,6769,88,153
345,2001,14,2724,2469,7553,636,799,28,2567,1861,5891,88,154
4232,2017,13,3043,5362,14667,3986,1084,12,3404,5208,13694,88,155
5551,2159,16,3144,5988,16858,4742,1261,18,3782,6800,16603,88,156
5595,2088,8,3294,6408,17393,4950,1338,8,4002,7096,17394,88,157
5048,2293,9,3305,6059,16714,4464,1558,14,4050,6834,16920,88,158
3068,2324,76,3312,5176,13956,3144,1690,83,4158,4869,13944,88,159
538,2193,61,4320,3671,10783,920,2470,139,3342,3321,10192,88,160
388,2236,14,3213,2739,8590,658,1038,13,3055,2498,7262,88,161
4122,2056,12,3048,5294,14532,4054,1015,25,3723,5281,14098,88,162
5681,2246,17,3345,6560,17849,5480,1365,30,4174,6783,17832,88,163
5487,2172,14,3454,6709,17836,5373,1634,31,4413,6857,18308,88,164
4807,2243,7,3524,6142,16723,4972,1566,13,4459,6487,17497,88,165
2790,2063,117,3663,4826,13459,3655,1601,89,4473,4724,14542,88,166
496,1914,56,2889,2470,7825,920,1239,97,3305,2185,7746,88,167
398,2293,16,2766,2589,8062,583,883,25,2711,2060,6262,88,168
4159,1865,23,3075,5262,14384,3984,1079,26,3443,4924,13456,88,169
5348,1954,9,3224,5777,16312,4538,1455,20,4060,6503,16576,88,170
1065,1815,13,3009,3026,8928,1723,1029,32,3408,2548,8740,88,171
4428,1972,24,3249,5330,15003,4385,1507,21,3938,5822,15673,88,172
2599,2248,68,3185,4508,12608,3204,1533,75,3955,4582,13349,88,173
490,1826,47,2733,2249,7345,868,1224,117,2968,1842,7019,88,174
403,2029,11,2678,2570,7691,544,779,29,2573,1828,5753,88,175
4154,1862,23,2995,5081,14115,3738,1022,12,3554,4737,13063,88,176
5385,1939,11,3065,5856,16256,4361,1287,14,3790,6504,15956,88,177
5418,1996,14,3396,5927,16751,4628,1333,24,3878,6486,16349,88,178
4751,2545,13,3492,5750,16551,4488,1819,35,4191,6693,17226,88,179
2683,2152,57,3439,4573,12904,3346,1500,84,4330,4562,13822,88,180
513,1755,42,2814,2597,7721,867,1196,56,3346,2212,7677,88,181
328,2015,14,2426,2457,7240,551,837,31,2311,1671,5401,88,182
3992,1992,15,3305,5200,14504,3644,1069,31,3464,4808,13016,88,183
4965,1746,17,3315,5498,15541,4059,1229,27,3894,6038,15247,88,184
3816,2506,27,4020,4986,15355,3786,1625,57,4833,5639,15940,88,185
489,3286,22,3362,2711,9870,894,2776,44,3366,2907,9987,88,186
1476,1795,58,3496,3640,10465,2121,1164,82,4343,3295,11005,88,187
464,1779,108,2627,2498,7476,843,1054,63,3039,1995,6994,88,188
345,2277,3,2862,3003,8490,623,887,10,2725,2047,6292,88,189
3787,2332,13,3203,4966,14301,3942,1057,25,3543,4518,13085,88,190
4545,2103,10,3362,6117,16137,5073,1287,20,4173,5771,16324,88,191
4394,2126,15,3466,6280,16281,4896,1284,25,4412,6013,16630,88,192
4032,2310,10,3498,6054,15904,4866,1540,22,4368,5857,16653,88,193
2633,2193,70,3223,4593,12712,3392,1483,76,4040,4514,13505,88,194
501,1876,82,2925,2872,8256,863,1229,71,3526,2346,8035,88,195
347,2137,14,3034,2710,8242,686,868,13,2630,1973,6170,88,196
4093,1758,14,3330,4957,14152,3780,1111,20,3614,4843,13368,88,197
5423,1680,17,3115,5518,15753,4196,1185,21,3562,6261,15225,88,198
5247,1734,23,3224,5488,15716,4359,1197,24,3931,6463,15974,88,199
4647,2058,16,3220,5534,15475,4297,1433,23,4042,6292,16087,88,200
2591,2400,88,3478,4802,13359,3293,1658,98,4227,4593,13869,88,201
561,1675,55,3123,2844,8258,902,1374,79,3205,2076,7636,88,202
345,1706,6,3152,2757,7966,666,887,8,2969,2314,6844,88,203
3997,2290,11,3093,5079,14470,3865,1033,24,3602,4820,13344,88,204
5203,2042,11,3210,6361,16827,4687,1333,19,3986,6423,16448,88,205
4546,1967,6,4493,5854,16866,3910,1392,21,4624,6450,16397,88,206
4262,2162,13,3499,5930,15866,4601,1494,36,4354,6204,16689,88,207
2665,2164,68,3346,4963,13206,3286,1409,96,4547,4625,13963,88,208
501,1893,59,3137,2739,8329,890,1286,125,3381,2101,7783,88,209
334,2166,10,2933,2764,8207,582,896,30,2769,2087,6364,88,210
3928,1889,8,3189,5333,14347,3824,1037,31,3576,4925,13393,88,211
5223,1791,5,3052,5618,15689,4662,1088,14,3806,6225,15795,88,212
4983,1999,15,3065,5700,15762,4182,1268,19,4010,6282,15761,88,213
4396,2185,13,3296,5417,15307,4179,1356,16,3998,6103,15652,88,214
2538,1993,45,3248,4470,12294,3084,1583,74,3836,4426,13003,88,215
537,1430,89,2945,2405,7406,815,1013,79,3004,2146,7057,88,216
427,2090,8,2747,2450,7722,642,809,13,2708,2154,6326,88,217
3694,1881,12,2897,4553,13037,3237,1027,13,3367,4566,12210,88,218
5035,1587,23,3079,4917,14641,3773,1216,33,3576,5893,14491,88,219
4873,1677,6,2933,4979,14468,3551,1145,21,3728,5878,14323,88,220
4089,1649,6,2917,4566,13227,3436,1118,18,3598,5510,13680,88,221
2043,1640,98,2495,3708,9984,2330,1172,64,3239,3595,10400,88,222
401,1332,85,2626,2395,6839,842,965,58,2884,1745,6494,88,223
318,1785,5,2580,2398,7086,524,732,5,2485,1751,5497,88,224
3495,1655,26,2710,4041,11927,2896,870,29,3056,4288,11139,88,225
4721,1631,19,2667,4681,13719,3450,991,32,3267,5592,13332,88,226
4597,1686,58,2771,4867,13979,3487,1182,68,3428,5896,14061,88,227
3969,1750,43,2995,4538,13295,3385,1174,58,3525,5533,13675,88,228
2497,2120,51,2844,3723,11235,2595,1327,80,3685,4235,11922,88,229
419,1575,55,2657,2334,7040,811,1025,70,2818,1990,6714,88,230
327,1804,27,2539,2412,7109,484,653,33,2349,1874,5393,88,231
3267,1682,54,2998,4099,12100,2844,882,64,3152,4477,11419,88,232
4753,1606,36,3025,4630,14050,3359,1100,48,3337,5565,13409,88,233
4642,1590,50,2834,4922,14038,3457,1180,62,3485,5641,13825,88,234
4103,1699,29,2999,4513,13343,3310,1185,29,3571,5472,13567,88,235
2485,1881,66,3074,3909,11415,2634,1282,91,3781,4214,12002,88,236
519,1581,71,2738,2302,7211,759,1091,59,2847,1906,6662,88,237
321,1744,56,2679,2354,7154,565,832,46,2388,1803,5634,88,238
3709,1544,50,3065,4383,12751,3134,1028,40,3038,4525,11765,88,239
5097,1505,45,2826,5028,14501,3743,1150,46,3293,6140,14372,88,240
5089,1573,58,2780,5247,14747,3718,1186,65,3472,6319,14760,88,241
4240,1629,62,3099,4895,13925,3574,1285,62,3608,6222,14751,88,242
2517,2060,88,3344,4219,12228,2890,1504,84,4353,4420,13251,88,243
507,1464,83,2997,2457,7508,896,1131,89,3243,2037,7396,88,244
268,1901,30,3011,2228,7438,586,1105,28,2610,2263,6592,88,245
404,2200,9,2805,2987,8405,667,857,14,2613,1875,6026,88,246
5237,1619,65,3093,5566,15580,4104,1117,64,3311,6001,14597,88,247
5273,1714,43,2930,5721,15681,4138,1297,52,3638,6399,15524,88,248
4708,1859,60,2982,5591,15200,4155,1287,71,3595,6262,15370,88,249
2973,2035,64,2821,4660,12553,3165,1373,96,3481,4978,13093,88,250
466,1672,52,2924,2466,7580,791,1113,73,2898,2077,6952,88,251
348,1734,37,2854,2512,7485,547,746,40,2569,1887,5789,88,252
4384,1961,37,2947,5392,14721,4187,1040,45,3135,5161,13568,88,253
5627,1974,49,2992,6407,17049,5056,1391,58,3673,6629,16807,88,254
5384,2046,33,3141,6298,16902,5046,1387,39,3725,6679,16876,88,255
4874,2303,48,3224,6269,16718,4902,1651,63,4108,6697,17421,88,256
3135,2458,94,3407,5408,14502,3594,1693,95,4287,5714,15383,88,257
561,1672,116,3419,2824,8592,938,1326,74,3684,2247,8269,88,258
359,2027,84,3304,2361,8135,626,827,68,2961,2155,6637,88,259
4294,2063,97,3414,5537,15405,4248,1024,102,3561,5492,14427,88,260
5823,2073,43,3275,6833,18047,5519,1289,58,3960,7169,17995,88,261
5485,2211,65,3322,6844,17927,5282,1385,74,4079,6914,17734,88,262
5086,2201,48,3584,6588,17507,5441,1711,50,4569,6800,18571,88,263
3175,2672,49,3480,5294,14670,3877,1606,68,4528,5562,15641,88,264
633,3943,193,3477,5394,13640,922,1534,108,6043,5394,14001,88,265
335,2266,83,3050,2758,8492,586,911,89,3005,2074,6665,88,266
4508,2032,47,3212,5736,15535,4536,992,49,3613,5467,14657,88,267
5873,1888,48,3341,7021,18171,5128,1290,62,3971,7116,17567,88,268
5760,2368,78,3234,6752,18192,5269,1317,68,4257,7003,17914,88,269
5147,2348,56,3507,6507,17565,4840,1544,63,4343,7319,18109,88,270
3246,2392,75,3890,5519,15122,3772,1620,83,4572,5117,15164,88,271
568,1832,178,3282,2775,8635,893,1539,112,3369,2486,8399,88,272
348,2306,49,3015,2239,7957,584,846,53,3015,2137,6635,88,273
4528,1690,62,3326,5328,14934,3992,989,69,3488,5485,14023,88,274
6062,1807,83,3224,6020,17196,4669,1227,72,3645,6979,16592,88,275
5790,1802,75,3191,6534,17392,4758,1272,68,4039,6842,16979,88,276
4984,2088,77,3263,6077,16489,4316,1429,85,3929,6958,16717,88,277
3117,2230,68,3793,5335,14543,3699,1529,72,4535,5327,15162,88,278
538,1688,126,3239,2798,8389,928,1337,78,3377,2566,8286,88,279
433,2087,45,3273,2854,8692,646,986,31,3155,2179,6997,88,280
4451,1843,40,3640,5645,15619,4316,1125,42,3620,5515,14618,88,281
5914,2104,83,3555,6219,17875,4967,1381,84,4155,7165,17752,88,282
5767,1835,52,3585,6573,17812,5083,1707,68,4459,7569,18886,88,283
4860,2396,38,3427,6393,17114,4883,1776,57,4708,7188,18612,88,284
2660,2514,79,4404,5649,15306,3484,1758,98,5211,5145,15696,88,285
580,1701,123,3619,3204,9227,1121,1378,72,3991,2471,9033,88,286
484,2551,47,3356,3183,9621,649,1038,60,3473,2406,7626,88,287
1750,2361,30,3581,4129,11851,1959,960,29,3402,3077,9427,88,288
5741,1917,59,3862,6471,18050,4953,1460,63,4083,6880,17439,88,289
5853,1974,57,3652,6851,18387,4998,1324,61,4426,7351,18160,88,290
5237,2250,45,3783,6458,17773,4718,1731,64,4687,7244,18444,88,291
3176,2458,161,3791,5776,15362,3675,1775,123,4564,5862,15999,88,292
533,2098,177,3674,2956,9438,913,1722,124,3476,2502,8737,88,293
376,2033,30,3463,3068,8970,620,986,27,3080,2365,7078,88,294
4515,2019,12,3526,5682,15754,4223,1127,16,3677,5773,14816,88,295
5864,1884,13,3441,6451,17653,4969,1404,20,3976,6979,17348,88,296
5773,1867,11,3613,6659,17923,4962,1532,10,4028,7235,17767,88,297
5081,2259,65,3563,6314,17282,4937,1791,62,4339,7135,18264,88,298
3156,2469,127,3672,5435,14859,3690,1739,81,4692,5650,15852,88,299
622,1735,144,3599,3077,9177,1039,1379,77,3579,2527,8601,88,300
715,2054,44,3532,2861,9206,840,1048,52,3349,2732,8021,88,301
4321,1902,27,4001,5725,15976,4451,1173,27,4158,5469,15278,88,302
5682,2039,14,3923,6761,18419,4849,2176,15,4241,6513,17794,88,303
5787,1799,19,3602,6695,17902,4958,1551,24,4268,7455,18256,88,304
4598,1878,29,3399,5764,15668,4307,1432,33,4086,6334,16192,88,305
3120,2099,89,3525,5187,14020,3489,1540,89,4181,5329,14628,88,306
504,1628,57,3120,2552,7861,914,1306,98,3061,2487,7866,88,307
383,2275,12,3104,2700,8474,688,873,19,2846,2154,6580,88,308
4261,1779,10,3573,5285,14908,4120,1012,19,3326,5192,13669,88,309
3825,1964,45,3679,4813,14326,3605,1191,67,3630,4713,13206,88,310
4432,1487,16,3064,5277,14276,3801,1031,14,3300,5699,13845,88,311
4921,1778,34,3094,5721,15548,4441,1345,36,3601,6700,16123,88,312
3035,2094,59,3600,5241,14029,3471,1473,74,4535,5266,14819,88,313
521,1554,186,3363,2841,8465,933,1063,84,3756,2369,8205,88,314
371,1864,30,3268,2580,8113,601,806,27,2549,2272,6255,88,315
1633,1874,24,3215,3096,9842,1573,790,26,2920,2657,7966,88,316
6149,1843,29,3244,6339,17604,5075,1123,29,3621,6947,16795,88,317
6027,2203,35,3331,6576,18172,5422,1334,30,3928,7176,17890,88,318
5416,1993,33,3556,6511,17509,5157,1371,39,3929,7270,17766,88,319
3233,2235,64,3785,5490,14807,3825,1556,59,4347,5499,15286,88,320
504,1469,64,2872,2593,7502,738,1063,64,2724,2084,6673,88,321
383,1749,36,2796,2776,7740,482,838,41,2500,1907,5768,88,322
4738,1759,35,2972,5765,15269,4436,1042,31,3466,5505,14480,88,323
6307,1845,36,3391,6660,18239,5344,1291,31,3854,7316,17836,88,324
5818,2134,29,3105,6717,17803,5277,1343,26,4009,6976,17631,88,325
5233,1914,25,3566,6414,17152,5140,1592,28,4183,7361,18304,88,326
3192,1987,85,3610,5065,13939,3737,1613,80,4550,5579,15559,88,327
509,1405,125,2718,2338,7095,855,1110,67,3203,2121,7356,88,328
329,1427,17,2436,2249,6458,487,790,28,2602,1855,5762,88,329
3918,1564,47,3172,4881,13582,3626,1123,37,3950,5415,14151,88,330
4005,1586,25,3514,4971,14101,3688,1391,25,4401,6076,15581,88,331
1908,1678,17,3924,3856,11383,3054,1218,23,4998,4161,13454,88,332
287,632,16,1745,1154,3834,694,373,17,1574,635,3293,88,333
602,1618,117,3140,2712,8189,1236,786,45,2910,2040,7017,88,334
390,2307,124,3390,3273,9484,638,898,34,2828,2089,6487,88,335
339,2560,33,3886,3305,10123,504,810,36,2466,1936,5752,88,336
4599,2364,28,3716,5630,16337,4073,975,25,3405,5243,13721,88,337
6179,1956,36,3325,6392,17888,4913,1366,40,3486,6982,16787,88,338
5887,2157,32,3593,6747,18416,5244,1369,40,4151,7155,17959,88,339
5164,2094,24,3369,6489,17140,4694,1678,30,4000,7376,17778,88,340
3227,2053,102,3396,5651,14429,3658,1590,88,4358,5173,14867,88,341
469,1821,134,3146,2817,8387,735,1526,88,2904,2446,7699,88,342
339,1918,24,2891,3327,8499,485,891,23,2680,2183,6262,88,343
4679,1890,29,3245,5655,15498,4183,1189,30,3289,5458,14149,88,344
6195,2260,23,3520,6636,18634,5101,1493,30,3972,7514,18110,88,345
6139,2191,13,3434,6693,18470,5178,1430,15,4136,7384,18143,88,346
5568,2252,24,3835,6837,18516,5040,1918,22,4739,7556,19275,88,347
3284,2448,109,4129,5729,15699,3600,1758,91,5061,6123,16633,88,348
539,1739,110,3406,2863,8657,913,1263,75,3791,2788,8830,88,349
338,1726,40,2863,2711,7678,656,927,33,2954,1994,6564,88,350
4224,1902,29,3726,5444,15325,4008,1052,25,3780,5323,14188,88,351
5782,2072,50,3652,6171,17727,4773,1330,54,4335,6679,17171,88,352
5284,2001,25,3730,6151,17191,4966,1243,28,4314,6487,17038,88,353
4621,2154,33,3758,5813,16379,4520,1424,46,4236,6417,16643,88,354
2584,1929,83,3437,4475,12508,2947,1362,70,3929,4746,13054,88,355
353,1355,66,2593,2315,6682,691,814,24,3188,2091,6808,88,356
324,1217,12,1834,2023,5410,525,646,12,2422,1903,5508,88,357
1878,1318,9,2747,3084,9036,2032,759,14,3554,3430,9789,88,358
846,841,5,2121,1698,5511,1265,424,10,2451,1565,5715,88,359
124,771,6,930,734,2565,297,308,7,828,605,2045,88,360
1214,1432,21,2610,3183,8460,1430,636,25,2624,2252,6967,88,361
1374,1804,59,3074,3560,9871,1680,833,34,3423,2793,8763,88,362
330,1400,41,2622,2360,6753,629,720,43,2724,1562,5678,88,363
299,1350,25,2460,2155,6289,477,628,27,2361,1689,5182,88,364
1918,1526,17,3382,3869,10712,2353,931,20,3797,3251,10352,88,365
1587,1289,209,3134,2721,8940,1985,817,230,3366,2493,8891,88,366
63,38,1,177,97,376,38,114,12,126,162,452,89,1
666,71,5,312,198,1252,142,215,14,191,732,1294,89,2
796,86,2,292,215,1391,136,243,9,238,850,1476,89,3
789,86,4,271,212,1362,145,241,19,202,820,1427,89,4
541,73,7,257,268,1146,106,236,29,199,604,1174,89,5
88,52,5,203,107,455,39,166,18,121,171,515,89,6
75,56,2,245,96,474,34,185,10,117,183,529,89,7
747,69,4,273,186,1279,137,216,8,200,764,1325,89,8
864,61,5,237,134,1301,136,181,10,242,776,1345,89,9
949,97,7,311,207,1571,174,277,16,219,927,1613,89,10
871,67,5,310,249,1502,147,298,16,186,879,1526,89,11
451,69,3,280,194,997,117,189,22,186,431,945,89,12
75,54,3,456,141,729,29,216,23,167,302,737,89,13
54,46,2,196,81,379,28,114,5,113,155,415,89,14
105,61,14,212,138,530,83,144,25,120,193,565,89,15
255,77,17,185,129,663,139,152,15,131,231,668,89,16
803,74,5,307,199,1388,158,241,15,220,788,1422,89,17
875,77,4,279,219,1454,147,315,10,202,850,1524,89,18
324,65,9,249,132,779,82,148,30,172,359,791,89,19
94,53,6,259,153,565,48,157,26,183,193,607,89,20
61,45,3,182,130,421,21,131,12,110,200,474,89,21
713,76,2,271,199,1261,134,237,12,218,722,1323,89,22
945,76,3,289,179,1492,135,286,10,194,930,1555,89,23
961,84,3,303,212,1563,148,343,17,205,900,1613,89,24
867,93,2,293,227,1482,136,310,19,207,829,1501,89,25
670,90,4,323,255,1342,127,287,33,276,652,1375,89,26
96,84,4,401,190,775,40,229,19,218,326,832,89,27
65,65,3,211,91,435,24,141,8,160,172,505,89,28
769,76,0,257,184,1286,145,249,11,166,753,1324,89,29
1006,99,2,293,176,1576,138,304,12,186,940,1580,89,30
1011,78,3,289,215,1596,144,305,13,205,939,1606,89,31
920,84,3,309,210,1526,144,291,21,222,848,1526,89,32
642,84,4,293,272,1295,133,267,24,253,641,1318,89,33
106,93,7,362,207,775,48,214,28,214,315,819,89,34
84,56,2,288,120,550,35,173,9,189,195,601,89,35
743,94,1,247,180,1265,125,243,6,193,793,1360,89,36
981,69,9,308,223,1590,148,283,19,199,949,1598,89,37
989,83,1,298,209,1580,141,281,8,225,981,1636,89,38
857,101,3,295,221,1477,144,320,9,226,830,1529,89,39
586,94,5,272,250,1207,111,241,36,231,636,1255,89,40
104,70,4,376,192,746,48,272,37,186,252,795,89,41
72,47,8,234,118,479,26,138,21,122,199,506,89,42
731,89,3,268,174,1265,134,208,12,226,722,1302,89,43
865,95,2,281,202,1445,154,325,5,202,855,1541,89,44
902,88,14,267,231,1502,164,309,16,224,837,1550,89,45
878,91,4,312,221,1506,164,315,13,214,833,1539,89,46
517,95,9,345,261,1227,146,210,30,248,568,1202,89,47
112,68,16,361,158,715,46,199,35,205,274,759,89,48
94,62,5,285,130,576,25,169,16,170,235,615,89,49
206,91,7,307,199,810,98,181,16,222,322,839,89,50
938,101,9,273,239,1560,153,306,17,227,950,1653,89,51
1005,83,2,340,221,1651,170,291,8,259,933,1661,89,52
865,81,2,307,226,1481,158,302,11,225,836,1532,89,53
557,96,22,276,191,1142,106,227,36,201,587,1157,89,54
136,76,12,378,192,794,62,215,16,234,267,794,89,55
89,75,1,248,101,514,42,160,9,139,184,534,89,56
791,91,8,272,221,1383,154,254,12,214,807,1441,89,57
965,90,6,319,193,1573,155,285,10,227,919,1596,89,58
961,92,4,260,186,1503,177,285,10,202,914,1588,89,59
891,102,3,313,176,1485,159,289,18,244,825,1535,89,60
575,93,4,320,250,1242,127,263,25,231,642,1288,89,61
109,97,6,307,184,703,52,215,23,174,249,713,89,62
79,57,4,283,137,560,39,152,15,154,216,576,89,63
787,84,7,291,201,1370,135,237,16,186,829,1403,89,64
950,98,3,314,192,1557,143,292,13,197,955,1600,89,65
1011,81,1,319,215,1627,178,333,12,232,952,1707,89,66
932,102,11,298,224,1567,175,342,35,216,887,1655,89,67
590,110,3,344,250,1297,119,278,30,222,646,1295,89,68
128,88,2,337,178,733,48,274,14,204,237,777,89,69
100,67,2,263,123,555,51,157,6,146,284,644,89,70
745,96,8,287,210,1346,155,239,18,187,752,1351,89,71
994,112,6,372,188,1672,173,325,12,214,1030,1754,89,72
1031,109,3,395,230,1768,171,371,13,264,1009,1828,89,73
887,125,4,436,281,1733,173,361,15,260,950,1759,89,74
620,118,17,394,246,1395,139,302,38,243,679,1401,89,75
198,124,7,564,309,1202,63,364,58,272,462,1219,89,76
102,83,3,377,171,736,40,246,16,176,312,790,89,77
800,85,2,340,222,1449,162,267,13,242,846,1530,89,78
1010,107,1,316,244,1678,158,339,5,219,996,1717,89,79
1059,124,2,378,283,1846,158,376,12,287,990,1823,89,80
929,120,2,414,264,1729,160,394,11,268,962,1795,89,81
639,126,4,473,336,1578,140,399,31,308,737,1615,89,82
114,87,4,330,221,756,53,264,32,175,260,784,89,83
127,85,3,582,181,978,47,302,10,221,442,1022,89,84
771,97,4,465,287,1624,164,328,12,224,897,1625,89,85
996,102,14,512,304,1928,179,442,9,240,1042,1912,89,86
968,84,3,336,235,1626,152,334,11,215,927,1639,89,87
835,97,8,427,238,1605,151,381,13,252,794,1591,89,88
582,98,5,564,303,1552,121,340,28,313,723,1525,89,89
204,97,33,850,274,1458,67,432,68,330,583,1480,89,90
118,94,2,412,157,783,44,255,13,191,333,836,89,91
784,123,5,465,258,1635,184,379,15,246,809,1633,89,92
979,88,3,431,236,1737,189,383,7,270,963,1812,89,93
967,121,21,390,247,1746,163,381,22,219,998,1783,89,94
954,134,11,480,286,1865,196,419,28,249,1028,1920,89,95
634,131,5,483,323,1576,135,346,44,281,777,1583,89,96
169,105,8,546,268,1096,70,343,42,276,430,1161,89,97
163,79,3,403,168,816,60,272,8,234,308,882,89,98
787,88,10,319,227,1431,163,269,24,235,762,1453,89,99
989,154,6,330,243,1722,186,373,39,240,1023,1861,89,100
966,136,9,385,295,1791,194,393,27,295,972,1881,89,101
937,131,4,356,268,1696,172,389,24,248,878,1711,89,102
628,111,1,343,307,1390,141,362,16,287,662,1468,89,103
190,119,5,589,271,1174,63,400,42,287,405,1197,89,104
116,83,17,404,155,775,36,240,25,197,333,831,89,105
826,105,12,330,248,1521,200,303,18,231,725,1477,89,106
1000,93,3,370,248,1714,192,398,8,265,950,1813,89,107
1062,104,4,397,264,1831,194,373,20,239,1007,1833,89,108
992,117,4,381,275,1769,178,438,12,280,902,1810,89,109
661,118,13,356,312,1460,159,347,44,273,674,1497,89,110
132,100,5,606,290,1133,83,403,45,226,445,1202,89,111
90,91,4,305,111,601,49,203,9,159,253,673,89,112
796,98,1,284,214,1393,172,262,7,223,809,1473,89,113
1028,109,18,322,271,1748,163,412,23,235,961,1794,89,114
999,105,9,358,301,1772,190,413,18,254,957,1832,89,115
994,118,4,395,268,1779,165,418,14,328,936,1861,89,116
654,119,2,363,315,1453,151,352,29,261,689,1482,89,117
173,97,12,389,230,901,84,239,78,251,289,941,89,118
120,67,3,338,157,685,61,219,29,187,271,767,89,119
809,98,8,351,208,1474,173,298,9,232,822,1534,89,120
1022,114,1,348,260,1745,176,380,7,252,984,1799,89,121
1032,116,4,352,237,1741,203,363,14,259,969,1808,89,122
960,108,7,338,267,1680,200,345,28,243,902,1718,89,123
659,136,14,377,318,1504,160,347,35,296,680,1518,89,124
130,94,9,408,190,831,76,255,33,192,293,849,89,125
87,80,7,283,127,584,52,214,15,146,243,670,89,126
811,109,1,334,211,1466,168,280,6,246,808,1508,89,127
1027,105,4,312,305,1753,183,418,8,250,999,1858,89,128
1026,118,6,367,308,1825,195,440,24,274,1001,1934,89,129
941,112,9,357,259,1678,188,353,18,240,960,1759,89,130
621,107,4,337,267,1336,135,342,28,240,676,1421,89,131
179,108,12,488,197,984,71,275,30,297,433,1106,89,132
103,78,3,304,123,611,44,210,9,186,263,712,89,133
858,92,13,333,233,1529,168,312,22,257,791,1550,89,134
1017,111,6,293,221,1648,190,311,16,229,997,1743,89,135
1019,113,2,309,296,1739,167,402,12,244,981,1806,89,136
967,119,1,383,250,1720,166,394,15,242,925,1742,89,137
643,124,3,341,264,1375,135,376,38,259,659,1467,89,138
125,89,5,398,190,807,66,279,31,211,279,866,89,139
136,83,10,283,147,659,45,222,26,216,262,771,89,140
825,116,10,353,244,1548,190,353,15,244,815,1617,89,141
1046,118,14,348,293,1819,170,385,25,259,1081,1920,89,142
1019,130,9,383,293,1834,203,392,14,244,1044,1897,89,143
924,132,12,348,313,1729,184,343,17,289,940,1773,89,144
533,118,6,401,312,1370,155,322,21,279,561,1338,89,145
175,118,10,502,281,1086,68,399,44,215,353,1079,89,146
142,98,5,448,160,853,44,287,30,232,378,971,89,147
114,83,9,392,173,771,61,223,22,239,281,826,89,148
988,103,13,356,263,1723,195,337,17,264,954,1767,89,149
1068,120,14,334,245,1781,183,358,26,270,995,1832,89,150
996,108,13,386,266,1769,185,375,30,263,961,1814,89,151
651,138,7,343,307,1446,139,353,37,304,661,1494,89,152
150,113,8,410,246,927,78,322,37,227,319,983,89,153
112,81,3,322,153,671,38,236,7,183,292,756,89,154
835,106,4,350,273,1568,183,314,21,239,890,1647,89,155
1085,114,5,358,291,1853,205,393,14,287,1021,1920,89,156
1020,118,6,364,287,1795,176,407,16,292,1016,1907,89,157
957,116,4,371,370,1818,195,390,35,267,979,1866,89,158
672,133,3,377,399,1584,153,427,62,247,743,1632,89,159
155,140,6,733,478,1512,77,700,60,267,458,1562,89,160
129,111,12,484,216,952,50,327,23,218,406,1024,89,161
887,116,17,342,256,1618,190,337,23,270,900,1720,89,162
1076,131,17,391,255,1870,190,394,31,256,1069,1940,89,163
1070,129,8,442,291,1940,186,444,31,313,1034,2008,89,164
1003,136,9,377,259,1784,181,373,27,282,918,1781,89,165
655,119,9,374,386,1543,152,407,57,269,689,1574,89,166
163,152,6,415,257,993,76,318,26,203,317,940,89,167
89,102,13,342,138,684,47,226,15,209,267,764,89,168
798,122,16,338,232,1506,166,282,24,275,864,1611,89,169
1011,114,7,389,313,1834,184,438,17,271,970,1880,89,170
367,117,5,448,311,1248,137,347,12,274,475,1245,89,171
832,146,4,370,280,1632,177,342,22,241,834,1616,89,172
632,124,12,349,246,1363,149,300,49,247,650,1395,89,173
151,141,5,356,265,918,76,374,53,246,268,1017,89,174
128,81,9,278,188,684,62,233,32,168,269,764,89,175
825,115,13,327,273,1553,191,364,17,231,774,1577,89,176
1047,121,11,361,228,1768,190,360,20,239,1027,1836,89,177
1063,108,9,350,291,1821,193,377,17,226,1016,1829,89,178
974,115,4,427,273,1793,185,442,19,273,934,1853,89,179
619,149,6,427,312,1513,145,348,42,303,702,1540,89,180
172,127,4,424,246,973,61,341,34,284,350,1070,89,181
105,92,3,307,211,718,47,222,10,230,276,785,89,182
797,128,5,381,263,1574,167,317,14,239,897,1634,89,183
931,103,7,374,289,1704,178,378,13,233,955,1757,89,184
785,154,4,392,408,1743,183,446,28,333,773,1763,89,185
151,687,8,650,758,2254,54,1337,66,346,393,2196,89,186
389,111,10,411,247,1168,138,330,43,245,501,1257,89,187
138,119,3,406,167,833,67,292,32,195,336,922,89,188
101,89,9,299,134,632,45,223,18,183,248,717,89,189
753,117,45,356,223,1494,184,336,41,243,774,1578,89,190
943,104,5,337,238,1627,221,342,10,257,905,1735,89,191
997,117,4,321,242,1681,172,362,16,287,902,1739,89,192
904,134,4,378,253,1673,165,385,20,269,896,1735,89,193
666,122,3,343,252,1386,148,321,36,250,632,1387,89,194
149,167,4,481,294,1095,70,390,42,271,376,1149,89,195
111,82,9,316,170,688,50,243,27,195,240,755,89,196
820,103,7,334,182,1446,173,349,13,168,715,1418,89,197
977,102,6,295,236,1616,193,350,20,231,873,1667,89,198
993,116,7,336,233,1685,200,316,9,259,966,1750,89,199
953,141,12,384,251,1741,188,373,36,240,917,1754,89,200
620,156,17,344,298,1435,165,303,83,262,699,1512,89,201
161,105,14,414,298,992,68,393,55,237,338,1091,89,202
113,79,2,377,163,734,58,227,10,223,293,811,89,203
763,111,6,347,205,1432,148,371,13,237,779,1548,89,204
1004,128,32,374,255,1793,180,355,38,260,1016,1849,89,205
937,122,18,404,275,1756,168,394,40,227,994,1823,89,206
933,141,4,403,211,1692,161,391,17,245,914,1728,89,207
617,128,7,347,324,1423,158,377,57,251,666,1509,89,208
136,122,8,437,285,988,46,327,86,212,383,1054,89,209
103,84,8,286,163,644,59,227,23,188,255,752,89,210
755,108,17,335,277,1492,159,292,50,258,820,1579,89,211
1012,125,9,359,217,1722,173,347,20,258,964,1762,89,212
969,129,9,392,283,1782,204,388,18,274,983,1867,89,213
886,146,13,343,253,1641,174,364,22,249,823,1632,89,214
650,121,6,347,302,1426,162,355,49,321,645,1532,89,215
146,91,3,490,210,940,42,312,40,253,339,986,89,216
113,86,5,354,149,707,47,242,13,242,302,846,89,217
746,122,4,337,266,1475,162,337,11,276,742,1528,89,218
966,139,41,383,272,1801,186,378,39,296,944,1843,89,219
1008,129,6,364,268,1775,207,388,14,274,927,1810,89,220
886,125,9,346,247,1613,210,338,34,250,839,1671,89,221
496,108,22,312,287,1225,129,327,58,165,576,1255,89,222
131,143,6,407,233,920,57,367,43,225,313,1005,89,223
124,101,21,375,161,782,61,233,25,221,271,811,89,224
793,118,14,362,247,1534,221,296,22,304,803,1646,89,225
1031,137,3,351,285,1807,234,369,15,288,1037,1943,89,226
1001,143,14,374,264,1796,202,344,30,235,998,1809,89,227
898,130,10,336,259,1633,225,336,25,263,847,1696,89,228
647,124,25,314,256,1366,145,296,64,285,603,1393,89,229
119,91,14,402,206,832,75,267,41,204,301,888,89,230
104,97,25,269,122,617,47,221,33,148,260,709,89,231
778,105,1,314,251,1449,155,300,5,223,836,1519,89,232
992,107,3,352,305,1759,178,392,31,245,991,1837,89,233
965,114,9,293,307,1688,202,351,36,219,998,1806,89,234
863,125,2,362,275,1627,145,358,18,221,909,1651,89,235
603,139,5,376,264,1387,138,327,42,266,668,1441,89,236
169,102,5,413,249,938,67,336,30,227,352,1012,89,237
95,80,5,343,134,657,46,216,10,216,248,736,89,238
815,105,6,316,251,1493,184,313,8,222,839,1566,89,239
1049,131,4,313,307,1804,195,371,21,245,1078,1910,89,240
956,118,9,346,293,1722,176,417,16,230,998,1837,89,241
917,104,11,348,229,1609,188,326,35,248,916,1713,89,242
493,97,5,346,257,1198,129,246,41,297,530,1243,89,243
128,82,2,444,226,882,58,328,33,234,338,991,89,244
90,89,6,418,164,767,54,244,12,185,322,817,89,245
113,63,9,330,128,643,55,217,12,213,282,779,89,246
1027,110,6,335,213,1691,196,345,13,246,1022,1822,89,247
1057,107,4,343,224,1735,195,364,17,254,1011,1841,89,248
964,102,3,347,213,1629,150,331,15,245,922,1663,89,249
669,138,15,328,283,1433,141,319,44,261,763,1528,89,250
120,104,3,396,228,851,64,280,52,222,314,932,89,251
105,82,18,295,161,661,53,249,25,194,217,738,89,252
845,88,11,327,228,1499,183,289,16,268,839,1595,89,253
1084,114,12,346,244,1800,199,385,18,296,999,1897,89,254
1052,116,5,350,290,1813,208,421,13,253,980,1875,89,255
988,115,8,368,301,1780,170,411,28,297,942,1848,89,256
646,116,4,352,356,1474,162,351,51,276,741,1581,89,257
155,133,5,457,267,1017,61,352,36,259,361,1069,89,258
111,88,2,368,144,713,52,240,9,214,307,822,89,259
838,89,5,333,227,1492,176,300,20,271,768,1535,89,260
1062,93,6,340,203,1704,196,319,12,249,1037,1813,89,261
1036,114,6,346,300,1802,195,419,18,263,994,1889,89,262
1027,118,9,402,305,1861,185,404,23,294,953,1859,89,263
666,126,4,377,283,1456,160,309,45,323,687,1524,89,264
159,103,5,481,251,999,65,351,38,230,340,1024,89,265
96,68,5,320,180,669,39,209,14,214,275,751,89,266
909,100,8,367,226,1610,210,281,18,280,876,1665,89,267
1063,109,10,348,241,1771,178,388,20,262,1017,1865,89,268
1047,108,14,348,283,1800,211,386,31,220,1006,1854,89,269
977,119,8,415,313,1832,188,426,22,250,1007,1893,89,270
649,123,10,360,285,1427,147,311,46,287,664,1455,89,271
161,150,8,542,289,1150,65,405,67,293,373,1203,89,272
90,72,5,333,152,652,49,258,13,209,212,741,89,273
837,109,7,312,196,1461,164,302,9,228,890,1593,89,274
1096,99,12,329,224,1760,189,370,18,259,1001,1837,89,275
1074,97,8,376,242,1797,203,356,19,289,1027,1894,89,276
1006,129,4,372,275,1786,178,394,23,254,970,1819,89,277
677,153,7,358,324,1519,160,286,56,265,761,1528,89,278
133,96,8,442,276,955,48,322,40,231,359,1000,89,279
102,71,3,349,167,692,48,181,13,184,329,755,89,280
874,108,3,355,228,1568,199,282,19,286,880,1666,89,281
1102,109,6,349,223,1789,192,374,18,258,1011,1853,89,282
1064,122,5,390,249,1830,209,344,14,258,1071,1896,89,283
724,127,9,367,250,1477,160,319,16,255,936,1686,89,284
589,127,8,381,311,1416,158,334,35,278,656,1461,89,285
232,114,7,551,273,1177,68,361,36,324,397,1186,89,286
247,73,3,411,180,914,68,238,24,374,297,1001,89,287
350,108,3,404,200,1065,152,215,8,251,492,1118,89,288
1132,113,13,340,272,1870,206,420,20,276,1059,1981,89,289
1114,129,9,395,235,1882,182,386,17,285,1077,1947,89,290
1023,119,2,365,242,1751,207,377,16,281,958,1839,89,291
691,132,6,350,286,1465,170,336,59,286,736,1587,89,292
159,135,8,429,278,1009,66,263,50,230,386,995,89,293
92,76,5,377,159,709,53,291,37,170,303,854,89,294
915,102,2,373,224,1616,171,372,9,255,882,1689,89,295
1123,114,12,384,250,1883,177,436,19,262,1028,1922,89,296
1049,108,10,367,317,1851,169,448,23,270,1047,1957,89,297
1016,123,9,416,294,1858,173,442,18,261,952,1846,89,298
670,123,9,426,322,1550,153,344,56,297,797,1647,89,299
155,145,40,496,241,1077,65,284,83,297,377,1106,89,300
392,75,16,415,179,1077,106,247,27,382,450,1212,89,301
834,108,13,340,225,1520,179,290,27,285,866,1647,89,302
1068,131,7,412,380,1998,177,570,24,287,1013,2071,89,303
1111,105,6,344,260,1826,204,387,31,242,1058,1922,89,304
978,145,7,328,262,1720,199,352,24,295,954,1824,89,305
635,130,10,381,278,1434,138,289,38,298,690,1453,89,306
132,101,4,475,235,947,57,345,33,276,328,1039,89,307
127,77,13,363,161,741,55,227,12,255,273,822,89,308
869,105,10,384,246,1614,207,287,11,307,880,1692,89,309
895,112,10,310,233,1560,207,281,19,268,862,1637,89,310
942,122,12,346,261,1683,206,326,16,270,887,1705,89,311
976,129,4,309,222,1640,178,343,10,243,928,1702,89,312
594,119,13,386,297,1409,159,325,41,293,624,1442,89,313
142,127,8,428,242,947,73,252,42,268,364,999,89,314
97,77,6,364,152,696,47,202,19,231,312,811,89,315
365,91,2,372,230,1060,139,257,17,250,498,1161,89,316
1087,97,9,336,224,1753,198,327,22,249,1034,1830,89,317
1052,109,8,337,258,1764,165,357,16,307,1019,1864,89,318
1019,120,5,366,245,1755,191,370,22,295,986,1864,89,319
704,127,4,354,257,1446,178,298,31,259,756,1522,89,320
167,82,6,451,178,884,62,216,28,261,362,929,89,321
99,80,4,292,157,632,30,202,9,193,249,683,89,322
848,104,11,315,258,1536,204,257,23,280,880,1644,89,323
1070,124,9,289,243,1735,178,338,12,246,1043,1817,89,324
1043,109,7,358,236,1753,195,347,20,274,1014,1850,89,325
998,122,6,345,279,1750,240,356,21,265,959,1841,89,326
657,115,4,305,222,1303,143,260,45,267,668,1383,89,327
132,120,6,411,251,920,67,293,39,224,297,920,89,328
100,75,2,288,153,618,44,194,12,193,264,707,89,329
741,109,5,320,241,1416,175,253,23,234,799,1484,89,330
812,100,8,329,241,1490,192,268,19,253,827,1559,89,331
573,96,14,493,253,1429,182,255,25,438,514,1414,89,332
92,58,5,162,58,375,38,96,11,162,131,438,89,333
195,81,4,444,142,866,103,220,16,236,403,978,89,334
107,78,5,333,181,704,67,207,22,226,290,812,89,335
86,85,6,292,125,594,42,202,13,200,262,719,89,336
787,126,4,278,228,1423,149,279,19,261,784,1492,89,337
989,115,6,283,272,1665,168,358,14,247,1041,1828,89,338
980,106,11,316,237,1650,156,324,11,274,1014,1779,89,339
890,125,6,268,270,1559,172,329,21,242,882,1646,89,340
633,113,6,369,276,1397,128,304,47,283,732,1494,89,341
143,123,5,427,279,977,77,370,50,241,294,1032,89,342
97,72,6,291,178,644,47,213,23,201,233,717,89,343
764,112,7,296,195,1374,159,258,26,207,807,1457,89,344
1044,106,5,343,242,1740,186,381,12,244,951,1774,89,345
1019,106,2,282,197,1606,183,332,17,209,929,1670,89,346
958,117,5,355,261,1696,167,371,23,299,896,1756,89,347
617,127,8,363,304,1419,164,297,41,319,678,1499,89,348
213,117,7,462,284,1083,71,301,43,343,391,1149,89,349
96,62,3,271,133,565,42,212,14,170,248,686,89,350
749,126,17,287,225,1404,169,267,25,274,777,1512,89,351
1003,127,4,306,274,1714,234,302,30,227,1024,1817,89,352
949,97,11,326,235,1618,185,301,20,252,953,1711,89,353
832,113,5,319,260,1529,175,293,22,264,862,1616,89,354
542,102,1,355,309,1309,148,284,28,285,534,1279,89,355
116,99,7,340,181,743,65,212,24,183,275,759,89,356
66,72,5,309,168,620,41,174,18,159,236,628,89,357
395,93,4,351,240,1083,132,258,14,199,491,1094,89,358
213,55,14,269,95,646,132,117,17,201,202,669,89,359
42,39,5,111,50,247,30,79,15,57,77,258,89,360
275,62,2,326,150,815,120,215,11,193,351,890,89,361
300,91,4,335,191,921,115,194,28,233,370,940,89,362
92,100,3,276,158,629,48,198,24,166,243,679,89,363
72,76,1,250,139,538,34,159,17,150,243,603,89,364
449,90,3,435,206,1183,179,225,17,315,535,1271,89,365
320,180,44,363,203,1110,134,207,132,256,392,1121,89,366
72,96,2,427,208,805,41,210,4,287,312,854,90,1
764,196,7,727,680,2374,383,340,9,535,1012,2279,90,2
1021,200,14,730,899,2864,497,470,18,573,1204,2762,90,3
1075,244,5,916,960,3200,494,472,11,697,1311,2985,90,4
734,254,16,859,955,2818,418,509,48,697,979,2651,90,5
166,182,23,592,365,1328,93,349,34,442,416,1334,90,6
129,142,5,801,439,1516,64,325,18,522,571,1500,90,7
993,360,2,986,1083,3424,498,515,7,851,1335,3206,90,8
1252,220,7,776,841,3096,547,373,11,843,1234,3008,90,9
1348,407,6,1034,1246,4041,565,595,14,990,1680,3844,90,10
1230,365,8,1040,1226,3869,578,618,31,896,1507,3630,90,11
767,269,10,1094,938,3078,474,446,49,735,1041,2745,90,12
164,226,8,1028,589,2015,98,426,52,573,766,1915,90,13
117,185,2,701,414,1419,63,307,10,509,506,1395,90,14
186,154,4,728,460,1532,108,337,7,492,550,1494,90,15
460,261,7,595,609,1932,193,392,25,512,691,1813,90,16
1101,349,12,995,1013,3470,429,570,19,803,1446,3267,90,17
1287,349,21,951,1115,3723,555,703,48,834,1393,3533,90,18
439,327,16,620,611,2013,222,411,58,490,726,1907,90,19
157,263,8,805,536,1769,82,475,50,560,525,1692,90,20
116,149,21,729,434,1449,67,361,26,529,511,1494,90,21
1094,320,7,945,1015,3381,518,533,13,874,1346,3284,90,22
1445,352,11,979,1080,3867,586,594,15,850,1648,3693,90,23
1410,411,5,1019,1107,3952,568,694,14,850,1604,3730,90,24
1302,364,6,1031,1094,3797,561,733,10,841,1445,3590,90,25
795,409,19,1049,1034,3306,492,611,64,766,1115,3048,90,26
175,271,10,1103,644,2203,115,472,53,671,782,2093,90,27
137,137,12,842,444,1572,78,336,18,545,619,1596,90,28
1151,328,14,911,943,3347,472,519,23,857,1456,3327,90,29
1437,330,18,939,1151,3875,583,613,23,843,1608,3670,90,30
1420,364,8,1047,1123,3962,600,678,11,881,1614,3784,90,31
1344,382,13,954,1121,3814,541,691,14,842,1567,3655,90,32
820,345,16,921,1015,3117,424,565,76,710,1073,2848,90,33
360,1301,187,1785,2436,6069,583,1068,33,3568,1915,7167,90,34
300,932,30,1543,2153,4958,406,547,15,2711,1369,5048,90,35
1118,308,11,870,956,3263,531,488,16,777,1372,3184,90,36
1474,417,3,910,1069,3873,567,679,5,857,1653,3761,90,37
1444,380,14,1001,1092,3931,591,700,20,845,1607,3763,90,38
1331,334,14,938,1078,3695,588,611,22,792,1481,3494,90,39
839,384,21,859,996,3099,454,609,52,739,1130,2984,90,40
190,332,34,1080,730,2366,118,516,54,764,825,2277,90,41
135,275,5,837,504,1756,70,478,15,523,688,1774,90,42
1102,281,13,956,968,3320,489,515,11,813,1374,3202,90,43
1346,323,7,914,1116,3706,494,660,9,833,1491,3487,90,44
1416,382,5,956,1121,3880,521,701,10,840,1634,3706,90,45
1300,334,4,1009,1011,3658,526,663,19,849,1546,3603,90,46
749,346,85,997,945,3122,418,618,124,754,970,2884,90,47
284,231,20,893,557,1985,169,402,53,572,575,1771,90,48
178,171,9,752,482,1592,69,338,16,513,602,1538,90,49
302,175,18,840,485,1820,172,416,25,558,644,1815,90,50
1408,339,4,938,1076,3765,600,622,9,839,1534,3604,90,51
1384,365,1,1045,1030,3825,557,683,8,956,1531,3735,90,52
1280,386,2,898,1093,3659,569,646,15,778,1523,3531,90,53
798,349,22,1005,828,3002,445,517,51,738,1060,2811,90,54
578,1142,29,3547,2244,7540,575,2054,282,2455,3171,8537,90,55
387,568,7,2525,1651,5138,377,1553,25,2091,2298,6344,90,56
1093,381,4,903,1099,3480,513,566,12,806,1452,3349,90,57
1444,348,2,1003,1060,3857,579,651,13,927,1565,3735,90,58
1465,309,5,962,1102,3843,546,620,12,904,1565,3647,90,59
1327,356,14,1030,1069,3796,563,680,21,851,1465,3580,90,60
866,287,22,873,1031,3079,493,589,58,703,1109,2952,90,61
178,317,6,1051,2531,4083,82,478,44,2405,879,3888,90,62
142,127,4,817,391,1481,79,341,5,540,586,1551,90,63
1119,284,17,799,797,3016,408,623,22,591,1329,2973,90,64
1424,222,12,877,941,3476,488,697,18,595,1516,3314,90,65
1469,250,12,893,930,3554,515,678,17,672,1453,3335,90,66
1271,298,15,921,989,3494,463,767,30,650,1380,3290,90,67
830,431,18,940,989,3208,403,711,64,728,1150,3056,90,68
169,205,3,903,526,1806,79,466,40,595,580,1760,90,69
122,167,3,813,433,1538,65,372,10,526,653,1626,90,70
1017,339,1,889,936,3182,509,632,9,728,1264,3142,90,71
1330,380,3,1001,1106,3820,515,757,13,872,1540,3697,90,72
1366,381,2,1089,1169,4007,525,750,18,962,1575,3830,90,73
1130,335,6,1133,1196,3800,532,788,33,846,1442,3641,90,74
732,349,8,1065,1053,3207,440,643,69,840,1041,3033,90,75
250,337,13,1348,793,2741,126,648,57,867,898,2596,90,76
145,163,7,931,490,1736,76,420,14,560,698,1768,90,77
1127,339,18,983,1034,3501,487,608,22,874,1467,3458,90,78
1450,408,24,1026,1139,4047,558,755,20,892,1691,3916,90,79
1477,385,29,1135,1239,4265,547,886,30,1049,1644,4156,90,80
1418,366,9,1099,1199,4091,563,846,19,933,1526,3887,90,81
937,388,10,1057,1100,3492,481,731,49,793,1233,3287,90,82
157,352,8,889,644,2050,97,554,57,493,667,1868,90,83
180,159,4,1124,560,2027,94,450,12,710,809,2075,90,84
1116,334,5,1019,868,3342,444,660,9,851,1388,3352,90,85
1404,317,4,1061,1103,3889,490,685,8,942,1562,3687,90,86
1347,373,3,1051,944,3718,483,708,10,894,1557,3652,90,87
1242,398,9,1105,1046,3800,512,761,15,903,1513,3704,90,88
782,385,18,1171,1126,3482,427,783,61,834,1137,3242,90,89
156,309,8,1307,772,2552,106,678,49,663,857,2353,90,90
185,185,6,874,482,1732,68,451,10,585,584,1698,90,91
1032,319,9,1067,908,3335,417,673,13,818,1387,3308,90,92
1431,305,5,975,1113,3829,551,642,9,846,1604,3652,90,93
1388,352,10,910,1124,3784,563,675,23,823,1507,3591,90,94
1330,417,0,1080,1303,4130,611,864,8,1042,1568,4093,90,95
841,445,16,1047,1095,3444,418,738,56,850,1177,3239,90,96
243,291,7,1052,719,2312,116,617,42,789,729,2293,90,97
288,171,15,999,506,1979,114,480,20,737,668,2019,90,98
1089,305,9,1054,893,3350,522,602,14,816,1333,3287,90,99
1421,398,8,996,1054,3877,586,755,16,812,1597,3766,90,100
1444,346,3,1182,1035,4010,531,759,9,967,1592,3858,90,101
1365,325,8,1093,1086,3877,508,750,15,860,1463,3596,90,102
940,519,14,1047,1005,3525,391,765,43,852,1271,3322,90,103
237,356,16,1088,779,2476,129,607,56,686,842,2320,90,104
172,176,17,1027,479,1871,76,455,21,727,689,1968,90,105
1053,350,4,928,1089,3424,485,681,13,836,1228,3243,90,106
1277,240,3,919,959,3398,473,760,12,719,1328,3292,90,107
1358,458,7,1098,1106,4027,551,873,13,917,1509,3863,90,108
1194,477,7,1042,1109,3829,522,914,12,864,1400,3712,90,109
842,350,92,976,953,3213,391,672,119,784,1027,2993,90,110
345,357,42,1138,720,2602,221,668,85,727,754,2455,90,111
183,203,19,762,455,1622,94,363,25,571,570,1623,90,112
1103,310,6,861,872,3152,492,510,14,697,1277,2990,90,113
1401,320,3,948,1027,3699,536,739,9,749,1522,3555,90,114
1456,375,5,1049,1128,4013,535,788,5,906,1512,3746,90,115
1317,307,3,1083,1075,3785,485,756,14,863,1460,3578,90,116
823,400,35,994,1049,3301,387,769,83,761,1094,3094,90,117
249,282,15,1075,587,2208,134,520,56,706,631,2047,90,118
165,170,8,938,509,1790,77,406,37,673,689,1882,90,119
1095,274,4,923,879,3175,493,573,10,681,1285,3042,90,120
1442,296,8,964,1002,3712,589,641,14,745,1526,3515,90,121
1484,310,1,994,1016,3805,542,710,13,758,1525,3548,90,122
1339,306,4,964,997,3610,512,646,25,780,1393,3356,90,123
875,344,10,1144,1034,3407,499,619,50,769,1068,3005,90,124
213,270,14,2013,1523,4033,179,459,28,2300,903,3869,90,125
157,124,6,734,367,1388,65,340,15,471,479,1370,90,126
1018,254,2,882,781,2937,460,501,5,598,1206,2770,90,127
1469,260,2,1055,965,3751,547,726,7,749,1491,3520,90,128
1451,299,2,971,1085,3808,469,792,27,778,1514,3580,90,129
1272,237,3,982,1013,3507,515,690,9,690,1402,3306,90,130
831,332,9,900,1075,3147,424,599,34,761,1096,2914,90,131
248,250,9,1723,1328,3558,221,481,39,2171,712,3624,90,132
142,154,12,780,430,1518,64,357,23,550,565,1559,90,133
1096,211,3,854,862,3026,442,591,11,629,1181,2854,90,134
1462,224,21,902,893,3502,467,572,25,726,1535,3325,90,135
1397,310,0,908,995,3610,475,749,10,733,1434,3401,90,136
1329,345,7,976,1007,3664,479,689,25,720,1435,3348,90,137
881,331,6,1005,980,3203,409,598,52,743,1114,2916,90,138
213,270,14,837,593,1927,85,529,44,556,706,1920,90,139
216,166,1,951,514,1848,76,442,10,719,695,1942,90,140
1109,210,2,820,886,3027,446,607,6,647,1275,2981,90,141
1481,232,5,936,1069,3723,595,758,17,682,1561,3613,90,142
1486,222,15,960,1063,3746,566,659,27,760,1448,3460,90,143
1279,246,1,863,933,3322,547,619,11,674,1282,3133,90,144
853,311,2,1012,883,3061,407,612,45,687,914,2665,90,145
165,242,5,856,574,1842,100,562,43,573,494,1772,90,146
137,190,2,793,452,1574,74,417,13,564,528,1596,90,147
126,133,0,711,291,1261,69,345,8,431,457,1310,90,148
1295,242,5,835,888,3265,472,551,23,681,1460,3187,90,149
1386,231,3,1140,865,3625,565,599,13,844,1469,3490,90,150
1284,280,5,965,980,3514,496,683,18,678,1399,3274,90,151
876,344,17,895,999,3131,414,698,65,767,979,2923,90,152
188,277,5,1021,656,2147,116,580,41,712,649,2098,90,153
163,150,6,896,658,1873,79,386,10,833,552,1860,90,154
1167,262,2,747,880,3058,427,543,6,593,1323,2892,90,155
1446,221,2,953,972,3594,480,698,5,692,1477,3352,90,156
1496,230,13,907,925,3571,500,644,18,744,1484,3390,90,157
1403,298,3,997,937,3638,469,746,13,701,1491,3420,90,158
884,367,7,1109,1218,3585,449,745,78,906,1091,3269,90,159
214,289,4,1380,832,2719,170,865,81,761,811,2688,90,160
144,206,4,1001,570,1925,89,497,14,635,745,1980,90,161
1183,208,4,882,789,3066,412,539,18,639,1285,2893,90,162
1534,257,4,923,1033,3751,425,744,10,1008,1505,3692,90,163
1501,262,3,1022,930,3718,422,809,12,813,1434,3490,90,164
1426,305,3,893,873,3500,393,801,14,695,1409,3312,90,165
949,367,13,889,983,3201,395,752,57,729,1049,2982,90,166
216,268,19,982,735,2220,108,631,54,664,681,2138,90,167
160,175,2,806,437,1580,75,416,5,577,573,1646,90,168
1129,232,11,804,718,2894,371,541,7,614,1248,2781,90,169
1317,348,8,1030,952,3655,464,675,30,810,1432,3411,90,170
390,240,4,925,650,2209,254,501,10,681,643,2089,90,171
1249,330,15,1018,892,3504,531,668,21,724,1330,3274,90,172
789,330,4,835,841,2799,362,543,45,694,986,2630,90,173
195,334,7,807,669,2012,103,587,77,605,518,1890,90,174
141,150,9,677,387,1364,74,344,19,482,472,1391,90,175
1088,208,16,814,826,2952,449,527,22,680,1219,2897,90,176
1386,279,8,903,894,3470,483,697,17,691,1424,3312,90,177
1393,242,12,959,987,3593,502,687,14,717,1442,3362,90,178
1347,336,3,967,901,3554,492,720,14,678,1382,3286,90,179
839,315,7,1004,996,3161,430,707,46,743,1049,2975,90,180
188,267,8,1065,565,2093,132,487,35,679,630,1963,90,181
138,152,2,731,373,1396,82,310,24,622,425,1463,90,182
1019,202,7,774,829,2831,466,546,8,597,1121,2738,90,183
1193,267,7,897,926,3290,460,611,16,653,1327,3067,90,184
1042,270,7,957,962,3238,443,708,16,805,1091,3063,90,185
173,736,10,834,648,2401,89,1136,33,493,552,2303,90,186
432,285,8,886,741,2352,286,510,35,662,701,2194,90,187
163,259,6,795,454,1677,99,474,30,528,501,1632,90,188
145,179,19,704,363,1410,83,356,23,543,461,1466,90,189
1014,248,4,793,823,2882,542,529,5,662,1111,2849,90,190
1315,262,2,879,817,3275,540,562,9,693,1343,3147,90,191
1223,204,17,903,912,3259,558,627,19,696,1251,3151,90,192
1220,310,3,918,886,3337,530,674,6,749,1290,3249,90,193
810,326,20,760,863,2779,446,564,63,649,892,2614,90,194
176,310,14,927,618,2045,125,552,54,611,578,1920,90,195
150,196,5,799,385,1535,77,368,27,582,505,1559,90,196
1023,204,12,761,713,2713,466,456,17,603,1151,2693,90,197
1317,249,20,839,826,3251,482,615,24,652,1348,3121,90,198
1318,194,2,981,844,3339,559,584,6,722,1400,3271,90,199
1237,254,21,956,918,3386,454,679,26,731,1329,3219,90,200
809,326,21,936,992,3084,403,660,118,717,980,2878,90,201
216,262,15,899,691,2083,116,560,71,633,597,1977,90,202
125,156,4,894,408,1587,73,443,9,607,481,1613,90,203
974,228,3,775,742,2722,430,505,6,653,1199,2793,90,204
1389,270,12,879,885,3435,512,686,18,657,1450,3323,90,205
1246,198,7,985,1019,3455,492,711,11,695,1332,3241,90,206
1246,258,3,972,913,3392,502,621,9,686,1295,3113,90,207
764,330,19,879,906,2898,388,623,61,673,1026,2771,90,208
191,320,7,947,749,2214,171,501,82,762,618,2134,90,209
167,184,9,746,533,1639,134,415,26,647,491,1713,90,210
964,325,4,842,881,3016,433,538,27,800,1198,2996,90,211
1263,328,8,903,945,3447,510,591,16,815,1462,3394,90,212
1008,342,25,865,941,3181,520,685,23,761,1356,3345,90,213
1157,415,12,917,1035,3536,551,712,13,826,1271,3373,90,214
733,384,85,812,1080,3094,488,638,63,749,997,2935,90,215
160,295,28,1000,633,2116,150,442,45,775,653,2065,90,216
135,276,4,867,429,1711,90,389,8,688,530,1705,90,217
891,241,5,803,864,2804,486,550,7,608,1061,2712,90,218
1224,217,4,851,863,3159,496,625,10,673,1285,3089,90,219
1162,247,9,864,871,3153,498,630,18,593,1261,3000,90,220
993,234,4,815,837,2883,459,540,16,594,1141,2750,90,221
534,314,20,755,746,2369,357,540,66,513,741,2217,90,222
166,277,11,928,532,1914,96,525,62,617,568,1868,90,223
131,173,10,745,420,1479,65,389,17,527,516,1514,90,224
882,217,2,768,813,2682,451,476,9,628,1058,2622,90,225
1136,224,5,832,904,3101,495,597,9,633,1313,3047,90,226
1089,241,2,920,948,3200,470,604,11,716,1263,3064,90,227
1052,342,2,878,944,3218,477,624,16,699,1247,3063,90,228
638,302,7,971,901,2819,476,599,53,737,852,2717,90,229
172,270,15,860,577,1894,124,500,42,612,573,1851,90,230
137,163,2,803,421,1526,77,374,7,591,527,1576,90,231
864,242,9,950,872,2937,502,471,16,846,1097,2932,90,232
1162,270,8,898,1109,3447,544,656,11,817,1316,3344,90,233
1093,365,2,1056,1148,3664,538,632,5,940,1350,3465,90,234
1015,479,5,1061,1091,3651,554,604,23,900,1391,3472,90,235
678,342,5,1008,1003,3036,389,596,56,822,962,2825,90,236
242,253,7,1062,683,2247,126,588,44,719,711,2188,90,237
151,176,5,912,448,1692,69,424,14,603,611,1721,90,238
1063,385,13,902,1062,3425,531,574,18,897,1336,3356,90,239
1389,406,8,1005,1225,4033,562,658,11,986,1656,3873,90,240
1303,415,9,995,1117,3839,531,667,12,945,1570,3725,90,241
1196,364,13,981,1085,3639,604,536,17,938,1440,3535,90,242
785,359,16,896,937,2993,362,561,42,788,972,2725,90,243
159,238,2,1018,620,2037,161,497,33,663,565,1919,90,244
133,195,3,922,486,1739,73,455,12,595,592,1727,90,245
162,141,4,691,404,1402,84,367,11,481,550,1493,90,246
1400,418,4,1044,1038,3904,717,580,7,945,1662,3911,90,247
1429,442,9,978,1170,4028,599,635,11,913,1764,3922,90,248
1398,437,4,1033,1243,4115,666,693,15,913,1529,3816,90,249
896,386,15,964,1021,3282,517,632,66,756,1132,3103,90,250
238,285,11,1128,751,2413,159,646,74,725,642,2246,90,251
148,181,10,908,503,1750,90,414,10,707,568,1789,90,252
1226,394,5,915,1066,3606,658,571,11,830,1457,3527,90,253
1554,462,17,1048,1222,4303,681,785,23,951,1699,4139,90,254
1499,394,9,1021,1293,4216,617,788,17,969,1690,4081,90,255
1400,526,4,1047,1300,4277,668,801,18,922,1670,4079,90,256
924,364,24,939,1132,3383,513,737,78,776,1199,3303,90,257
201,492,14,1067,854,2628,127,773,66,819,804,2589,90,258
167,158,1,926,486,1738,101,387,7,648,671,1814,90,259
1232,378,3,1003,1142,3758,613,598,10,899,1532,3652,90,260
1535,451,4,1046,1185,4221,733,671,12,946,1781,4143,90,261
1550,406,7,1050,1247,4260,611,781,12,1033,1645,4082,90,262
1370,395,10,1046,1270,4091,555,832,17,915,1577,3896,90,263
995,352,13,1102,1036,3498,487,674,54,836,1218,3269,90,264
229,272,8,1143,692,2344,119,653,49,710,696,2227,90,265
160,157,3,830,438,1588,83,383,11,596,567,1640,90,266
1219,362,2,898,1080,3561,603,571,4,886,1500,3564,90,267
1491,440,11,1023,1258,4223,668,697,11,973,1819,4168,90,268
1519,405,6,1011,1234,4175,625,743,14,933,1710,4025,90,269
1337,397,3,1088,1291,4116,595,750,22,932,1627,3926,90,270
896,356,11,977,996,3236,510,698,46,748,1078,3080,90,271
190,376,34,1149,779,2528,118,832,78,713,704,2445,90,272
147,162,2,933,433,1677,91,393,11,596,588,1679,90,273
1193,446,7,898,1099,3643,589,568,12,918,1555,3642,90,274
1521,429,3,942,1191,4086,652,665,13,949,1700,3979,90,275
1455,366,5,1061,1290,4177,590,714,15,1063,1734,4116,90,276
1312,464,4,1088,1241,4109,574,740,22,979,1563,3878,90,277
947,358,20,975,1140,3440,489,719,59,763,1185,3215,90,278
213,303,2,1128,712,2358,139,657,35,782,728,2341,90,279
173,152,15,895,508,1743,85,403,22,621,602,1733,90,280
1219,414,5,1010,1210,3858,635,687,13,922,1514,3771,90,281
1558,404,19,1046,1261,4288,684,692,27,931,1812,4146,90,282
1541,392,9,1139,1296,4377,624,724,11,1007,1762,4128,90,283
1253,487,5,1167,1314,4226,668,837,12,979,1501,3997,90,284
761,376,21,1197,1071,3426,494,658,75,926,1046,3199,90,285
245,296,11,1150,717,2419,127,649,55,767,728,2326,90,286
151,171,6,1051,654,2033,91,480,12,704,733,2020,90,287
483,220,7,909,639,2258,205,513,10,597,943,2268,90,288
1543,275,5,1009,1090,3922,564,888,9,764,1572,3797,90,289
1611,367,6,1223,1220,4427,589,709,23,1187,1785,4293,90,290
1377,446,8,1123,1318,4272,649,817,11,1030,1619,4126,90,291
961,375,14,1180,1030,3560,461,718,38,846,1218,3281,90,292
275,492,24,1172,808,2771,139,856,78,883,870,2826,90,293
336,196,2,913,580,2027,104,688,14,708,657,2171,90,294
1295,352,41,1068,1197,3953,659,706,37,860,1520,3782,90,295
1583,379,33,1132,1309,4436,743,769,35,1045,1804,4396,90,296
1586,378,28,1153,1369,4514,605,815,34,1065,1791,4310,90,297
1583,430,22,1265,1299,4599,696,841,32,933,1790,4292,90,298
1100,431,11,1255,1047,3844,517,706,67,862,1254,3406,90,299
325,318,13,1113,716,2485,139,656,51,849,718,2413,90,300
314,186,27,1001,567,2095,108,525,35,829,660,2157,90,301
1293,393,38,999,1142,3865,577,762,43,923,1439,3744,90,302
1521,442,37,1171,1710,4881,746,1102,44,1007,1737,4636,90,303
1523,423,60,1284,1329,4619,724,783,58,1055,1786,4406,90,304
1330,475,37,1086,1278,4206,604,761,53,953,1628,3999,90,305
879,399,4,1080,1156,3518,488,653,72,906,1161,3280,90,306
218,335,12,1137,786,2488,133,622,51,714,751,2271,90,307
197,167,29,912,519,1824,104,335,31,742,680,1892,90,308
1115,301,39,1072,1087,3614,606,571,39,862,1346,3424,90,309
1146,354,38,1114,984,3636,527,573,60,925,1405,3490,90,310
1253,345,19,1007,1120,3744,544,590,23,936,1517,3610,90,311
1364,403,25,1037,1193,4022,626,663,31,903,1531,3754,90,312
940,328,12,1051,1121,3452,505,596,58,817,1140,3116,90,313
216,346,15,1221,890,2688,134,483,29,1045,887,2578,90,314
133,141,36,953,476,1739,96,367,40,673,609,1785,90,315
566,193,19,905,713,2396,332,503,20,672,940,2467,90,316
1538,427,50,1102,1232,4349,675,624,53,970,1836,4158,90,317
1546,365,37,1107,1311,4366,610,712,47,995,1825,4189,90,318
1428,420,34,1111,1241,4234,657,675,35,952,1701,4020,90,319
959,381,17,1174,1147,3678,543,601,59,839,1276,3318,90,320
242,346,6,1169,773,2536,127,543,59,817,813,2359,90,321
199,158,36,951,507,1851,84,417,38,704,672,1915,90,322
1234,393,45,959,1133,3764,637,545,47,925,1514,3668,90,323
1547,445,53,1098,1238,4381,697,645,57,1039,1765,4203,90,324
1505,441,33,1105,1161,4245,632,727,35,971,1854,4219,90,325
1365,444,33,1127,1286,4255,624,738,42,1020,1685,4109,90,326
887,319,21,888,1047,3162,509,492,58,753,1099,2911,90,327
195,264,13,987,720,2179,103,539,41,657,670,2010,90,328
156,178,20,865,505,1724,82,348,21,633,604,1688,90,329
1010,314,21,1015,1032,3392,508,439,23,916,1330,3216,90,330
1092,342,55,977,1107,3573,516,516,56,950,1377,3415,90,331
626,218,27,1014,779,2664,363,389,32,788,881,2453,90,332
142,124,6,435,316,1023,68,212,8,282,287,857,90,333
245,176,4,875,461,1761,149,397,24,536,690,1796,90,334
119,198,9,825,499,1650,83,448,43,560,669,1803,90,335
127,116,41,789,413,1486,92,362,44,535,564,1597,90,336
1048,318,38,840,915,3159,450,522,40,787,1363,3162,90,337
1440,357,56,1040,1139,4032,652,681,55,845,1734,3967,90,338
1443,340,50,1131,1165,4129,609,680,59,940,1712,4000,90,339
1313,321,46,1072,1184,3936,565,673,45,866,1511,3660,90,340
880,344,8,1067,1101,3400,544,596,45,826,1207,3218,90,341
173,274,22,1056,832,2357,120,658,40,625,765,2208,90,342
145,186,66,1031,628,2056,75,458,59,678,797,2067,90,343
1150,328,55,955,1067,3555,571,667,60,821,1395,3514,90,344
1521,325,51,1184,1154,4235,677,755,53,887,1664,4036,90,345
1494,289,39,1015,1018,3855,554,721,51,856,1546,3728,90,346
1422,310,56,1162,1212,4162,575,830,55,773,1660,3893,90,347
912,359,21,1066,1091,3449,536,667,71,773,1216,3263,90,348
216,312,28,1129,827,2512,100,598,61,812,831,2402,90,349
155,148,19,899,513,1734,75,375,22,646,647,1765,90,350
1066,218,15,899,920,3118,466,521,17,722,1284,3010,90,351
1300,229,11,1097,1014,3651,502,642,28,766,1529,3467,90,352
1278,240,3,1004,1019,3544,549,657,11,744,1451,3412,90,353
1078,216,3,910,999,3206,444,595,15,705,1313,3072,90,354
710,262,13,844,960,2789,382,546,45,630,917,2520,90,355
145,179,2,876,536,1738,82,353,26,526,607,1594,90,356
112,111,0,701,413,1337,66,287,4,409,451,1217,90,357
456,165,3,821,594,2039,234,336,8,551,725,1854,90,358
225,116,1,631,357,1330,190,177,4,455,370,1196,90,359
67,72,2,244,142,527,23,139,2,167,165,496,90,360
225,151,7,607,484,1474,182,312,9,398,555,1456,90,361
286,188,3,705,551,1733,193,341,20,493,620,1667,90,362
99,158,4,638,365,1264,65,318,20,429,442,1274,90,363
78,97,0,640,325,1140,63,300,3,411,449,1226,90,364
459,184,0,765,559,1967,264,340,5,547,770,1926,90,365
401,294,70,822,468,2055,222,292,171,614,686,1985,90,366
93,99,3,410,186,791,44,216,11,346,340,957,91,1
1742,145,5,715,405,3012,207,382,21,434,1943,2987,91,2
2075,121,7,763,709,3675,248,732,18,490,2247,3735,91,3
1934,135,4,686,425,3184,232,489,18,502,1949,3190,91,4
1147,196,5,672,798,2818,191,834,75,462,1263,2825,91,5
160,164,9,556,427,1316,79,439,96,338,419,1371,91,6
117,109,1,991,258,1476,50,451,16,332,679,1528,91,7
1822,112,11,637,509,3091,250,647,23,382,1852,3154,91,8
2302,97,4,561,294,3258,257,430,16,607,2056,3366,91,9
2459,145,6,715,419,3744,264,677,23,491,2386,3841,91,10
2222,149,5,747,702,3825,283,829,31,527,2172,3842,91,11
1084,137,4,550,444,2219,218,382,39,401,1030,2070,91,12
207,122,1,1379,378,2087,74,561,55,361,929,1980,91,13
132,67,1,556,239,995,53,247,13,280,448,1041,91,14
210,97,12,439,179,937,103,252,24,200,379,958,91,15
506,108,5,351,422,1392,165,421,20,293,536,1435,91,16
1817,158,6,672,430,3083,283,550,16,464,1796,3109,91,17
2269,178,7,726,733,3913,313,867,22,544,2159,3905,91,18
676,128,7,860,361,2032,130,414,51,349,1099,2043,91,19
199,161,0,806,543,1709,84,506,83,419,634,1726,91,20
131,98,3,630,371,1233,52,424,12,361,472,1321,91,21
1838,169,2,659,460,3128,298,518,8,460,1883,3167,91,22
2644,158,3,735,543,4083,317,698,17,585,2516,4133,91,23
2669,175,3,768,577,4192,320,792,42,581,2510,4245,91,24
2321,201,5,726,621,3874,309,837,28,549,2221,3944,91,25
1279,306,8,1031,694,3318,259,727,111,607,1652,3356,91,26
295,231,5,1567,701,2799,109,780,81,574,1275,2819,91,27
161,108,0,831,288,1388,61,322,14,401,680,1478,91,28
1850,171,2,610,440,3073,314,472,11,498,1823,3118,91,29
2631,167,3,757,519,4077,326,643,20,578,2542,4109,91,30
2621,211,5,650,685,4172,298,824,16,539,2528,4205,91,31
2319,187,3,703,552,3764,305,788,30,553,2129,3805,91,32
1317,252,14,696,719,2998,224,707,92,561,1337,2921,91,33
245,233,7,1144,498,2127,110,511,64,537,906,2128,91,34
133,100,6,928,305,1472,57,390,25,473,701,1646,91,35
1907,163,3,634,456,3163,299,519,7,497,1872,3194,91,36
2714,165,4,763,661,4307,325,811,26,536,2617,4315,91,37
2710,189,8,728,557,4192,340,745,23,593,2568,4269,91,38
2368,174,5,757,594,3898,325,735,25,503,2377,3965,91,39
1387,319,6,750,676,3138,246,583,165,581,1563,3138,91,40
296,247,9,1515,700,2767,93,846,129,559,1108,2735,91,41
131,79,4,1020,265,1499,63,289,61,366,925,1704,91,42
1887,140,3,631,471,3132,289,572,18,478,1845,3202,91,43
2226,168,5,620,731,3750,294,920,15,445,2077,3751,91,44
3259,209,2,730,576,4776,314,880,28,1090,2510,4822,91,45
2421,153,3,709,456,3742,310,736,27,443,2095,3611,91,46
1250,242,14,688,711,2905,234,619,101,541,1397,2892,91,47
248,194,5,987,422,1856,86,496,84,393,762,1821,91,48
156,116,0,868,253,1393,59,384,24,405,694,1566,91,49
470,170,8,794,401,1843,178,332,29,502,863,1904,91,50
2655,177,4,658,710,4204,338,843,18,541,2470,4210,91,51
2729,167,4,798,571,4269,326,694,27,572,2686,4305,91,52
2545,197,2,703,632,4079,297,890,28,527,2530,4272,91,53
1535,247,7,675,578,3042,237,540,87,516,1663,3043,91,54
270,274,14,1149,904,2611,102,855,128,595,945,2625,91,55
186,111,4,793,387,1481,73,424,15,438,639,1589,91,56
2132,129,3,631,651,3546,314,744,17,504,2107,3686,91,57
2988,173,2,735,628,4526,318,835,15,572,2798,4538,91,58
2921,156,3,709,470,4259,298,674,17,579,2741,4309,91,59
2689,179,3,724,583,4178,305,784,28,531,2574,4222,91,60
1536,216,13,685,957,3407,217,924,106,541,1586,3374,91,61
220,219,17,1074,499,2029,69,577,94,450,809,1999,91,62
185,125,3,1188,314,1815,53,405,12,474,907,1851,91,63
2174,113,7,789,432,3515,257,581,17,506,2152,3513,91,64
2932,126,3,958,504,4523,249,857,27,530,2909,4572,91,65
2981,104,2,760,576,4423,240,861,22,549,2795,4467,91,66
2761,169,6,935,581,4452,273,866,75,570,2687,4471,91,67
1342,236,19,1028,696,3321,230,872,112,588,1741,3543,91,68
422,166,12,1225,677,2502,96,967,131,501,938,2633,91,69
225,128,3,991,351,1698,64,400,32,474,933,1903,91,70
1863,191,1,755,465,3275,291,628,19,502,1931,3371,91,71
2728,202,3,1045,585,4563,342,993,20,568,2763,4686,91,72
2763,189,3,1183,635,4773,321,940,52,683,2911,4907,91,73
2484,225,14,1248,788,4759,323,970,84,668,2684,4729,91,74
1374,247,5,1114,866,3606,263,766,220,600,1770,3619,91,75
702,351,7,2623,998,4681,133,1481,207,957,1868,4646,91,76
231,160,4,1572,650,2617,84,822,23,554,1266,2749,91,77
2023,177,13,883,600,3696,304,660,25,646,2103,3738,91,78
2773,194,8,974,712,4661,333,916,29,674,2807,4759,91,79
2859,203,2,1268,1010,5342,333,1237,41,729,3000,5340,91,80
2480,191,9,1091,884,4655,361,1191,44,753,2384,4733,91,81
1512,256,5,1528,1269,4570,313,1249,136,765,2146,4609,91,82
344,253,9,1348,673,2627,93,898,91,474,1146,2702,91,83
519,149,0,3217,756,4641,83,1096,43,824,2671,4717,91,84
1850,214,5,1846,856,4771,278,926,236,670,2609,4719,91,85
2512,202,3,1813,951,5481,319,1215,26,769,3153,5482,91,86
2314,179,2,1076,654,4225,303,811,21,684,2428,4247,91,87
2056,211,7,1290,626,4190,292,813,27,631,2492,4255,91,88
1263,288,3,2127,807,4488,260,1027,105,810,2371,4573,91,89
547,263,15,3917,1135,5877,123,1635,107,1025,2940,5830,91,90
238,162,0,1661,546,2607,82,785,23,629,1236,2755,91,91
1755,227,9,1860,630,4481,283,1466,51,630,1934,4364,91,92
2632,179,8,1143,631,4593,330,809,30,663,2825,4657,91,93
2669,171,3,940,748,4531,314,970,24,584,2694,4586,91,94
2605,254,3,1305,981,5148,315,1266,37,710,2811,5139,91,95
1455,275,2,1336,921,3989,275,979,129,709,1984,4076,91,96
574,316,8,2192,735,3825,128,1344,142,807,1419,3840,91,97
520,137,1,1648,646,2952,119,948,23,747,1174,3011,91,98
1942,186,6,914,544,3592,324,590,86,607,2039,3646,91,99
2651,278,4,952,725,4610,326,828,183,601,2732,4670,91,100
2618,205,11,1010,580,4424,305,874,36,643,2679,4537,91,101
2469,193,8,850,646,4166,314,909,47,609,2283,4162,91,102
1442,266,2,916,842,3468,310,886,123,604,1695,3618,91,103
570,298,12,2204,1070,4154,159,1315,181,707,1714,4076,91,104
267,184,0,1435,475,2361,89,618,32,546,1232,2517,91,105
1935,212,4,907,697,3755,323,795,26,580,2059,3783,91,106
2749,210,3,864,570,4396,351,837,33,629,2695,4545,91,107
2831,211,9,850,676,4577,349,1001,41,651,2673,4715,91,108
2562,225,3,921,720,4431,320,941,56,657,2513,4487,91,109
1446,262,14,966,976,3664,272,997,109,653,1675,3706,91,110
344,306,2,3081,1065,4798,117,1883,154,578,1747,4479,91,111
199,159,6,1146,371,1881,70,474,21,435,987,1987,91,112
1902,208,6,845,486,3447,289,624,20,568,1985,3486,91,113
2719,184,6,824,879,4612,342,1122,32,616,2559,4671,91,114
2712,194,2,832,895,4635,368,1132,31,595,2606,4732,91,115
2697,200,2,1141,816,4856,335,1204,76,730,2603,4948,91,116
1329,290,9,851,1102,3581,273,1114,170,579,1537,3673,91,117
404,249,4,1257,952,2866,111,908,303,658,900,2880,91,118
204,187,1,1216,656,2264,95,726,137,459,984,2401,91,119
1910,160,2,743,497,3312,322,541,18,529,1961,3371,91,120
2701,193,1,814,572,4281,337,796,19,601,2588,4341,91,121
2785,174,1,892,615,4467,346,894,54,639,2609,4542,91,122
2501,200,1,789,571,4062,335,793,45,622,2313,4108,91,123
1462,237,7,879,837,3422,250,837,99,758,1567,3511,91,124
339,248,6,1412,634,2639,103,892,123,572,994,2684,91,125
190,125,3,1129,382,1829,64,720,23,462,689,1958,91,126
1930,188,1,798,453,3370,323,556,24,561,2005,3469,91,127
2761,204,1,816,815,4597,321,1063,24,641,2693,4742,91,128
2699,184,1,908,947,4739,317,1209,52,618,2639,4835,91,129
2297,224,5,821,556,3903,329,871,31,622,2202,4055,91,130
1273,266,19,742,644,2944,281,630,123,585,1453,3072,91,131
433,247,9,1488,548,2725,134,783,81,626,1251,2875,91,132
181,173,4,946,341,1645,115,370,28,476,768,1757,91,133
1959,156,4,946,562,3627,296,693,22,570,2078,3659,91,134
2744,129,2,882,502,4259,327,729,24,624,2701,4405,91,135
2705,170,3,847,659,4384,340,916,31,622,2570,4479,91,136
2561,193,6,1029,625,4414,366,934,56,666,2541,4563,91,137
1582,255,8,920,681,3446,317,657,80,783,1725,3562,91,138
267,243,8,1121,579,2218,109,637,80,551,899,2276,91,139
398,179,3,1111,387,2078,93,569,34,634,857,2187,91,140
1924,173,4,791,610,3502,313,757,26,522,2014,3632,91,141
2761,193,5,878,735,4572,343,998,33,539,2666,4579,91,142
2806,175,10,1107,534,4632,350,809,35,615,2922,4731,91,143
2413,197,3,862,567,4042,323,739,24,644,2408,4138,91,144
1167,346,3,896,908,3320,287,913,112,744,1353,3409,91,145
343,250,10,1833,901,3337,104,1456,179,586,1044,3369,91,146
277,220,6,1639,469,2611,75,631,89,678,1317,2790,91,147
263,153,10,952,313,1691,92,405,28,492,840,1857,91,148
2646,165,11,861,618,4301,360,633,99,621,2590,4303,91,149
3215,183,7,861,559,4825,338,748,36,1116,2681,4919,91,150
2603,190,3,943,668,4407,338,932,35,655,2531,4491,91,151
1371,314,7,890,653,3235,284,702,120,644,1580,3330,91,152
365,285,9,1346,782,2787,143,943,125,609,1041,2861,91,153
238,189,16,1018,391,1852,66,499,38,427,903,1933,91,154
2197,162,1,808,693,3861,323,865,27,575,2166,3956,91,155
3090,195,12,947,745,4989,356,1040,33,619,2991,5039,91,156
2928,213,1,968,588,4698,338,1017,29,629,2740,4753,91,157
2693,229,5,936,941,4804,360,1215,59,656,2516,4806,91,158
1450,339,5,1045,1500,4339,315,1424,209,622,1811,4381,91,159
353,408,20,3432,1495,5708,130,2839,277,645,1601,5492,91,160
250,185,5,2035,603,3078,99,910,47,534,1604,3194,91,161
2153,171,3,972,524,3823,330,701,23,534,2346,3934,91,162
2934,211,11,980,752,4888,372,1209,44,572,2773,4970,91,163
2961,203,4,949,819,4936,354,1130,122,663,2759,5028,91,164
2663,181,1,1043,607,4495,359,1005,43,648,2554,4609,91,165
1511,321,2,1016,1239,4089,268,1201,208,714,1745,4136,91,166
357,328,9,1800,1013,3507,138,1483,132,631,1147,3531,91,167
236,208,11,1165,352,1972,71,563,35,473,1053,2195,91,168
2086,140,6,860,480,3572,319,598,35,581,2156,3689,91,169
2854,163,3,893,911,4824,362,1127,61,673,2653,4876,91,170
757,210,7,1150,655,2779,257,942,33,539,1113,2884,91,171
2576,309,10,1152,603,4650,317,910,53,582,2745,4607,91,172
1555,306,5,883,646,3395,273,736,115,608,1625,3357,91,173
343,434,7,1175,977,2936,114,1153,227,624,810,2928,91,174
247,164,9,856,390,1666,103,462,70,476,744,1855,91,175
1998,173,3,866,505,3545,292,757,36,548,2056,3689,91,176
2941,181,2,869,527,4520,357,824,26,613,2795,4615,91,177
3062,187,11,926,658,4844,368,1039,45,646,2827,4925,91,178
2654,232,2,1143,648,4679,405,1034,56,700,2611,4806,91,179
1475,340,10,1147,736,3708,285,704,119,695,1887,3690,91,180
427,338,2,1332,770,2869,126,879,104,636,1176,2921,91,181
204,222,11,1003,331,1771,73,513,30,412,719,1747,91,182
2116,158,3,1071,822,4170,304,1050,39,512,2316,4221,91,183
2618,204,2,1028,876,4728,310,1079,101,623,2672,4785,91,184
2007,229,8,1032,1227,4503,310,1278,142,885,1956,4571,91,185
580,2283,46,2047,2239,7195,111,3814,206,847,1279,6257,91,186
789,286,3,1118,662,2858,217,735,119,630,1217,2918,91,187
353,329,9,1443,466,2600,139,898,108,488,959,2592,91,188
218,175,10,1108,317,1828,72,460,27,507,966,2032,91,189
1986,151,2,897,510,3546,316,831,23,529,1974,3673,91,190
2464,173,15,878,506,4036,319,725,38,617,2513,4212,91,191
2550,165,9,861,542,4127,325,906,50,518,2467,4266,91,192
2285,220,6,981,581,4073,311,853,38,598,2348,4148,91,193
1316,299,2,815,684,3116,242,753,119,597,1482,3193,91,194
314,333,5,1756,1452,3860,95,1915,152,544,1140,3846,91,195
239,210,6,938,346,1739,90,492,67,461,788,1898,91,196
2043,150,7,748,408,3356,304,558,19,521,2062,3464,91,197
2697,164,2,794,627,4284,281,1009,20,549,2486,4345,91,198
2731,141,11,866,454,4203,292,775,37,541,2660,4305,91,199
2495,202,2,1035,608,4342,294,1051,40,575,2498,4458,91,200
1294,340,20,856,1071,3581,250,920,377,590,1542,3679,91,201
321,315,4,1567,1621,3828,117,1784,206,634,1027,3768,91,202
256,196,12,1407,370,2241,81,517,28,512,1230,2368,91,203
2058,137,8,841,1081,4125,278,1261,34,533,2068,4174,91,204
2750,173,2,905,789,4619,311,1138,30,559,2718,4756,91,205
2551,190,3,1134,985,4863,310,1274,50,610,2623,4867,91,206
2466,201,3,1132,580,4382,322,855,32,583,2636,4428,91,207
1383,373,8,993,726,3483,253,771,157,656,1564,3401,91,208
300,341,1,1709,1042,3393,109,1184,258,626,1236,3413,91,209
216,161,3,1055,458,1893,70,670,69,478,777,2064,91,210
2045,160,4,1003,1013,4225,283,828,404,526,2201,4242,91,211
2621,187,2,1007,570,4387,310,1146,31,582,2515,4584,91,212
2591,163,5,955,534,4248,279,763,18,597,2743,4400,91,213
2340,249,2,986,618,4195,281,937,42,576,2321,4157,91,214
1483,301,5,1285,1278,4352,280,1522,236,593,1641,4272,91,215
539,264,14,2166,544,3527,54,1453,184,599,1238,3528,91,216
352,143,6,1377,347,2225,88,501,23,575,1296,2483,91,217
1814,152,3,861,596,3426,282,684,34,535,1962,3497,91,218
2554,151,2,889,935,4531,307,1151,33,592,2556,4639,91,219
2461,140,3,917,622,4143,292,814,31,539,2510,4186,91,220
2171,185,2,881,554,3793,263,677,61,607,2241,3849,91,221
1085,287,11,670,876,2929,241,816,207,514,1127,2905,91,222
309,310,11,1254,946,2830,116,1057,212,575,948,2908,91,223
316,180,3,1285,685,2469,79,838,17,616,1076,2626,91,224
1724,115,8,821,436,3104,264,526,26,507,1873,3196,91,225
2430,172,0,920,563,4085,309,840,32,553,2425,4159,91,226
2473,194,6,927,557,4157,270,835,43,617,2500,4265,91,227
2082,205,4,946,609,3846,288,765,77,593,2191,3914,91,228
1225,250,7,936,635,3053,265,636,102,580,1437,3020,91,229
261,351,9,1267,738,2626,123,771,249,608,961,2712,91,230
200,187,5,969,405,1766,69,510,54,450,821,1904,91,231
1694,126,8,714,449,2991,276,552,27,442,1720,3017,91,232
2504,190,4,840,659,4197,317,858,45,566,2484,4270,91,233
2460,186,7,895,706,4254,283,950,74,590,2422,4319,91,234
2281,210,11,1026,564,4092,336,808,39,522,2497,4202,91,235
1296,304,7,809,873,3289,281,855,122,649,1422,3329,91,236
476,319,18,1630,849,3292,99,1184,144,623,1261,3311,91,237
206,174,4,1077,449,1910,78,611,41,436,819,1985,91,238
1864,196,3,738,964,3765,354,962,17,612,1888,3833,91,239
2635,249,3,795,1064,4746,390,1217,35,609,2547,4798,91,240
2571,234,3,778,940,4526,383,1069,16,671,2440,4579,91,241
2162,239,14,912,771,4098,388,752,192,627,2273,4232,91,242
1115,270,11,941,908,3245,271,832,151,710,1278,3242,91,243
354,293,11,1967,630,3255,107,1172,170,621,1198,3268,91,244
265,177,4,1627,408,2481,86,535,44,521,1423,2609,91,245
221,160,1,882,383,1647,65,429,9,428,812,1743,91,246
2529,213,5,768,552,4067,405,702,22,621,2522,4272,91,247
2779,234,6,786,341,4146,393,831,19,614,1341,3198,91,248
2520,230,6,870,647,4273,388,836,32,580,2482,4318,91,249
1352,282,2,809,735,3180,331,683,94,589,1484,3181,91,250
334,291,12,1360,970,2967,123,796,406,609,1026,2960,91,251
267,197,8,954,490,1916,90,573,28,547,802,2040,91,252
2044,256,0,822,736,3858,368,747,82,589,2067,3853,91,253
2826,230,12,879,933,4880,397,1204,32,632,2678,4943,91,254
2802,228,3,851,816,4700,395,1061,41,561,2688,4746,91,255
2602,242,2,928,770,4544,414,1013,26,626,2518,4597,91,256
1442,319,7,896,1050,3714,338,991,189,686,1605,3809,91,257
344,358,6,1730,1056,3494,152,1395,244,675,1117,3583,91,258
263,174,7,1367,481,2292,94,485,31,575,1249,2434,91,259
1994,204,8,789,604,3599,388,710,26,627,1976,3727,91,260
2778,231,7,849,656,4521,409,936,27,616,2612,4600,91,261
2761,237,5,802,669,4474,364,1040,36,637,2605,4682,91,262
2595,230,6,932,922,4685,392,1071,43,724,2482,4712,91,263
1446,349,15,903,818,3531,319,869,135,626,1625,3574,91,264
322,339,9,1636,1060,3366,138,1281,275,643,943,3280,91,265
191,155,4,1051,427,1828,79,551,20,540,814,2004,91,266
2025,213,0,790,569,3597,377,615,43,587,1984,3606,91,267
2825,212,2,801,948,4788,371,1118,38,604,2733,4864,91,268
2763,237,3,788,1010,4801,371,1184,55,625,2571,4806,91,269
2394,258,0,1112,765,4529,361,900,77,677,2591,4606,91,270
1358,325,8,800,1208,3699,280,1139,184,656,1485,3744,91,271
390,282,12,2145,1202,4031,136,1844,156,715,1225,4076,91,272
222,172,10,1479,466,2349,105,897,32,504,899,2437,91,273
2028,193,12,764,562,3559,365,592,41,545,2029,3572,91,274
2766,214,15,795,629,4419,373,799,41,564,2692,4469,91,275
2729,206,10,816,699,4460,375,937,51,705,2578,4646,91,276
2435,266,16,1028,701,4446,331,911,71,663,2448,4424,91,277
1313,279,4,966,848,3410,284,851,129,682,1582,3528,91,278
329,352,9,1531,923,3144,167,1085,185,685,1059,3181,91,279
217,174,12,1077,458,1938,97,569,47,506,927,2146,91,280
2117,180,10,838,579,3724,356,655,40,625,2170,3846,91,281
2903,223,5,964,623,4718,410,968,24,643,2810,4855,91,282
2898,307,6,1015,781,5007,391,1009,90,708,2830,5028,91,283
2500,239,5,1041,913,4698,365,1032,38,744,2564,4743,91,284
1355,313,2,1110,920,3700,330,823,91,739,1631,3614,91,285
607,406,5,1801,1142,3961,142,1524,187,781,1327,3961,91,286
433,218,0,1278,692,2621,84,726,148,818,1027,2803,91,287
877,144,4,1020,551,2596,289,639,37,571,1254,2790,91,288
2918,201,1,936,918,4974,383,1178,33,720,2718,5032,91,289
2978,193,2,960,736,4869,399,867,56,705,2943,4970,91,290
2473,275,3,1066,997,4814,371,1107,79,678,2511,4746,91,291
1410,323,13,987,904,3637,322,886,135,626,1733,3702,91,292
386,434,7,1511,944,3282,121,1129,200,636,1201,3287,91,293
237,183,0,1412,562,2394,88,918,25,556,939,2526,91,294
2010,171,3,855,706,3745,367,783,52,663,1998,3863,91,295
2905,206,1,922,622,4656,427,888,19,714,2796,4844,91,296
2848,197,2,966,905,4918,385,1167,35,725,2672,4984,91,297
2648,233,0,953,901,4735,407,1150,76,642,2517,4792,91,298
1538,345,4,917,774,3578,283,849,143,693,1762,3730,91,299
413,398,19,1446,945,3221,163,995,193,730,1126,3207,91,300
1070,239,1,1375,706,3391,114,726,157,1183,1228,3408,91,301
2051,186,1,748,620,3606,389,640,38,639,2118,3824,91,302
2768,220,1,1081,1573,5643,386,1840,31,755,2640,5652,91,303
2827,205,1,935,729,4697,402,919,34,675,2752,4782,91,304
2281,426,0,875,920,4502,362,784,91,770,2396,4403,91,305
1299,354,6,915,752,3326,303,730,94,679,1557,3363,91,306
396,361,18,1570,1140,3485,149,1330,215,740,1029,3463,91,307
236,195,4,958,503,1896,96,598,13,625,743,2075,91,308
1909,182,2,799,730,3622,358,716,30,648,2093,3845,91,309
1922,173,1,792,485,3373,296,518,45,640,2033,3532,91,310
2226,217,1,794,821,4059,399,848,57,630,2158,4092,91,311
2422,201,4,849,692,4168,385,818,28,627,2372,4230,91,312
1485,297,24,821,1116,3743,337,990,142,758,1537,3764,91,313
328,282,5,1516,685,2816,136,651,114,654,1178,2733,91,314
218,151,0,1241,449,2059,80,529,60,493,1101,2263,91,315
903,175,0,884,551,2513,271,534,48,536,1238,2627,91,316
2809,196,0,853,633,4491,398,733,25,598,2795,4549,91,317
2952,195,2,909,919,4977,400,1055,40,629,2851,4975,91,318
2543,198,1,906,697,4345,360,877,35,637,2452,4361,91,319
1450,276,13,854,840,3433,343,816,150,654,1535,3498,91,320
336,325,10,1417,687,2775,155,675,118,657,1150,2755,91,321
204,166,10,951,534,1865,86,578,38,469,826,1997,91,322
2115,171,6,753,586,3631,392,621,24,631,2062,3730,91,323
2900,201,6,845,672,4624,394,877,14,665,2720,4670,91,324
2838,201,1,853,661,4554,394,859,24,665,2718,4660,91,325
2578,222,2,870,988,4660,391,1161,37,690,2429,4708,91,326
1380,277,14,743,903,3317,316,848,134,693,1496,3487,91,327
284,294,8,1269,1084,2939,138,1142,165,588,958,2991,91,328
207,153,6,1092,455,1913,68,499,25,533,992,2117,91,329
1810,178,13,956,589,3546,376,570,58,583,2072,3659,91,330
2037,210,0,1094,823,4164,353,825,26,621,2461,4286,91,331
1158,277,1,1258,696,3390,259,751,54,950,1634,3648,91,332
138,198,2,339,177,854,51,143,8,531,407,1140,91,333
544,208,10,1788,470,3020,137,622,43,558,1583,2943,91,334
226,212,7,1357,628,2430,116,717,77,427,1054,2391,91,335
193,132,9,985,447,1766,63,535,30,461,807,1896,91,336
1939,157,3,655,597,3351,372,639,17,603,1818,3449,91,337
2791,179,1,804,854,4629,372,1008,25,667,2642,4714,91,338
2821,166,9,855,636,4487,377,877,32,723,2575,4584,91,339
2434,168,2,880,843,4327,332,1078,34,561,2633,4638,91,340
1326,223,8,744,810,3111,261,687,119,523,1466,3056,91,341
225,254,8,1359,1194,3040,114,1259,133,525,1010,3041,91,342
203,160,2,1131,548,2044,63,656,41,500,918,2178,91,343
1990,153,4,679,537,3363,318,731,24,570,1845,3488,91,344
2881,174,4,927,587,4573,310,898,28,686,2751,4673,91,345
2873,183,3,821,581,4461,323,971,44,617,2610,4565,91,346
2585,199,8,961,808,4561,341,1100,49,628,2416,4534,91,347
1392,244,6,874,845,3361,293,755,160,557,1602,3367,91,348
696,291,10,1432,1186,3615,152,1310,186,893,1063,3604,91,349
141,145,3,841,531,1661,68,560,51,438,678,1795,91,350
1869,165,2,726,507,3269,302,548,15,540,1927,3332,91,351
2694,214,6,1032,879,4825,354,1002,176,609,2703,4844,91,352
2542,172,3,961,688,4366,295,979,45,609,2509,4437,91,353
2168,204,5,977,931,4285,324,1142,30,589,2260,4345,91,354
913,218,6,718,820,2675,232,715,81,399,985,2412,91,355
151,205,9,994,548,1907,82,577,73,370,752,1854,91,356
122,111,1,1039,530,1803,63,713,18,289,677,1760,91,357
696,127,2,1003,547,2375,193,713,21,451,977,2355,91,358
264,64,2,426,211,967,118,222,7,323,469,1139,91,359
55,64,2,179,111,411,24,115,9,143,182,473,91,360
482,127,1,756,448,1814,156,492,13,295,730,1686,91,361
458,163,2,941,435,1999,150,477,47,366,828,1868,91,362
104,143,4,779,464,1494,85,479,69,304,567,1504,91,363
102,106,0,807,332,1347,46,323,76,243,623,1311,91,364
725,169,1,1190,597,2682,205,686,34,482,1391,2798,91,365
701,631,157,1243,583,3315,191,441,569,584,1432,3217,91,366
43,67,1,268,147,526,27,125,3,203,241,599,92,1
735,112,8,361,337,1553,220,226,9,258,868,1581,92,2
913,115,2,389,478,1897,239,383,6,295,989,1912,92,3
868,107,2,439,424,1840,238,285,5,300,945,1773,92,4
468,202,18,409,622,1719,203,487,66,289,583,1628,92,5
68,105,12,390,434,1009,162,255,35,307,250,1009,92,6
60,75,1,515,220,871,36,191,8,317,375,927,92,7
744,117,8,355,382,1606,240,276,13,311,808,1648,92,8
1074,84,3,396,323,1880,266,221,5,334,1025,1851,92,9
1128,142,2,501,480,2253,260,338,7,359,1146,2110,92,10
1017,134,40,474,593,2258,275,529,39,321,1114,2278,92,11
378,103,3,275,250,1009,171,105,11,184,151,622,92,12
49,107,9,321,145,631,45,113,16,174,133,481,92,13
32,42,4,205,95,378,17,56,5,114,105,297,92,14
63,38,0,187,95,383,37,56,0,127,104,324,92,15
332,128,2,320,343,1125,120,287,1,293,432,1133,92,16
1040,161,0,392,417,2010,225,373,6,309,1116,2029,92,17
1115,199,2,458,634,2408,285,561,7,318,1106,2277,92,18
342,258,11,400,382,1393,150,386,42,240,514,1332,92,19
88,253,7,613,410,1371,46,385,57,344,522,1354,92,20
56,90,1,517,254,918,27,193,7,311,368,906,92,21
791,160,8,365,482,1806,247,316,8,387,863,1821,92,22
1237,191,6,471,544,2449,336,433,11,349,1258,2387,92,23
1193,214,2,464,548,2421,321,496,10,342,1162,2331,92,24
1060,229,2,472,582,2345,281,533,8,379,1087,2288,92,25
549,333,9,517,648,2056,257,442,68,408,699,1874,92,26
145,213,16,721,433,1528,52,386,56,467,563,1524,92,27
72,90,5,526,229,922,32,230,7,394,325,988,92,28
792,147,2,433,417,1791,229,318,8,335,895,1785,92,29
1206,210,14,450,506,2386,281,428,22,363,1263,2357,92,30
1180,158,2,474,591,2405,312,530,10,361,1198,2411,92,31
1097,218,1,470,560,2346,296,519,5,359,1107,2286,92,32
548,225,14,442,613,1842,216,450,65,360,674,1765,92,33
98,233,24,655,427,1437,47,378,62,380,547,1414,92,34
61,88,2,570,265,986,32,236,7,379,437,1091,92,35
780,169,2,374,408,1733,256,282,9,325,849,1721,92,36
1171,210,2,500,561,2444,296,485,9,378,1316,2484,92,37
1203,186,0,478,619,2486,350,515,7,352,1198,2422,92,38
1120,190,1,446,637,2394,325,455,7,390,1117,2294,92,39
579,226,18,485,639,1947,257,420,56,413,649,1795,92,40
104,206,18,772,511,1611,73,435,60,381,587,1536,92,41
69,243,2,476,305,1095,50,246,17,307,543,1163,92,42
740,160,15,394,533,1842,282,346,20,386,849,1883,92,43
1052,182,6,496,587,2323,305,516,16,371,1136,2344,92,44
1141,219,2,483,609,2454,297,535,10,411,1097,2350,92,45
1063,213,2,469,600,2347,295,438,18,385,1135,2271,92,46
535,233,16,484,635,1903,242,465,53,387,639,1786,92,47
108,227,8,664,377,1384,63,348,55,391,479,1336,92,48
70,108,1,556,260,995,28,227,7,351,383,996,92,49
229,150,3,499,320,1201,118,251,5,387,531,1292,92,50
1138,182,6,481,548,2355,288,438,10,351,1222,2309,92,51
1210,209,5,481,629,2534,432,465,11,405,1205,2518,92,52
1114,224,3,531,672,2544,369,550,8,352,1139,2418,92,53
533,254,13,451,560,1811,243,412,36,361,661,1713,92,54
120,222,13,695,445,1495,41,392,86,441,487,1447,92,55
80,106,1,458,294,939,30,249,3,351,402,1035,92,56
802,185,3,423,498,1911,263,420,7,318,894,1902,92,57
1227,193,2,464,572,2458,312,460,8,376,1322,2478,92,58
1220,166,1,496,561,2444,331,387,7,382,1209,2316,92,59
1090,228,1,504,605,2428,303,498,8,373,1148,2330,92,60
567,250,16,469,749,2051,227,490,80,393,687,1877,92,61
106,247,21,615,435,1424,51,434,88,403,474,1450,92,62
88,88,9,658,276,1119,49,207,11,473,497,1237,92,63
806,128,10,439,406,1789,249,292,15,341,910,1807,92,64
1147,153,14,486,559,2359,339,467,16,342,1228,2392,92,65
1168,136,19,462,611,2396,327,484,31,366,1150,2358,92,66
1085,198,12,512,675,2482,315,664,35,362,1132,2508,92,67
575,233,13,530,654,2005,240,466,65,420,718,1909,92,68
103,181,9,624,395,1312,58,404,56,403,378,1299,92,69
66,114,15,563,278,1036,28,234,8,379,468,1117,92,70
774,172,10,399,425,1780,252,413,11,310,852,1838,92,71
1223,215,13,540,623,2614,311,563,18,360,1387,2639,92,72
1215,206,11,576,675,2683,323,615,24,393,1325,2680,92,73
1115,257,10,640,778,2800,326,647,69,437,1241,2720,92,74
580,266,11,598,723,2178,270,539,107,484,788,2188,92,75
433,355,21,1048,608,2465,61,727,73,782,714,2357,92,76
131,116,1,644,390,1282,40,397,8,401,561,1407,92,77
801,178,4,509,532,2024,255,427,8,357,1005,2052,92,78
1255,260,13,629,588,2745,343,610,16,421,1400,2790,92,79
1259,252,0,608,823,2942,318,759,8,410,1330,2825,92,80
1135,258,1,595,736,2725,346,678,6,377,1207,2614,92,81
614,335,15,616,1022,2602,469,646,67,477,760,2419,92,82
91,327,16,672,717,1823,241,532,52,379,507,1711,92,83
158,133,2,936,355,1584,49,317,5,535,750,1656,92,84
776,191,7,556,610,2140,223,500,118,394,995,2230,92,85
1224,202,2,543,688,2659,293,615,10,359,1320,2597,92,86
1116,182,2,428,598,2326,286,491,8,383,1116,2284,92,87
964,236,6,604,570,2380,248,492,13,406,1116,2275,92,88
467,270,18,675,677,2107,203,584,57,431,731,2006,92,89
157,240,19,1026,556,1998,49,578,34,517,692,1870,92,90
79,88,1,667,240,1075,72,262,8,393,442,1177,92,91
669,209,2,526,504,1910,202,481,12,324,922,1941,92,92
1199,172,2,546,493,2412,305,447,10,367,1330,2459,92,93
1145,186,1,499,558,2389,300,553,7,326,1193,2379,92,94
1182,249,1,631,673,2736,309,648,9,433,1203,2602,92,95
613,283,16,606,798,2316,244,597,77,446,754,2118,92,96
210,283,14,994,517,2018,45,564,63,593,649,1914,92,97
451,118,3,772,405,1749,48,445,5,712,568,1778,92,98
758,198,9,552,424,1941,260,326,42,411,938,1977,92,99
1173,207,9,511,539,2439,295,550,27,361,1282,2515,92,100
1227,206,18,539,632,2622,332,586,35,399,1236,2588,92,101
1083,206,7,555,653,2504,330,595,16,414,1095,2450,92,102
588,308,20,579,690,2185,283,529,59,427,806,2104,92,103
168,279,25,985,617,2074,69,560,92,561,689,1971,92,104
85,144,3,805,324,1361,47,325,8,493,597,1470,92,105
813,191,3,512,594,2113,312,482,8,414,937,2153,92,106
1273,215,2,543,603,2636,349,531,8,400,1331,2619,92,107
1275,213,5,500,597,2590,325,575,8,398,1277,2583,92,108
1096,264,3,586,679,2628,310,651,11,403,1151,2526,92,109
571,297,25,590,802,2285,245,598,70,442,783,2138,92,110
132,261,18,1145,660,2216,42,685,63,481,771,2042,92,111
72,114,2,582,298,1068,39,258,6,412,469,1184,92,112
756,196,5,438,490,1885,280,396,6,348,925,1955,92,113
1247,248,7,548,703,2753,347,566,11,426,1252,2602,92,114
1168,234,3,533,764,2702,357,705,17,438,1171,2688,92,115
1127,255,2,579,767,2730,353,636,13,405,1184,2591,92,116
602,266,10,601,806,2285,250,629,49,430,782,2140,92,117
162,219,10,780,538,1709,49,469,180,450,511,1659,92,118
105,183,2,692,434,1416,35,420,40,432,605,1532,92,119
741,170,19,408,468,1806,273,389,25,356,890,1933,92,120
1233,198,1,511,586,2529,365,512,8,437,1234,2556,92,121
1143,193,3,525,671,2535,352,599,14,377,1211,2553,92,122
1108,233,4,571,649,2565,295,601,23,395,1110,2424,92,123
566,273,13,514,771,2137,227,574,60,425,714,2000,92,124
148,190,6,820,380,1544,54,403,59,463,453,1432,92,125
94,95,1,558,285,1033,24,295,12,386,409,1126,92,126
762,150,22,411,448,1793,247,369,27,328,851,1822,92,127
1199,215,1,503,759,2677,372,709,4,418,1185,2688,92,128
1220,199,10,531,754,2714,371,665,22,405,1221,2684,92,129
1042,187,13,565,666,2473,304,592,25,393,1090,2404,92,130
594,251,9,501,563,1918,218,434,34,387,733,1806,92,131
187,187,6,861,471,1712,69,376,46,455,653,1599,92,132
92,121,1,620,232,1066,44,250,5,357,473,1129,92,133
765,174,5,466,443,1853,262,407,17,336,968,1990,92,134
1182,153,2,534,533,2404,323,433,9,338,1271,2374,92,135
1172,171,10,551,613,2517,344,551,22,384,1123,2424,92,136
1079,257,22,555,668,2581,327,590,47,392,1148,2504,92,137
574,267,5,539,565,1950,224,447,63,343,713,1790,92,138
145,211,17,653,395,1421,41,440,59,395,472,1407,92,139
147,116,1,625,280,1169,53,292,11,458,468,1282,92,140
778,175,6,423,544,1926,259,452,8,348,897,1964,92,141
1132,219,3,506,712,2572,339,661,10,357,1280,2647,92,142
1159,195,0,535,643,2532,346,536,8,383,1250,2523,92,143
1004,144,5,489,612,2254,307,516,10,408,1028,2269,92,144
476,244,12,567,636,1935,263,493,55,419,570,1800,92,145
124,143,9,711,525,1512,43,537,47,392,437,1456,92,146
109,173,2,646,327,1257,42,361,19,374,428,1224,92,147
96,116,6,361,208,787,39,241,6,290,387,963,92,148
1072,147,3,484,513,2219,306,412,9,347,1212,2286,92,149
1175,182,2,473,494,2326,335,425,6,388,1158,2312,92,150
1093,223,5,578,638,2537,287,567,13,392,1158,2417,92,151
535,306,19,538,568,1966,234,459,51,392,757,1893,92,152
113,292,18,701,482,1606,54,535,57,441,478,1565,92,153
83,118,1,577,282,1061,48,267,4,427,458,1204,92,154
837,168,13,440,814,2272,532,472,18,351,1021,2394,92,155
1314,434,5,505,756,3014,379,648,5,401,1548,2981,92,156
1274,177,4,550,617,2622,614,506,7,380,1216,2723,92,157
1150,266,1,481,835,2733,330,684,13,340,1244,2611,92,158
657,299,9,747,1089,2801,323,837,100,567,808,2635,92,159
146,280,24,1175,801,2426,61,926,90,506,675,2258,92,160
125,157,1,729,317,1329,39,336,3,410,592,1380,92,161
848,153,19,471,569,2060,262,380,21,386,1041,2090,92,162
1256,492,28,534,596,2906,378,548,31,393,1594,2944,92,163
1237,225,1,597,729,2789,371,647,21,437,1329,2805,92,164
1140,274,3,656,756,2829,357,603,14,497,1213,2684,92,165
605,294,9,841,837,2586,383,645,78,662,754,2522,92,166
139,260,28,744,548,1719,66,524,57,501,518,1666,92,167
84,101,3,532,223,943,55,253,4,349,440,1101,92,168
835,151,2,438,470,1896,266,354,8,357,994,1979,92,169
1249,448,11,516,654,2878,278,590,18,427,1432,2745,92,170
315,159,3,630,496,1603,144,457,7,416,592,1616,92,171
1120,298,5,531,702,2656,347,565,19,369,1195,2495,92,172
614,317,14,685,589,2219,283,464,49,569,719,2084,92,173
125,312,12,606,537,1592,69,602,97,493,408,1669,92,174
89,111,6,480,301,987,46,280,17,347,387,1077,92,175
924,178,3,466,517,2088,283,391,7,382,1101,2164,92,176
1231,452,1,554,640,2878,385,545,9,394,1547,2880,92,177
1200,184,4,573,663,2624,410,559,9,406,1244,2628,92,178
1137,275,10,576,730,2728,319,585,24,423,1277,2628,92,179
632,283,22,793,628,2358,325,514,59,586,768,2252,92,180
145,225,19,690,469,1548,71,445,61,431,505,1513,92,181
103,106,2,498,320,1029,59,249,6,386,384,1084,92,182
806,136,5,438,668,2053,277,510,8,350,942,2087,92,183
1067,458,3,564,658,2750,343,506,12,426,1414,2701,92,184
821,227,10,642,750,2450,267,577,23,509,852,2228,92,185
138,917,6,800,584,2445,45,1260,33,485,517,2340,92,186
286,209,9,553,451,1508,149,375,33,337,510,1404,92,187
122,184,10,637,344,1297,74,369,51,396,399,1289,92,188
85,128,3,516,232,964,49,301,5,350,424,1129,92,189
784,140,8,425,544,1901,307,363,11,366,900,1947,92,190
1133,397,2,491,673,2696,425,442,8,423,1381,2679,92,191
1117,193,14,517,639,2480,393,466,16,388,1183,2446,92,192
1018,223,1,535,746,2523,397,561,14,439,1092,2503,92,193
593,263,14,640,678,2188,363,487,57,489,670,2066,92,194
157,255,21,708,644,1785,79,605,53,415,554,1706,92,195
117,150,1,585,290,1143,53,280,17,464,415,1229,92,196
799,172,1,437,516,1925,309,357,6,344,960,1976,92,197
1184,395,2,490,726,2797,405,515,8,391,1545,2864,92,198
1192,182,4,558,617,2553,437,410,12,416,1192,2467,92,199
1083,293,1,553,691,2621,316,611,14,381,1195,2517,92,200
561,323,19,610,778,2291,283,572,129,570,697,2251,92,201
131,253,13,652,563,1612,68,625,76,444,468,1681,92,202
94,124,1,598,289,1106,59,290,12,463,531,1355,92,203
765,141,2,391,583,1882,296,414,7,314,1016,2047,92,204
1231,342,26,496,870,2965,400,608,31,357,1536,2932,92,205
1151,185,6,567,781,2690,395,664,15,394,1183,2651,92,206
1086,238,2,829,713,2868,336,557,17,600,1183,2693,92,207
587,287,16,563,685,2138,279,467,125,416,742,2029,92,208
145,263,13,724,553,1698,68,509,123,444,578,1722,92,209
109,129,2,513,331,1084,54,262,5,386,463,1170,92,210
799,170,6,466,602,2043,308,402,47,380,921,2058,92,211
1147,179,6,518,614,2464,401,447,25,360,1274,2507,92,212
1149,213,1,593,659,2615,409,507,5,435,1213,2569,92,213
1075,203,5,520,695,2498,349,545,13,378,1162,2447,92,214
560,315,12,624,740,2251,296,594,50,577,685,2202,92,215
153,208,17,712,436,1526,105,348,47,424,502,1426,92,216
115,127,1,647,266,1156,57,297,4,415,491,1264,92,217
730,157,8,419,573,1887,325,406,11,309,905,1956,92,218
1128,242,15,526,698,2609,435,515,16,431,1242,2639,92,219
1083,211,13,529,669,2505,428,493,27,419,1157,2524,92,220
879,185,3,577,558,2202,335,372,8,411,1004,2130,92,221
434,300,9,468,678,1889,263,498,87,384,579,1811,92,222
131,238,12,665,553,1599,64,497,62,433,468,1524,92,223
68,132,0,612,326,1138,45,302,4,415,537,1303,92,224
707,181,8,435,508,1839,280,372,12,344,888,1896,92,225
1055,196,4,539,669,2463,416,541,9,396,1203,2565,92,226
1019,205,4,568,675,2471,378,490,13,414,1142,2437,92,227
991,209,9,500,611,2320,317,520,35,346,1072,2290,92,228
508,332,9,561,588,1998,270,493,66,427,740,1996,92,229
137,248,9,742,495,1631,65,406,62,492,502,1527,92,230
78,141,2,556,292,1069,32,259,2,425,514,1232,92,231
719,143,5,410,444,1721,251,300,10,350,858,1769,92,232
1144,199,5,526,640,2514,385,572,8,377,1218,2560,92,233
1160,210,12,522,695,2599,402,561,20,355,1220,2558,92,234
945,208,18,514,692,2377,307,501,23,370,1090,2291,92,235
567,309,18,476,592,1962,256,532,70,385,679,1922,92,236
171,263,21,789,456,1700,78,537,94,482,488,1679,92,237
86,151,18,647,305,1207,42,285,26,403,489,1245,92,238
773,176,32,435,642,2058,321,523,35,342,897,2118,92,239
1176,242,5,483,804,2710,425,680,9,361,1214,2689,92,240
1159,254,6,505,816,2740,407,614,8,405,1208,2642,92,241
1000,212,10,517,623,2362,326,427,35,425,1058,2271,92,242
492,260,13,522,707,1994,214,521,60,429,551,1775,92,243
91,162,11,728,420,1412,53,401,57,397,475,1383,92,244
76,144,5,525,301,1051,32,276,11,341,486,1146,92,245
77,110,7,437,243,874,49,241,10,327,410,1037,92,246
1107,185,9,473,559,2333,392,410,13,411,1171,2397,92,247
1233,228,14,489,654,2618,403,454,18,418,1287,2580,92,248
1120,229,20,484,577,2430,316,460,27,393,1215,2411,92,249
564,311,19,469,546,1909,261,469,51,405,727,1913,92,250
147,226,21,785,656,1835,146,548,97,533,503,1827,92,251
98,133,3,572,333,1139,44,250,8,449,441,1192,92,252
832,230,2,476,514,2054,304,413,4,356,967,2044,92,253
1312,273,4,552,765,2906,448,597,19,432,1378,2874,92,254
1252,231,9,567,790,2849,473,573,14,441,1346,2847,92,255
1156,244,7,589,815,2811,411,665,19,427,1193,2715,92,256
591,290,10,556,773,2220,248,627,85,457,702,2119,92,257
126,260,14,810,673,1883,68,604,63,530,597,1862,92,258
154,115,13,703,316,1301,47,258,16,556,565,1442,92,259
889,224,28,433,534,2108,304,421,23,370,978,2096,92,260
1302,221,6,555,712,2796,464,512,5,409,1345,2735,92,261
1220,236,4,615,710,2785,421,559,14,444,1311,2749,92,262
1156,260,12,569,777,2774,323,691,21,394,1199,2628,92,263
632,309,18,552,647,2158,281,507,60,468,756,2072,92,264
137,246,13,848,550,1794,66,500,90,513,564,1733,92,265
100,143,2,610,287,1142,50,262,5,420,472,1209,92,266
893,175,1,412,502,1983,329,368,5,368,986,2056,92,267
1318,228,13,536,705,2800,416,558,26,370,1409,2779,92,268
1286,239,10,535,775,2845,424,636,18,411,1343,2832,92,269
1158,247,8,570,710,2693,346,538,30,447,1244,2605,92,270
563,284,21,553,729,2150,237,579,68,413,715,2012,92,271
123,331,16,940,669,2079,59,669,93,517,608,1946,92,272
83,111,4,562,328,1088,49,282,5,381,523,1240,92,273
805,199,2,474,501,1981,289,376,6,382,945,1998,92,274
1254,224,8,518,702,2706,426,514,15,393,1301,2649,92,275
1209,216,3,566,725,2719,382,558,4,418,1297,2659,92,276
1062,252,8,632,732,2686,328,583,11,408,1209,2539,92,277
602,296,22,590,648,2158,278,518,63,479,720,2058,92,278
143,305,12,936,610,2006,84,532,77,521,633,1847,92,279
112,112,2,636,330,1192,50,260,12,469,549,1340,92,280
902,205,5,466,502,2080,314,402,11,384,994,2105,92,281
1316,253,10,621,645,2845,427,565,15,388,1418,2813,92,282
1301,259,17,563,714,2854,390,577,30,431,1431,2859,92,283
1150,270,12,534,747,2713,325,590,28,413,1234,2590,92,284
578,303,17,674,631,2203,239,468,64,486,806,2063,92,285
161,267,13,891,528,1860,70,517,60,519,614,1780,92,286
211,165,1,647,402,1426,85,346,13,575,555,1574,92,287
434,144,3,595,414,1590,161,362,6,385,727,1641,92,288
1350,267,16,648,814,3095,451,651,25,462,1427,3016,92,289
1369,261,14,654,692,2990,444,560,25,461,1407,2897,92,290
1188,258,3,598,849,2896,321,709,7,431,1269,2737,92,291
561,314,30,560,699,2164,269,516,57,431,791,2064,92,292
162,259,26,866,484,1797,68,539,70,569,545,1791,92,293
99,135,14,649,399,1296,48,375,19,417,494,1353,92,294
908,209,20,473,591,2201,348,412,38,380,1044,2222,92,295
1353,238,13,577,668,2849,434,544,16,421,1411,2826,92,296
1295,275,12,571,818,2971,434,685,20,419,1405,2963,92,297
1242,289,12,613,749,2905,342,665,22,425,1318,2772,92,298
646,360,27,613,729,2375,267,569,61,471,858,2226,92,299
179,349,24,817,523,1892,82,553,84,465,629,1813,92,300
604,149,9,853,425,2040,107,397,14,831,613,1962,92,301
874,211,15,447,573,2120,343,384,21,378,1041,2167,92,302
1276,250,4,592,1057,3179,432,936,12,464,1309,3153,92,303
1260,215,2,634,817,2928,423,615,8,428,1392,2866,92,304
1117,305,1,563,769,2755,319,537,31,468,1306,2661,92,305
602,338,32,587,680,2239,246,547,84,439,828,2144,92,306
142,349,27,803,567,1888,72,569,88,505,633,1867,92,307
113,112,6,621,274,1126,51,252,12,493,456,1264,92,308
872,182,8,466,567,2095,316,392,9,388,1014,2119,92,309
1044,202,3,548,529,2326,307,355,29,418,1112,2221,92,310
1062,225,23,508,761,2579,385,471,35,394,1210,2495,92,311
1200,253,16,540,660,2669,335,510,33,429,1207,2514,92,312
623,276,16,592,712,2219,350,473,59,406,768,2056,92,313
129,265,35,747,458,1634,75,407,71,473,540,1566,92,314
90,131,2,591,314,1128,48,228,10,375,562,1223,92,315
459,190,3,530,377,1559,142,340,8,407,710,1607,92,316
1294,223,6,555,661,2739,443,455,12,399,1377,2686,92,317
1339,231,2,540,754,2866,468,601,18,454,1324,2865,92,318
1273,240,4,572,660,2749,316,496,14,445,1288,2559,92,319
612,304,15,538,616,2085,249,438,71,430,764,1952,92,320
126,315,19,750,462,1672,64,425,53,482,615,1639,92,321
103,109,1,511,340,1064,48,246,10,417,426,1147,92,322
945,196,15,440,513,2109,309,346,15,372,1034,2076,92,323
1398,229,8,540,710,2885,449,528,9,407,1402,2795,92,324
1333,241,4,565,744,2887,411,530,10,436,1405,2792,92,325
1211,246,12,500,700,2669,306,613,18,408,1231,2576,92,326
617,269,9,487,603,1985,237,465,43,393,796,1934,92,327
101,267,12,712,576,1668,63,495,55,434,496,1543,92,328
103,114,2,542,263,1024,46,232,5,326,422,1031,92,329
750,155,5,407,420,1737,209,299,13,305,822,1648,92,330
733,176,12,453,426,1800,219,293,15,360,877,1764,92,331
461,125,3,456,383,1428,170,235,5,368,466,1244,92,332
53,66,2,173,110,404,28,101,4,122,157,412,92,333
155,112,3,520,245,1035,78,304,21,301,451,1155,92,334
128,121,8,383,274,914,49,280,19,271,397,1016,92,335
66,101,0,443,254,864,53,269,4,340,440,1106,92,336
784,151,3,367,474,1779,273,372,5,345,893,1888,92,337
1259,226,32,532,771,2820,412,624,42,405,1299,2782,92,338
1258,206,6,558,702,2730,416,537,12,413,1315,2693,92,339
1125,220,1,516,746,2608,290,654,9,391,1156,2500,92,340
604,299,13,555,722,2193,281,544,76,422,726,2049,92,341
112,254,9,881,694,1950,72,531,68,505,593,1769,92,342
85,135,1,668,403,1292,41,350,11,426,544,1372,92,343
836,180,4,414,544,1978,328,415,4,320,954,2021,92,344
1346,182,15,505,684,2732,403,579,23,389,1240,2634,92,345
1269,173,5,587,667,2701,434,582,9,392,1203,2620,92,346
1203,255,1,563,793,2815,351,723,19,407,1129,2629,92,347
593,355,25,597,721,2291,270,637,68,428,784,2187,92,348
206,272,17,904,626,2025,50,606,83,543,652,1934,92,349
89,96,5,670,339,1199,38,268,9,438,462,1215,92,350
838,174,3,435,480,1930,257,339,11,360,896,1863,92,351
1189,188,8,524,687,2596,379,514,15,375,1237,2520,92,352
1132,152,2,536,678,2500,354,447,11,360,1154,2326,92,353
950,204,7,512,664,2337,270,543,6,353,932,2104,92,354
407,164,15,411,472,1469,158,271,20,268,448,1165,92,355
73,147,4,427,281,932,37,171,12,255,327,802,92,356
55,77,3,366,210,711,32,144,6,214,233,629,92,357
242,81,1,327,253,904,113,126,4,235,289,767,92,358
116,46,4,226,121,513,59,62,11,140,153,425,92,359
19,36,2,105,82,244,19,63,4,76,77,239,92,360
142,63,10,235,181,631,80,132,10,176,263,661,92,361
182,92,8,267,219,768,91,189,11,198,266,755,92,362
44,103,6,257,193,603,48,202,22,174,221,667,92,363
44,75,3,324,181,627,31,151,6,234,227,649,92,364
316,98,3,384,352,1153,126,252,8,317,486,1189,92,365
298,329,143,538,306,1614,124,337,247,363,519,1590,92,366
95,236,5,475,458,1269,109,222,8,414,450,1203,93,1
584,337,8,664,879,2472,528,385,5,587,989,2494,93,2
796,337,7,691,863,2694,692,452,9,640,1099,2892,93,3
714,346,2,556,797,2415,622,445,1,517,1061,2646,93,4
469,530,38,585,876,2498,521,572,33,534,1039,2699,93,5
110,359,29,559,491,1548,105,366,37,614,440,1562,93,6
107,240,3,646,544,1540,99,284,4,640,610,1637,93,7
698,225,4,539,912,2378,629,397,1,494,1021,2542,93,8
868,258,1,523,678,2328,619,326,3,537,1092,2577,93,9
883,362,1,613,915,2774,711,534,4,587,1161,2997,93,10
750,360,7,622,922,2661,628,589,10,534,1118,2879,93,11
547,461,27,658,788,2481,491,538,37,656,918,2640,93,12
118,422,33,842,775,2190,126,464,42,763,845,2240,93,13
86,308,5,674,533,1606,102,336,7,646,653,1744,93,14
134,185,4,592,419,1334,136,338,5,474,497,1450,93,15
331,203,2,431,556,1523,320,383,2,377,546,1628,93,16
795,349,10,630,917,2701,563,526,18,569,1193,2869,93,17
901,317,4,673,1000,2895,651,606,7,630,1179,3073,93,18
370,371,37,539,634,1951,276,488,41,427,640,1872,93,19
129,395,42,777,622,1965,128,478,51,703,680,2040,93,20
72,215,0,676,475,1438,102,302,0,528,585,1517,93,21
749,221,3,545,955,2473,706,403,5,522,1052,2688,93,22
918,315,0,595,956,2784,665,545,2,581,1199,2992,93,23
926,390,6,588,1012,2922,707,637,6,605,1197,3152,93,24
852,406,1,631,961,2851,683,613,2,589,1076,2963,93,25
564,722,47,699,1006,3038,516,733,48,663,1130,3090,93,26
134,493,39,827,735,2228,145,585,37,815,882,2464,93,27
93,259,1,678,423,1454,121,295,0,593,577,1586,93,28
713,241,2,378,775,2109,685,447,5,373,776,2286,93,29
1062,449,2,785,1203,3501,762,594,1,684,1258,3299,93,30
1036,524,3,776,1169,3508,772,730,5,695,1461,3663,93,31
996,490,9,808,1200,3503,752,703,13,739,1284,3491,93,32
702,688,43,767,1168,3368,631,731,41,734,1139,3276,93,33
172,577,58,861,936,2604,148,615,52,802,825,2442,93,34
109,369,5,699,635,1817,129,326,10,663,653,1781,93,35
794,380,7,742,1104,3027,745,528,5,671,1136,3085,93,36
1058,407,9,778,1170,3422,781,611,9,714,1282,3397,93,37
1082,457,8,771,1231,3549,768,701,9,750,1351,3579,93,38
969,539,16,781,1146,3451,706,637,13,685,1292,3333,93,39
692,725,62,820,1216,3515,642,640,71,740,1308,3401,93,40
183,2075,100,982,3066,6406,201,761,42,1999,3452,6455,93,41
146,468,8,809,810,2241,143,491,6,724,817,2181,93,42
854,336,10,716,1118,3034,759,456,8,640,1176,3039,93,43
1063,464,7,758,1195,3487,742,729,6,639,1389,3505,93,44
1028,549,18,872,1251,3718,773,714,15,800,1491,3793,93,45
969,486,10,850,1092,3407,713,603,5,704,1250,3275,93,46
604,803,84,828,1112,3431,560,683,64,745,1263,3315,93,47
142,743,88,930,817,2720,159,608,61,777,1016,2621,93,48
126,477,6,829,853,2291,150,497,9,806,810,2272,93,49
252,377,5,767,766,2167,224,476,7,690,774,2171,93,50
931,491,7,799,1193,3421,750,639,7,759,1365,3520,93,51
1020,523,15,812,1247,3617,830,691,21,681,1378,3601,93,52
930,520,8,806,1152,3416,712,691,4,689,1338,3434,93,53
696,708,56,855,1177,3492,671,656,52,713,1213,3305,93,54
182,1444,73,965,1017,3681,188,860,73,927,1582,3630,93,55
159,383,8,811,765,2126,139,384,7,763,758,2051,93,56
817,453,2,677,1055,3004,702,589,0,615,1142,3048,93,57
1072,420,3,775,1076,3346,789,642,8,679,1339,3457,93,58
1090,492,9,774,1091,3456,771,626,11,725,1263,3396,93,59
1016,566,9,798,1277,3666,787,748,11,751,1252,3549,93,60
750,929,73,826,1216,3794,680,841,44,773,1350,3688,93,61
183,724,72,897,971,2847,165,653,54,782,905,2559,93,62
127,546,7,907,792,2379,144,437,7,901,910,2399,93,63
856,479,20,734,1205,3294,772,595,16,723,1203,3309,93,64
1154,602,33,749,1256,3794,801,675,35,729,1500,3740,93,65
1110,575,2,871,1228,3786,793,746,7,831,1435,3812,93,66
1059,638,8,886,1355,3946,784,789,6,989,1393,3961,93,67
698,758,68,849,1171,3544,654,789,68,837,1253,3601,93,68
209,526,67,936,823,2561,212,581,61,871,706,2431,93,69
120,504,13,840,654,2131,154,421,13,701,871,2160,93,70
808,560,3,763,1142,3276,708,638,1,728,1234,3309,93,71
998,881,6,848,1279,4012,780,785,4,800,1543,3912,93,72
1021,913,10,849,1463,4256,802,854,9,970,1643,4278,93,73
875,971,5,938,1397,4186,748,932,24,847,1561,4112,93,74
655,868,62,852,1305,3742,628,769,97,882,1367,3743,93,75
249,1651,93,1313,3454,6760,250,905,71,3768,2032,7026,93,76
150,729,7,942,1109,2937,157,572,6,1135,942,2812,93,77
823,538,9,758,1223,3351,787,619,8,756,1225,3395,93,78
1070,662,10,826,1362,3930,851,679,14,787,1534,3865,93,79
1088,979,8,841,1441,4357,845,882,9,849,1631,4216,93,80
1038,815,3,829,1417,4102,821,860,3,765,1548,3997,93,81
738,1036,91,999,1484,4348,719,863,67,962,1524,4135,93,82
169,1511,76,848,1060,3664,192,932,59,794,1446,3423,93,83
173,856,14,1135,1340,3518,213,485,10,1155,1089,2952,93,84
854,751,21,907,1332,3865,745,718,29,842,1407,3741,93,85
1040,646,18,926,1440,4070,844,750,18,879,1457,3948,93,86
1049,581,18,908,1263,3819,812,780,20,808,1454,3874,93,87
941,619,10,885,1256,3711,797,696,15,821,1374,3703,93,88
682,1282,84,1036,1662,4746,703,1007,58,1106,1554,4428,93,89
172,2962,93,1265,2187,6679,241,1365,57,1578,2695,5936,93,90
148,613,4,1016,1424,3205,209,470,7,1481,877,3044,93,91
742,563,10,880,1248,3443,723,598,11,781,1315,3428,93,92
1022,658,9,834,1286,3809,791,718,12,819,1550,3890,93,93
1087,611,16,794,1245,3753,855,777,20,704,1369,3725,93,94
979,704,13,937,1339,3972,839,776,21,839,1530,4005,93,95
646,835,61,971,1293,3806,619,955,64,976,1337,3951,93,96
255,1059,64,1212,1135,3725,254,816,42,1149,1224,3485,93,97
195,923,4,945,1075,3142,236,518,6,1133,985,2878,93,98
769,656,4,743,1138,3310,735,618,7,758,1240,3358,93,99
1002,610,8,808,1193,3621,821,686,6,833,1359,3705,93,100
983,678,7,849,1196,3713,788,679,8,835,1397,3707,93,101
984,563,5,710,1128,3390,809,617,4,671,1428,3529,93,102
632,813,71,830,1246,3592,665,760,61,804,1250,3540,93,103
188,1550,95,1010,1260,4103,240,1055,73,1082,1602,4052,93,104
144,708,5,976,956,2789,193,501,7,960,932,2593,93,105
686,543,3,733,1024,2989,673,624,7,741,1059,3104,93,106
791,798,6,713,1157,3465,527,689,7,756,1488,3467,93,107
853,524,21,869,1002,3269,769,643,13,832,1043,3300,93,108
838,710,10,1093,1180,3831,778,747,5,968,1289,3787,93,109
553,795,53,810,1070,3281,602,794,43,844,1229,3512,93,110
154,1552,88,1020,1959,4773,199,961,46,1978,1472,4656,93,111
129,542,7,656,746,2080,147,444,7,748,787,2133,93,112
791,482,10,725,1016,3024,731,582,7,713,1140,3173,93,113
1014,631,20,802,1189,3656,797,687,21,794,1310,3609,93,114
997,709,6,815,1181,3708,785,654,6,753,1473,3671,93,115
922,813,7,976,1183,3901,795,728,7,1007,1455,3992,93,116
666,1499,87,891,1184,4327,649,992,43,886,1888,4458,93,117
173,1219,77,904,912,3285,202,879,62,886,1183,3212,93,118
141,686,7,929,1170,2933,208,508,26,1296,942,2980,93,119
797,527,4,751,1112,3191,750,563,11,697,1198,3219,93,120
999,656,3,765,1164,3587,855,661,3,752,1480,3751,93,121
1007,783,10,855,1221,3876,880,734,10,849,1528,4001,93,122
978,896,9,740,1196,3819,804,775,17,712,1601,3909,93,123
702,964,70,895,1258,3889,668,865,63,898,1465,3959,93,124
180,1189,60,994,824,3247,202,769,45,905,1298,3219,93,125
127,867,7,794,621,2416,151,506,11,788,994,2450,93,126
768,445,9,725,1039,2986,735,487,9,718,1141,3090,93,127
996,821,5,788,1138,3748,772,635,8,803,1467,3685,93,128
961,761,2,761,1205,3690,843,763,4,741,1371,3722,93,129
869,570,4,747,1234,3424,773,644,3,717,1286,3423,93,130
644,859,55,759,1033,3350,647,690,50,760,1325,3472,93,131
197,576,55,936,948,2712,215,585,43,929,1044,2816,93,132
124,474,5,773,814,2190,199,419,6,917,676,2217,93,133
793,500,3,753,1152,3201,755,566,18,732,1164,3235,93,134
1003,529,11,756,1129,3428,806,630,13,777,1346,3572,93,135
1001,1115,33,821,1110,4080,815,883,32,768,1683,4181,93,136
917,727,32,790,1184,3650,774,703,38,851,1358,3724,93,137
630,770,86,827,1231,3544,680,718,73,834,1321,3626,93,138
179,1262,71,884,744,3140,196,797,61,817,1185,3056,93,139
183,622,3,839,1212,2859,161,484,5,1228,943,2821,93,140
873,658,1,739,1145,3416,737,597,2,745,1278,3359,93,141
1045,631,5,796,1142,3619,818,616,12,802,1399,3647,93,142
982,753,6,841,1232,3814,851,647,10,867,1509,3884,93,143
873,592,4,819,1094,3382,781,566,5,801,1222,3375,93,144
655,1680,99,916,1221,4571,693,1008,62,917,1909,4589,93,145
193,1782,52,931,1006,3964,207,911,59,1108,1487,3772,93,146
166,847,8,919,957,2897,214,585,8,1055,1105,2967,93,147
147,423,0,719,652,1941,179,339,0,762,681,1961,93,148
895,528,8,823,1033,3287,820,517,6,825,1319,3487,93,149
967,542,4,854,1173,3540,959,633,8,752,1329,3681,93,150
890,744,4,845,1217,3700,831,656,2,985,1565,4039,93,151
665,886,116,820,1201,3688,763,775,58,849,1399,3844,93,152
181,1672,96,1049,1004,4002,256,1036,61,1101,1539,3993,93,153
144,587,3,865,985,2584,213,476,6,1101,861,2657,93,154
823,572,14,733,1104,3246,754,555,18,748,1207,3282,93,155
991,723,17,781,1289,3801,827,738,17,836,1406,3824,93,156
1017,679,7,876,1180,3759,856,724,7,853,1464,3904,93,157
943,1006,3,811,1297,4060,807,862,6,798,1590,4063,93,158
721,1337,88,979,1431,4556,1425,1070,90,1182,1438,5205,93,159
205,2240,127,1305,1407,5284,237,1808,93,1199,1758,5095,93,160
150,795,27,872,1022,2866,159,548,24,1065,1485,3281,93,161
875,624,4,793,1133,3429,797,568,6,825,1279,3475,93,162
1025,1052,17,797,1309,4200,979,818,11,769,1704,4281,93,163
1013,1215,6,881,1351,4466,866,884,7,958,1830,4545,93,164
926,979,5,862,1304,4076,872,852,3,876,1590,4193,93,165
686,1540,84,880,1258,4448,723,965,60,893,1714,4355,93,166
176,2442,137,1099,1152,5006,241,1225,79,1237,2066,4848,93,167
183,693,4,847,965,2692,193,534,15,1043,883,2668,93,168
739,560,2,700,1085,3086,722,531,10,683,1194,3140,93,169
912,868,22,721,1260,3783,761,962,37,809,1478,4047,93,170
328,1696,13,994,1121,4152,320,881,14,1117,1703,4035,93,171
821,939,3,853,1276,3892,766,816,10,832,1495,3919,93,172
557,1025,72,851,1213,3718,699,892,46,824,1335,3796,93,173
200,1719,135,989,1059,4102,297,1117,69,1150,1657,4290,93,174
161,671,7,867,833,2539,209,518,15,975,844,2561,93,175
733,627,2,727,1103,3192,741,586,5,740,1255,3327,93,176
892,768,2,841,1219,3722,803,792,7,849,1438,3889,93,177
930,773,5,853,1312,3873,826,733,6,848,1496,3909,93,178
842,1010,2,962,1201,4017,827,811,5,918,1623,4184,93,179
637,1064,85,828,1250,3864,654,839,66,942,1407,3908,93,180
176,2092,96,952,1149,4465,243,1187,91,1102,1764,4387,93,181
142,864,7,811,685,2509,185,443,3,847,1027,2505,93,182
711,662,1,777,1129,3280,698,650,5,801,1201,3355,93,183
811,913,3,926,1284,3937,801,753,5,891,1637,4087,93,184
727,2190,9,1066,1294,5286,732,1111,7,1053,2033,4936,93,185
181,3773,22,1247,1577,6800,234,2721,25,1394,2477,6851,93,186
384,1055,64,1003,1147,3653,486,849,34,1042,1287,3698,93,187
193,1090,73,944,1065,3365,244,813,54,1112,1120,3343,93,188
145,613,5,801,839,2403,213,462,5,909,919,2508,93,189
758,578,3,761,1143,3243,723,546,3,809,1227,3308,93,190
944,709,22,845,1178,3698,796,710,20,902,1496,3924,93,191
920,651,3,890,1294,3758,827,738,4,859,1619,4047,93,192
851,836,8,862,1295,3852,759,750,11,947,1458,3925,93,193
625,1339,71,819,1159,4013,707,743,53,857,1805,4165,93,194
188,2222,113,950,1181,4654,262,1024,63,1298,1736,4383,93,195
150,732,7,892,802,2583,222,513,7,915,959,2616,93,196
717,553,8,701,1063,3042,710,543,5,684,1122,3064,93,197
887,1517,5,824,1073,4306,763,886,6,785,1991,4431,93,198
875,473,15,844,1216,3423,750,555,10,833,1384,3532,93,199
859,854,21,815,1227,3776,773,827,23,837,1429,3889,93,200
572,1326,135,866,1172,4071,622,947,95,894,1464,4022,93,201
170,2045,97,1026,1062,4400,237,992,65,1181,1553,4028,93,202
179,662,8,838,883,2570,226,526,7,932,893,2584,93,203
711,518,15,670,1056,2970,728,583,12,682,1050,3055,93,204
907,634,15,881,1319,3756,822,742,15,846,1467,3892,93,205
939,932,17,908,1397,4193,825,823,18,910,1604,4180,93,206
884,745,14,837,1239,3719,800,720,16,820,1433,3789,93,207
644,979,55,899,1240,3817,662,765,79,1003,1312,3821,93,208
176,1979,165,1086,1110,4516,269,942,87,1583,1750,4631,93,209
146,1717,8,843,858,3572,208,695,8,1181,1477,3569,93,210
717,842,5,829,1221,3614,740,562,6,798,1256,3362,93,211
955,688,11,815,1161,3630,820,682,13,772,1473,3760,93,212
950,750,4,766,1242,3712,796,677,4,733,1474,3684,93,213
902,859,3,859,1277,3900,822,820,4,833,1510,3989,93,214
591,1058,98,866,1244,3857,640,950,65,848,1412,3915,93,215
187,710,68,1034,1039,3038,238,574,50,1051,1094,3007,93,216
145,622,15,864,838,2484,191,458,18,884,890,2441,93,217
705,610,7,760,1076,3158,694,575,4,755,1233,3261,93,218
878,623,4,815,1274,3594,822,656,7,824,1397,3706,93,219
932,631,10,823,1154,3550,798,682,6,788,1430,3704,93,220
845,452,10,789,1093,3189,732,580,7,737,1160,3216,93,221
502,946,51,778,900,3177,556,795,63,668,1130,3212,93,222
167,1244,81,986,1061,3539,237,860,56,1012,1306,3471,93,223
114,593,13,810,834,2364,187,455,9,865,854,2370,93,224
707,603,5,771,1073,3159,679,538,9,837,1233,3296,93,225
868,784,7,807,1120,3586,742,725,5,793,1473,3738,93,226
874,774,4,850,1260,3762,761,767,3,778,1476,3785,93,227
807,891,12,894,1204,3808,690,823,30,853,1554,3950,93,228
567,1137,64,932,1088,3788,650,825,69,881,1448,3873,93,229
175,943,52,947,1053,3170,255,722,62,991,1115,3145,93,230
140,670,9,798,1544,3161,207,456,12,1504,911,3090,93,231
705,437,21,774,1063,3000,694,465,23,688,1241,3111,93,232
875,655,3,796,1239,3568,759,786,4,770,1396,3715,93,233
875,702,9,849,1233,3668,777,711,6,831,1385,3710,93,234
836,692,7,866,1227,3628,763,714,7,909,1406,3799,93,235
574,929,93,908,1221,3725,652,844,59,897,1420,3872,93,236
220,1548,84,1091,1068,4011,267,1123,43,1057,1644,4134,93,237
117,621,7,978,1489,3212,222,471,9,1640,966,3308,93,238
814,490,2,764,1113,3183,749,571,2,774,1199,3295,93,239
1071,738,1,760,1295,3865,872,682,7,721,1520,3802,93,240
1038,658,1,859,1271,3827,799,713,3,838,1507,3860,93,241
947,429,8,877,1257,3518,765,593,8,780,1498,3644,93,242
697,870,66,904,1083,3620,702,778,50,884,1351,3765,93,243
174,1340,61,1047,1292,3914,244,730,42,1296,1502,3814,93,244
159,1271,12,863,1187,3492,193,644,8,1131,1384,3360,93,245
121,648,1,719,857,2346,175,484,3,840,903,2405,93,246
1042,499,1,814,1193,3549,815,598,5,772,1493,3683,93,247
1072,599,8,882,1250,3811,863,758,11,809,1458,3899,93,248
1059,598,2,892,1214,3765,838,683,5,826,1528,3880,93,249
734,1103,79,887,1210,4013,751,929,64,835,1456,4035,93,250
207,1470,58,1298,1771,4804,264,824,72,2063,1205,4428,93,251
179,703,8,953,826,2669,215,454,6,953,1047,2675,93,252
955,634,1,769,1141,3500,795,675,3,636,1291,3400,93,253
1153,669,2,846,1268,3938,861,836,3,776,1536,4012,93,254
1138,853,2,856,1333,4182,887,833,1,787,1771,4279,93,255
1104,793,4,919,1313,4133,875,901,5,885,1635,4301,93,256
778,1299,79,903,1294,4353,753,1070,50,930,1759,4562,93,257
199,1934,221,1182,1156,4692,266,1183,83,1217,1934,4683,93,258
186,673,11,1042,1697,3609,229,515,12,1750,1074,3580,93,259
948,563,2,806,1143,3462,797,660,2,774,1346,3579,93,260
1160,702,5,861,1228,3956,869,757,8,777,1738,4149,93,261
1193,844,1,781,1260,4079,815,779,4,761,1808,4167,93,262
1108,756,5,890,1425,4184,1005,841,2,880,1587,4315,93,263
751,1171,81,1023,1355,4381,965,870,66,941,1587,4429,93,264
206,1860,235,1073,1117,4491,266,1036,66,1167,1826,4361,93,265
135,685,7,851,874,2552,206,536,8,890,947,2587,93,266
991,679,2,702,1120,3494,789,783,7,661,1485,3725,93,267
1220,809,7,790,1332,4158,910,825,7,764,1943,4449,93,268
1166,770,3,825,1213,3977,811,847,3,762,1695,4118,93,269
1080,690,11,935,1264,3980,836,831,9,811,1607,4094,93,270
798,842,64,882,1162,3748,725,806,64,781,1419,3795,93,271
195,2446,104,1108,1562,5415,274,1417,103,1450,1711,4955,93,272
163,541,5,892,803,2404,204,447,5,812,908,2376,93,273
985,643,15,769,1098,3510,776,630,20,715,1518,3659,93,274
1288,832,8,892,1216,4236,832,773,11,818,1767,4201,93,275
1198,748,5,990,1250,4191,875,822,9,937,1732,4375,93,276
1098,726,4,963,1350,4141,826,845,6,857,1646,4180,93,277
851,971,75,847,1277,4021,705,892,71,862,1524,4054,93,278
201,1607,122,1197,2784,5911,253,951,68,2558,2161,5991,93,279
172,677,3,942,814,2608,225,499,6,888,969,2587,93,280
947,625,4,762,1118,3456,779,601,2,770,1566,3718,93,281
1183,731,16,848,1318,4096,852,817,16,804,1740,4229,93,282
1172,797,4,978,1397,4348,886,807,6,1006,1687,4392,93,283
966,856,0,953,1352,4127,800,873,4,937,1558,4172,93,284
672,1037,61,1010,1300,4080,663,902,60,978,1550,4153,93,285
226,1409,111,1110,1173,4029,280,887,72,1203,1591,4033,93,286
209,1306,1,964,1004,3484,237,542,5,1146,1642,3572,93,287
379,508,8,883,899,2677,334,586,10,765,1052,2747,93,288
1217,470,18,914,1309,3928,913,739,15,839,1574,4080,93,289
1238,806,2,964,1323,4333,1002,857,3,877,1775,4514,93,290
1076,721,13,897,1376,4083,948,893,14,872,1559,4286,93,291
839,971,82,889,1370,4151,777,900,133,871,1520,4201,93,292
219,1680,80,1174,1133,4286,259,931,87,1086,1867,4230,93,293
159,1390,5,893,815,3262,215,527,7,998,1740,3487,93,294
973,766,4,814,1238,3795,838,720,2,806,1607,3973,93,295
1234,578,1,859,1302,3974,933,743,0,878,1613,4167,93,296
1249,840,1,981,1352,4423,931,939,5,937,1727,4539,93,297
1100,777,2,1004,1429,4312,947,929,7,873,1612,4368,93,298
880,969,71,925,1241,4086,694,922,63,898,1503,4080,93,299
222,936,74,1054,1065,3351,227,823,112,1055,1110,3327,93,300
259,669,4,1005,998,2935,208,600,7,1096,1062,2973,93,301
926,439,6,829,1218,3418,832,595,5,785,1385,3602,93,302
1197,620,7,963,1505,4292,915,977,8,858,1618,4376,93,303
1206,680,11,861,1302,4060,959,807,11,764,1635,4176,93,304
1092,982,2,882,1369,4327,879,1061,9,840,1676,4465,93,305
780,1122,105,928,1208,4143,731,984,70,867,1508,4160,93,306
184,1632,103,1066,1576,4561,239,892,75,1043,2052,4301,93,307
199,452,17,972,819,2459,225,432,21,1019,825,2522,93,308
879,414,1,892,1190,3376,832,630,4,777,1276,3519,93,309
906,548,3,968,1191,3616,745,591,40,931,1278,3585,93,310
1020,621,8,785,1283,3717,807,728,11,786,1502,3834,93,311
1119,705,10,910,1209,3953,834,740,10,823,1545,3952,93,312
816,966,82,915,1268,4047,699,907,73,867,1512,4058,93,313
209,807,63,1082,1182,3343,265,626,47,1161,1184,3283,93,314
174,635,3,923,1968,3703,230,446,4,2261,988,3929,93,315
396,512,13,911,931,2763,399,526,18,805,955,2703,93,316
1224,615,5,900,1177,3921,899,777,6,849,1694,4225,93,317
1215,613,2,827,1309,3966,884,793,3,772,1715,4167,93,318
1084,729,2,882,1232,3929,810,796,14,830,1628,4078,93,319
830,1008,52,804,1135,3829,731,846,50,792,1541,3960,93,320
212,883,82,1085,2258,4520,281,764,68,2558,1244,4915,93,321
185,477,1,911,819,2393,198,481,5,972,910,2566,93,322
1007,537,4,778,1206,3532,831,664,6,793,1465,3759,93,323
1230,640,1,870,1175,3916,865,727,2,809,1652,4055,93,324
1141,614,20,973,1402,4150,878,730,20,1058,1706,4392,93,325
1093,575,38,955,1264,3925,883,806,32,858,1626,4205,93,326
873,689,85,890,1237,3774,774,756,63,878,1478,3949,93,327
220,838,61,1117,1018,3254,245,737,57,1069,1080,3188,93,328
159,462,4,887,754,2266,179,368,8,855,823,2233,93,329
816,435,9,907,1161,3328,791,520,15,805,1307,3438,93,330
848,487,1,892,1104,3332,726,511,3,809,1242,3291,93,331
498,442,2,1052,964,2958,517,467,3,838,934,2759,93,332
124,274,1,471,371,1241,109,234,3,468,347,1161,93,333
203,460,32,763,588,2046,269,478,31,676,859,2313,93,334
155,523,51,834,722,2285,213,556,28,737,887,2421,93,335
128,392,4,775,634,1933,163,455,7,785,818,2228,93,336
879,464,4,799,1049,3195,753,550,6,743,1459,3511,93,337
1192,483,10,839,1319,3843,854,753,13,787,1675,4082,93,338
1166,577,3,893,1266,3905,883,745,6,857,1692,4183,93,339
1075,628,3,926,1255,3887,832,814,3,882,1681,4212,93,340
805,749,57,932,1318,3861,717,862,67,853,1441,3940,93,341
193,4357,136,1119,1147,6952,218,1821,66,1136,4015,7256,93,342
146,710,2,1022,827,2707,179,599,3,889,1117,2787,93,343
971,477,14,786,1183,3431,762,677,15,708,1435,3597,93,344
1215,543,19,930,1326,4033,846,777,22,835,1753,4233,93,345
1260,857,4,903,1245,4269,864,893,8,888,1763,4416,93,346
1150,878,3,965,1390,4386,815,976,7,989,1800,4587,93,347
848,941,113,1021,1329,4252,697,918,80,950,1611,4256,93,348
225,985,128,1131,1234,3703,230,855,58,1170,1334,3647,93,349
134,508,1,974,873,2490,177,451,4,1029,943,2604,93,350
908,388,6,820,1143,3265,814,538,8,710,1360,3430,93,351
1108,649,4,993,1342,4096,862,761,7,854,1698,4182,93,352
1082,538,15,947,1302,3884,843,670,16,915,1521,3965,93,353
961,615,3,907,1210,3696,742,677,5,906,1456,3786,93,354
678,691,38,841,1096,3344,617,797,44,793,1191,3442,93,355
177,666,54,953,790,2640,214,565,25,874,952,2630,93,356
133,381,2,739,722,1977,157,359,3,698,731,1948,93,357
407,372,8,824,872,2483,481,357,12,714,879,2443,93,358
235,274,3,780,503,1795,329,197,4,613,593,1736,93,359
52,219,3,333,288,895,73,207,6,306,291,883,93,360
225,391,3,599,715,1933,320,374,11,628,687,2020,93,361
301,544,36,714,807,2402,406,439,25,619,962,2451,93,362
98,477,69,674,577,1895,155,466,32,621,703,1977,93,363
108,407,2,686,646,1849,153,333,5,700,661,1852,93,364
356,425,10,772,952,2515,463,540,8,741,944,2696,93,365
394,674,510,923,788,3289,385,852,281,857,1116,3491,93,366
50,36,0,105,64,255,22,57,3,82,108,272,94,1
543,74,2,239,148,1006,93,127,6,187,596,1009,94,2
643,51,6,260,175,1135,96,172,5,234,640,1147,94,3
627,43,1,205,159,1035,120,123,3,182,611,1039,94,4
352,43,3,206,189,793,92,137,23,177,397,826,94,5
48,39,5,127,98,317,19,95,16,79,102,311,94,6
34,34,3,163,71,305,15,67,5,93,136,316,94,7
548,40,0,194,145,927,92,126,3,114,605,940,94,8
745,36,3,194,107,1085,83,125,7,204,669,1088,94,9
806,53,1,288,117,1265,98,192,5,206,760,1261,94,10
740,49,1,234,218,1242,100,243,4,198,671,1216,94,11
293,41,0,160,149,643,102,84,5,141,270,602,94,12
58,28,3,262,77,428,36,67,7,83,187,380,94,13
36,27,3,103,63,232,16,48,2,72,86,224,94,14
69,34,5,120,108,336,55,62,4,73,117,311,94,15
166,32,7,135,108,448,77,70,12,98,184,441,94,16
544,60,3,209,134,950,89,155,6,160,542,952,94,17
739,64,3,254,210,1270,95,247,5,196,695,1238,94,18
307,59,8,261,108,743,63,125,20,137,322,667,94,19
51,46,0,183,124,404,17,99,19,98,160,393,94,20
34,27,1,171,77,310,23,70,6,96,108,303,94,21
562,44,3,253,155,1017,88,142,6,154,588,978,94,22
834,49,2,299,179,1363,89,237,3,191,839,1359,94,23
836,64,2,297,171,1370,106,239,3,219,796,1363,94,24
763,62,6,232,193,1256,93,210,14,211,717,1245,94,25
391,61,3,281,187,923,92,166,18,219,406,901,94,26
72,43,4,329,164,612,36,111,21,170,241,579,94,27
36,31,0,183,89,339,23,90,4,114,149,380,94,28
588,99,4,217,155,1063,98,191,6,183,618,1096,94,29
888,55,1,249,160,1353,100,208,7,233,835,1383,94,30
826,51,1,269,191,1338,82,224,7,205,792,1310,94,31
767,62,3,254,174,1260,98,210,10,199,720,1237,94,32
383,68,3,248,188,890,92,144,19,236,422,913,94,33
62,61,2,277,133,535,31,85,21,117,213,467,94,34
31,49,1,210,98,389,12,80,5,94,201,392,94,35
584,52,1,238,149,1024,96,151,3,178,599,1027,94,36
888,53,2,271,155,1369,97,218,3,214,830,1362,94,37
848,54,5,275,174,1356,102,225,9,191,811,1338,94,38
768,50,2,233,161,1214,89,220,4,198,663,1174,94,39
375,47,2,215,163,802,74,123,19,181,401,798,94,40
59,80,4,258,140,541,26,132,29,150,182,519,94,41
40,35,6,206,60,347,19,78,12,103,176,388,94,42
577,45,1,213,152,988,87,125,10,153,578,953,94,43
751,61,2,232,183,1229,83,249,5,178,708,1223,94,44
843,48,12,253,152,1308,104,283,14,177,694,1272,94,45
801,52,5,263,223,1344,93,229,12,196,1047,1577,94,46
392,71,9,239,178,889,83,145,19,192,436,875,94,47
71,57,2,227,125,482,24,114,17,134,197,486,94,48
55,37,1,220,96,409,14,99,6,113,209,441,94,49
147,24,3,210,134,518,72,101,6,150,189,518,94,50
846,56,5,275,154,1336,95,204,5,200,830,1334,94,51
876,54,9,262,184,1385,91,223,13,181,834,1342,94,52
773,68,2,261,191,1295,84,251,3,193,744,1275,94,53
432,62,3,226,156,879,75,135,24,201,450,885,94,54
73,54,4,232,130,493,39,113,29,143,198,522,94,55
46,47,4,210,104,411,19,97,8,109,165,398,94,56
596,71,1,260,200,1128,95,165,4,201,612,1077,94,57
925,53,2,256,209,1445,102,220,4,214,886,1426,94,58
866,54,3,250,167,1340,96,234,5,172,807,1314,94,59
797,75,1,254,202,1329,99,267,5,217,749,1337,94,60
415,66,4,262,229,976,109,187,18,227,432,973,94,61
60,60,3,238,115,476,28,97,22,143,189,479,94,62
45,49,2,250,114,460,17,97,0,121,233,468,94,63
639,39,2,262,150,1092,89,155,5,179,640,1068,94,64
834,55,10,283,165,1347,94,218,17,201,808,1338,94,65
898,48,0,273,179,1398,99,253,9,160,851,1372,94,66
821,81,1,275,183,1361,99,263,8,217,762,1349,94,67
423,68,3,278,179,951,91,165,14,195,495,960,94,68
84,57,7,249,132,529,29,138,22,149,198,536,94,69
32,46,1,183,83,345,15,84,6,93,176,374,94,70
603,66,1,244,166,1080,104,182,3,166,606,1061,94,71
878,52,2,367,174,1473,102,279,4,225,874,1484,94,72
859,65,2,398,190,1514,90,259,9,234,869,1461,94,73
748,58,2,370,238,1416,95,265,13,196,805,1374,94,74
409,85,6,259,228,987,93,178,49,204,419,943,94,75
173,85,9,441,163,871,39,213,34,228,359,873,94,76
53,43,3,315,141,555,18,125,5,135,281,564,94,77
648,53,1,277,183,1162,99,181,5,192,655,1132,94,78
902,49,11,371,201,1534,106,275,18,276,854,1529,94,79
888,72,6,398,258,1622,100,343,5,261,922,1631,94,80
835,53,3,343,212,1446,105,288,6,266,757,1422,94,81
427,71,7,385,291,1181,99,233,17,279,521,1149,94,82
51,81,7,239,196,574,44,152,16,125,210,547,94,83
92,47,1,534,170,844,30,156,8,219,443,856,94,84
546,59,8,390,202,1205,98,222,41,175,719,1255,94,85
777,49,1,420,200,1447,101,252,6,231,873,1463,94,86
738,58,1,282,163,1242,89,205,4,197,730,1225,94,87
628,47,4,298,178,1155,73,199,14,189,639,1114,94,88
326,92,11,428,192,1049,68,167,24,242,492,993,94,89
139,60,5,694,218,1116,45,233,21,239,523,1061,94,90
59,35,2,272,107,475,9,148,7,150,190,504,94,91
518,50,1,394,169,1132,96,319,6,177,548,1146,94,92
899,54,1,414,183,1551,99,247,3,235,961,1545,94,93
844,55,3,370,169,1441,105,225,6,204,877,1417,94,94
794,66,3,436,231,1530,103,324,8,243,834,1512,94,95
468,75,9,371,239,1162,88,229,15,225,554,1111,94,96
139,72,6,448,170,835,40,238,27,240,313,858,94,97
137,35,1,279,113,565,16,131,1,194,213,555,94,98
594,47,11,306,137,1095,94,164,26,215,590,1089,94,99
934,66,1,323,169,1493,98,269,13,249,850,1479,94,100
863,52,1,349,154,1419,120,248,7,228,818,1421,94,101
811,81,16,304,180,1392,97,256,19,228,784,1384,94,102
422,61,4,277,209,973,94,160,16,221,477,968,94,103
126,74,2,375,164,741,49,210,17,164,288,728,94,104
56,49,9,303,101,518,22,102,16,128,242,510,94,105
652,47,5,291,202,1197,105,214,10,196,643,1168,94,106
963,61,1,314,170,1509,105,247,6,258,904,1520,94,107
908,76,1,315,160,1460,98,288,8,227,864,1485,94,108
820,67,11,331,235,1464,105,253,14,229,846,1447,94,109
445,74,3,269,230,1021,86,199,38,189,486,998,94,110
65,95,2,544,294,1000,30,370,26,155,371,952,94,111
54,50,0,219,86,409,23,96,5,120,178,422,94,112
675,41,1,247,183,1147,114,175,7,220,676,1192,94,113
924,59,3,327,224,1537,104,298,12,209,922,1545,94,114
913,87,12,353,235,1600,111,368,21,255,845,1600,94,115
879,57,11,395,248,1590,103,316,17,296,873,1605,94,116
467,81,1,286,265,1100,83,258,37,211,505,1094,94,117
120,72,7,241,146,586,30,128,39,205,206,608,94,118
53,63,0,292,138,546,23,124,20,113,244,524,94,119
632,51,3,282,157,1125,103,181,5,198,628,1115,94,120
939,53,1,325,177,1495,119,222,3,249,884,1477,94,121
924,64,1,292,186,1467,128,246,11,248,854,1487,94,122
794,67,1,328,170,1360,117,249,8,210,753,1337,94,123
415,77,5,299,285,1081,104,232,16,203,479,1034,94,124
59,50,3,277,139,528,33,170,16,136,176,531,94,125
53,36,1,195,84,369,20,118,1,106,144,389,94,126
600,39,2,285,171,1097,119,134,10,190,628,1081,94,127
927,46,0,342,219,1534,119,288,12,203,893,1515,94,128
923,70,0,337,260,1590,116,325,19,230,843,1533,94,129
796,73,2,279,190,1340,103,236,7,206,781,1333,94,130
368,70,11,233,170,852,70,144,31,181,402,828,94,131
95,57,3,335,127,617,40,113,17,180,272,622,94,132
48,36,1,177,85,347,24,88,0,112,142,366,94,133
618,39,3,256,151,1067,104,166,11,178,618,1077,94,134
917,44,2,294,166,1423,112,220,11,205,874,1422,94,135
904,57,5,347,195,1508,97,255,8,255,879,1494,94,136
801,72,0,289,205,1367,101,277,9,221,750,1358,94,137
443,61,4,234,182,924,91,149,18,203,431,892,94,138
65,45,9,264,148,531,29,150,30,152,164,525,94,139
79,41,8,242,107,477,33,110,11,138,192,484,94,140
631,58,6,266,235,1196,109,225,13,183,630,1160,94,141
952,55,1,313,196,1517,123,257,10,277,862,1529,94,142
906,83,9,390,199,1587,145,251,17,263,925,1601,94,143
795,47,5,278,188,1313,110,230,7,219,748,1314,94,144
410,91,5,278,269,1053,89,235,24,272,399,1019,94,145
99,77,7,353,236,772,30,305,34,142,236,747,94,146
72,55,3,317,110,557,25,146,12,152,255,590,94,147
56,35,1,256,101,449,24,94,2,107,237,464,94,148
834,45,1,315,192,1387,121,192,12,223,824,1372,94,149
900,59,9,319,173,1460,119,193,15,219,911,1457,94,150
836,76,2,327,205,1446,108,322,9,225,771,1435,94,151
460,71,11,278,195,1015,116,170,27,230,470,1013,94,152
72,71,16,297,218,674,46,210,36,165,204,661,94,153
64,38,5,261,106,474,33,102,8,125,198,466,94,154
671,56,1,257,217,1202,111,239,6,209,680,1245,94,155
930,59,14,447,240,1690,121,337,11,229,1032,1730,94,156
975,56,6,401,198,1636,125,300,8,283,903,1619,94,157
894,64,5,305,249,1517,117,300,20,232,840,1509,94,158
471,127,3,310,360,1271,108,354,58,204,525,1249,94,159
82,88,5,610,337,1122,40,475,51,167,350,1083,94,160
78,51,4,386,134,653,30,177,14,124,311,656,94,161
661,59,4,310,151,1185,120,189,7,198,696,1210,94,162
966,73,11,400,221,1671,122,358,16,226,954,1676,94,163
929,79,8,402,236,1654,118,333,17,276,860,1604,94,164
830,66,3,362,189,1450,121,300,9,223,786,1439,94,165
450,72,6,289,261,1078,77,247,33,210,492,1059,94,166
90,92,5,351,208,746,41,247,26,164,213,691,94,167
65,49,1,297,84,496,27,95,4,122,280,528,94,168
658,78,1,260,147,1144,113,176,4,204,622,1119,94,169
875,53,2,328,280,1538,108,313,16,238,838,1513,94,170
194,71,3,262,196,726,79,210,10,140,271,710,94,171
772,73,2,358,217,1422,102,274,9,241,794,1420,94,172
411,85,5,268,189,958,93,218,31,176,471,989,94,173
78,84,2,248,191,603,37,219,41,124,165,586,94,174
62,48,4,215,100,429,36,82,12,144,178,452,94,175
616,43,5,310,151,1125,113,177,14,235,597,1136,94,176
901,58,12,335,194,1500,112,256,10,214,920,1512,94,177
912,59,7,333,194,1505,132,286,14,278,800,1510,94,178
805,77,7,374,216,1479,99,309,13,262,782,1465,94,179
424,91,3,299,221,1038,93,219,28,203,516,1059,94,180
122,69,4,297,189,681,58,196,32,157,258,701,94,181
76,39,8,229,86,438,29,112,22,134,174,471,94,182
660,43,6,327,227,1263,130,256,9,185,663,1243,94,183
866,55,11,318,219,1469,124,269,19,205,819,1436,94,184
635,80,7,326,325,1373,108,293,21,292,596,1310,94,185
141,804,8,464,539,1956,42,1219,35,235,287,1818,94,186
234,68,9,267,179,757,68,208,26,185,296,783,94,187
95,77,8,281,172,633,45,219,25,152,203,644,94,188
64,51,5,242,90,452,26,105,7,134,186,458,94,189
625,59,4,285,151,1124,110,209,5,194,600,1118,94,190
814,47,2,282,177,1322,136,252,3,191,750,1332,94,191
756,46,1,334,198,1335,144,224,4,208,718,1298,94,192
693,89,6,316,183,1287,124,260,13,193,714,1304,94,193
400,67,2,277,197,943,94,183,19,175,450,921,94,194
76,79,1,319,251,726,35,247,42,129,257,710,94,195
82,61,7,205,90,445,28,112,17,136,162,455,94,196
666,57,4,259,156,1142,110,188,10,190,659,1157,94,197
879,52,18,340,214,1503,116,325,18,235,787,1481,94,198
862,68,6,320,174,1430,130,211,14,229,839,1423,94,199
794,86,8,357,219,1464,118,257,25,246,817,1463,94,200
424,73,1,328,244,1070,97,233,51,188,441,1010,94,201
74,77,5,299,290,745,54,268,38,165,208,733,94,202
78,51,5,296,104,534,42,142,11,150,221,566,94,203
644,64,6,309,189,1212,88,253,11,185,631,1168,94,204
928,49,2,337,214,1530,117,286,11,254,856,1524,94,205
811,68,1,384,265,1529,108,334,13,281,804,1540,94,206
755,73,3,363,216,1410,102,295,6,242,762,1407,94,207
442,76,6,274,181,979,77,193,38,200,450,958,94,208
108,69,4,362,193,736,37,179,43,193,249,701,94,209
59,50,26,225,105,465,24,122,38,131,162,477,94,210
577,45,1,284,202,1109,90,212,32,192,572,1098,94,211
849,55,1,349,147,1401,81,302,5,209,757,1354,94,212
833,73,8,325,178,1417,103,255,18,242,855,1473,94,213
720,71,7,304,198,1300,100,228,14,203,710,1255,94,214
433,76,16,296,298,1119,103,291,38,197,443,1072,94,215
116,80,4,404,149,753,33,231,28,180,275,747,94,216
81,44,5,267,92,489,17,105,7,139,254,522,94,217
589,59,5,288,134,1075,86,207,7,187,590,1077,94,218
779,45,14,294,220,1352,85,260,25,192,767,1329,94,219
801,77,10,300,167,1355,94,210,13,227,772,1316,94,220
640,50,3,302,188,1183,91,188,18,211,651,1159,94,221
346,81,6,223,183,839,72,183,53,160,350,818,94,222
60,79,3,274,235,651,36,225,34,176,198,669,94,223
65,45,3,276,110,499,25,122,7,130,242,526,94,224
589,46,2,284,141,1062,101,141,5,184,621,1052,94,225
809,45,5,323,136,1318,92,218,10,230,723,1273,94,226
773,81,1,339,170,1364,82,240,7,222,763,1314,94,227
678,61,2,286,228,1255,114,230,13,228,657,1242,94,228
368,60,3,286,192,909,94,163,19,191,410,877,94,229
74,72,4,246,185,581,44,178,22,170,175,589,94,230
61,53,3,232,128,477,17,119,14,131,209,490,94,231
593,57,7,266,176,1099,101,168,13,177,646,1105,94,232
856,78,9,309,198,1450,105,244,16,239,834,1438,94,233
826,67,7,334,235,1469,111,243,18,238,811,1421,94,234
735,61,2,339,220,1357,106,249,6,200,777,1338,94,235
430,69,3,251,220,973,83,188,22,224,417,934,94,236
108,64,5,339,220,736,55,211,35,182,260,743,94,237
77,37,13,253,115,495,21,132,24,137,190,504,94,238
645,67,1,220,222,1155,94,238,6,200,639,1177,94,239
914,70,2,293,256,1535,90,308,15,232,869,1514,94,240
854,78,2,290,216,1440,110,304,7,225,820,1466,94,241
742,46,1,263,198,1250,98,202,25,234,721,1280,94,242
384,67,1,280,223,955,92,201,27,238,389,947,94,243
83,88,6,363,183,723,27,263,27,151,242,710,94,244
48,37,0,333,118,536,19,141,9,124,281,574,94,245
56,49,1,189,89,384,19,116,3,161,149,448,94,246
915,60,13,280,178,1446,93,188,14,220,915,1430,94,247
902,75,1,295,170,1443,106,193,5,240,903,1447,94,248
824,72,2,262,209,1369,90,246,6,227,778,1347,94,249
489,79,5,262,226,1061,100,199,21,216,442,978,94,250
100,63,3,353,278,797,56,167,88,164,273,748,94,251
60,43,6,190,112,411,26,118,9,146,157,456,94,252
694,58,0,286,186,1224,100,206,7,221,681,1215,94,253
966,83,4,289,239,1581,98,323,6,218,939,1584,94,254
969,94,13,302,241,1619,97,312,14,257,944,1624,94,255
891,79,5,308,290,1573,107,331,9,271,841,1559,94,256
472,86,4,275,279,1116,95,254,29,228,480,1086,94,257
101,100,4,401,213,819,42,270,35,200,241,788,94,258
76,56,2,261,135,530,17,102,8,167,240,534,94,259
709,49,0,258,199,1215,92,231,7,235,689,1254,94,260
1018,79,5,337,200,1639,104,268,9,274,998,1653,94,261
963,90,2,350,201,1606,91,298,11,262,909,1571,94,262
872,77,1,323,266,1539,91,306,6,286,822,1511,94,263
459,113,2,290,253,1117,79,247,35,236,499,1096,94,264
88,77,6,356,237,764,52,211,44,221,200,728,94,265
72,52,1,176,137,438,30,124,5,137,156,452,94,266
686,54,1,271,196,1208,93,239,4,245,686,1267,94,267
1008,67,1,317,246,1639,91,363,7,230,982,1673,94,268
963,95,5,331,265,1659,77,353,14,250,940,1634,94,269
826,83,6,470,249,1634,75,312,9,319,907,1622,94,270
478,96,3,332,223,1132,86,222,36,254,516,1114,94,271
98,79,1,402,265,845,46,359,38,182,260,885,94,272
80,47,1,314,98,540,29,137,6,147,209,528,94,273
722,60,2,251,174,1209,112,204,7,264,663,1250,94,274
1008,91,2,311,208,1620,97,259,23,261,962,1602,94,275
956,88,1,356,223,1624,101,305,8,286,943,1643,94,276
850,77,3,357,215,1502,99,302,4,294,807,1506,94,277
457,80,3,329,223,1092,76,219,34,261,504,1094,94,278
97,65,7,338,214,721,41,238,22,173,243,717,94,279
83,42,4,318,103,550,24,140,11,153,260,588,94,280
784,60,1,287,200,1332,106,250,7,217,772,1352,94,281
1050,100,1,378,183,1712,92,286,11,254,1042,1685,94,282
966,75,3,371,237,1652,109,306,12,275,944,1646,94,283
825,118,5,370,256,1574,105,317,9,279,873,1583,94,284
408,104,4,297,228,1041,78,216,34,207,520,1055,94,285
117,57,5,417,191,787,43,226,27,178,336,810,94,286
118,28,1,273,158,578,27,146,12,203,225,613,94,287
251,67,2,283,171,774,71,155,7,198,360,791,94,288
1041,53,3,365,233,1695,80,367,11,281,1000,1739,94,289
1035,91,6,399,218,1749,95,340,11,273,1019,1738,94,290
870,113,3,407,228,1621,82,373,7,268,892,1622,94,291
510,103,8,339,228,1188,92,291,37,195,567,1182,94,292
110,97,4,321,260,792,36,257,43,191,273,800,94,293
62,42,2,261,117,484,23,170,9,150,169,521,94,294
745,59,3,291,172,1270,86,199,8,243,752,1288,94,295
1031,59,9,366,209,1674,97,306,10,259,965,1637,94,296
1000,84,24,407,225,1740,96,347,37,298,975,1753,94,297
911,77,12,362,243,1605,102,351,19,259,861,1592,94,298
476,108,13,321,190,1108,73,234,32,265,554,1158,94,299
100,83,12,306,195,696,62,207,36,163,240,708,94,300
250,49,1,345,144,789,37,153,5,310,276,781,94,301
748,66,1,337,179,1331,94,215,6,257,725,1297,94,302
985,72,10,426,421,1914,93,605,16,292,921,1927,94,303
1000,63,7,385,213,1668,107,316,12,281,970,1686,94,304
783,90,11,334,259,1477,94,244,22,294,796,1450,94,305
434,66,7,327,208,1042,87,169,23,226,505,1010,94,306
86,83,11,296,224,700,42,241,23,184,203,693,94,307
67,58,4,192,82,403,20,91,7,153,159,430,94,308
663,44,3,276,184,1170,87,184,11,203,677,1162,94,309
673,52,2,292,145,1164,87,160,8,272,648,1175,94,310
760,71,2,282,183,1298,106,217,8,238,729,1298,94,311
816,60,4,331,214,1425,86,232,7,244,820,1389,94,312
407,57,5,300,202,971,89,172,23,216,484,984,94,313
97,74,9,302,149,631,38,172,26,161,242,639,94,314
71,33,2,255,92,453,22,89,4,146,212,473,94,315
297,54,2,303,128,784,62,172,12,187,372,805,94,316
1008,58,4,318,201,1589,94,237,8,247,962,1548,94,317
993,57,5,368,222,1645,92,332,9,290,949,1672,94,318
876,73,1,322,202,1474,101,249,9,274,865,1498,94,319
517,76,6,263,192,1054,105,187,26,245,503,1066,94,320
85,75,10,340,181,691,37,163,29,200,281,710,94,321
53,42,1,231,89,416,21,114,5,135,164,439,94,322
702,42,6,317,162,1229,84,189,9,235,681,1198,94,323
1013,58,0,333,222,1626,97,314,6,256,932,1605,94,324
984,47,2,318,178,1529,95,249,6,250,933,1533,94,325
829,52,3,330,265,1479,97,314,11,262,808,1492,94,326
444,54,8,258,168,932,83,159,25,236,448,951,94,327
73,88,7,255,205,628,31,179,25,142,225,602,94,328
59,34,1,197,111,402,21,110,5,144,179,459,94,329
631,37,3,318,175,1164,92,183,4,209,652,1140,94,330
696,53,1,351,228,1329,95,226,6,222,758,1307,94,331
367,64,1,353,176,961,76,165,10,337,437,1025,94,332
81,37,1,85,55,259,17,44,0,131,77,269,94,333
127,34,4,336,115,616,47,118,22,154,283,624,94,334
80,52,5,278,132,547,43,124,23,117,249,556,94,335
54,29,0,173,101,357,20,92,3,88,152,355,94,336
650,32,1,267,174,1124,80,158,5,221,617,1081,94,337
998,48,1,322,207,1576,95,323,7,251,921,1597,94,338
951,47,1,321,195,1515,97,281,7,257,863,1505,94,339
827,44,5,331,263,1470,81,341,16,242,807,1487,94,340
441,62,5,266,171,945,70,211,23,201,484,989,94,341
78,81,3,316,245,723,24,245,28,160,235,692,94,342
58,53,4,239,130,484,16,146,12,140,191,505,94,343
721,57,14,256,150,1198,90,214,21,197,716,1238,94,344
1018,49,5,354,177,1603,90,301,20,263,978,1652,94,345
964,51,6,335,187,1543,103,338,14,235,878,1568,94,346
957,68,0,336,240,1601,102,360,22,291,854,1629,94,347
439,74,5,282,239,1039,75,205,40,218,489,1027,94,348
166,58,8,328,253,813,25,243,42,234,215,759,94,349
59,54,9,188,138,448,20,128,15,129,191,483,94,350
641,48,11,257,164,1121,70,189,15,194,672,1140,94,351
902,59,3,332,262,1558,84,286,41,206,923,1540,94,352
833,60,4,339,202,1438,89,293,9,236,814,1441,94,353
734,61,6,352,267,1420,77,311,17,250,756,1411,94,354
270,37,3,220,192,722,57,134,15,124,255,585,94,355
67,48,4,186,124,429,20,110,18,76,154,378,94,356
42,26,5,132,68,273,7,57,14,58,125,261,94,357
206,27,7,228,117,585,66,125,14,125,218,548,94,358
110,19,4,149,60,342,35,49,10,108,101,303,94,359
16,17,4,36,54,127,9,31,9,35,39,123,94,360
154,34,2,149,115,454,62,92,6,101,162,423,94,361
127,23,3,228,100,481,48,85,19,111,143,406,94,362
59,50,6,157,69,341,27,68,22,84,117,318,94,363
54,35,2,143,75,309,24,83,11,82,101,301,94,364
235,29,2,278,174,718,61,145,13,189,377,785,94,365
226,137,30,291,130,814,48,122,107,178,374,829,94,366
196,84,4,342,191,817,56,279,15,220,351,921,95,1
998,117,4,529,433,2081,152,473,22,365,1036,2048,95,2
1277,113,34,560,423,2407,155,554,52,407,1226,2394,95,3
1272,99,4,556,471,2402,168,525,27,385,1211,2316,95,4
1122,131,14,586,492,2345,149,499,97,372,1097,2214,95,5
391,81,3,423,232,1130,67,315,66,308,377,1133,95,6
281,92,3,503,224,1103,51,358,22,294,457,1182,95,7
1215,106,7,565,460,2353,163,518,29,403,1188,2301,95,8
1172,103,5,448,319,2047,176,444,23,346,998,1987,95,9
1378,121,4,538,449,2490,155,559,38,428,1321,2501,95,10
1320,132,7,586,505,2550,160,575,54,402,1295,2486,95,11
1182,83,7,617,486,2375,153,472,84,384,1102,2195,95,12
402,98,8,642,360,1510,74,391,101,331,599,1496,95,13
277,104,8,493,211,1093,59,307,37,242,428,1073,95,14
510,90,11,473,261,1345,115,379,26,340,504,1364,95,15
688,84,4,504,346,1626,149,430,30,273,635,1517,95,16
1104,109,6,650,409,2278,127,484,38,371,1160,2180,95,17
1317,117,15,535,437,2421,143,588,43,399,1220,2393,95,18
676,101,13,481,386,1657,121,409,84,269,633,1516,95,19
402,91,2,495,289,1279,66,370,86,298,455,1275,95,20
269,88,4,500,263,1124,53,380,23,267,440,1163,95,21
1181,121,11,552,426,2291,161,519,38,379,1178,2275,95,22
1368,117,5,561,438,2489,151,573,26,411,1270,2431,95,23
1418,117,1,602,521,2659,195,615,22,437,1339,2608,95,24
1337,126,3,603,496,2565,185,650,33,405,1233,2506,95,25
1147,136,14,651,553,2501,178,554,116,462,1054,2364,95,26
453,129,12,726,392,1712,93,465,88,364,627,1637,95,27
279,94,4,494,250,1121,67,365,22,303,478,1235,95,28
1286,133,1,541,457,2418,180,511,40,373,1245,2349,95,29
1418,122,2,558,462,2562,164,619,22,424,1263,2492,95,30
1472,130,7,596,476,2681,175,564,42,438,1350,2569,95,31
1423,121,5,617,465,2631,185,601,38,421,1310,2555,95,32
1288,137,11,701,549,2686,199,544,109,494,1216,2562,95,33
388,133,7,685,360,1573,74,376,120,361,585,1516,95,34
311,112,3,534,313,1273,65,381,24,300,483,1253,95,35
1255,104,1,585,467,2412,152,557,14,419,1209,2351,95,36
1459,122,4,580,483,2648,180,596,28,434,1388,2626,95,37
1490,144,3,539,513,2689,156,689,26,383,1381,2635,95,38
1433,139,16,609,452,2649,177,605,42,393,1389,2606,95,39
1266,153,27,660,588,2694,162,585,119,439,1250,2555,95,40
406,145,19,634,437,1641,102,442,121,356,667,1688,95,41
317,116,8,564,270,1275,67,371,40,314,562,1354,95,42
1282,100,6,537,441,2366,159,486,26,412,1261,2344,95,43
1281,137,26,617,482,2543,155,669,56,396,1291,2567,95,44
1479,107,9,613,521,2729,145,604,72,455,1340,2616,95,45
1423,132,9,570,504,2638,140,607,48,403,1422,2620,95,46
1131,145,12,628,573,2489,152,575,111,487,1087,2412,95,47
372,115,1,635,345,1468,79,425,119,297,513,1433,95,48
316,127,9,557,324,1333,53,447,73,285,511,1369,95,49
675,127,7,637,377,1823,137,468,33,382,822,1842,95,50
1364,130,4,591,471,2560,159,615,23,397,1320,2514,95,51
1468,123,10,592,492,2685,160,597,57,442,1455,2711,95,52
1466,119,5,613,504,2707,168,641,54,427,1378,2668,95,53
1305,122,7,625,536,2595,173,606,110,445,1204,2538,95,54
444,136,5,646,416,1647,68,467,127,398,588,1648,95,55
319,96,3,597,277,1292,54,449,39,302,521,1365,95,56
1361,124,7,586,520,2598,198,603,33,415,1289,2538,95,57
1491,116,4,630,481,2722,178,636,28,423,1417,2682,95,58
1529,108,2,547,446,2632,169,570,22,423,1329,2513,95,59
1487,142,2,593,542,2766,216,681,40,452,1352,2741,95,60
1247,111,9,610,576,2553,158,580,110,433,1228,2509,95,61
384,127,11,632,354,1508,75,429,102,300,569,1475,95,62
346,104,10,625,315,1400,70,420,33,359,547,1429,95,63
1323,137,4,599,549,2612,165,636,28,401,1359,2589,95,64
1407,128,4,553,490,2582,172,699,21,365,1356,2613,95,65
1535,135,12,576,471,2729,164,655,46,426,1302,2593,95,66
1498,155,3,632,495,2783,169,716,59,483,1369,2796,95,67
1328,159,12,664,550,2713,182,651,121,426,1253,2633,95,68
433,97,5,617,288,1440,76,438,115,281,482,1392,95,69
297,106,4,544,275,1226,60,441,26,294,518,1339,95,70
1280,148,2,549,420,2399,157,650,23,366,1254,2450,95,71
1504,169,10,644,531,2858,167,760,52,403,1445,2827,95,72
1574,163,8,630,529,2904,155,758,40,452,1429,2834,95,73
1417,167,10,703,568,2865,172,803,52,417,1331,2775,95,74
1200,157,8,720,586,2671,144,639,121,446,1192,2542,95,75
478,183,13,864,408,1946,86,593,148,403,645,1875,95,76
334,156,1,686,350,1527,65,567,47,303,604,1586,95,77
1410,131,8,642,483,2674,172,669,35,402,1343,2621,95,78
1522,119,5,638,507,2791,178,727,42,430,1452,2829,95,79
1532,158,7,694,593,2984,171,852,42,421,1394,2880,95,80
1566,128,7,658,529,2888,171,747,53,390,1442,2803,95,81
1379,139,6,655,597,2776,170,685,152,396,1285,2688,95,82
410,144,9,541,397,1501,62,519,144,255,544,1524,95,83
359,128,4,710,321,1522,55,547,37,310,606,1555,95,84
1371,140,1,713,498,2723,176,703,38,415,1386,2718,95,85
1509,147,4,708,525,2893,182,771,42,464,1484,2943,95,86
1448,127,5,574,431,2585,149,654,45,369,1266,2483,95,87
1394,138,2,640,463,2637,156,722,26,399,1335,2638,95,88
1249,178,12,767,566,2772,172,674,141,475,1171,2633,95,89
477,147,7,836,473,1940,80,634,118,404,698,1934,95,90
389,144,5,651,307,1496,62,517,35,347,512,1473,95,91
1228,140,5,610,492,2475,152,688,43,372,1308,2563,95,92
1435,121,23,624,450,2653,135,682,66,408,1376,2667,95,93
1431,119,19,508,413,2490,164,633,66,371,1306,2540,95,94
1566,156,5,669,529,2925,155,754,45,480,1473,2907,95,95
1268,175,6,700,581,2730,161,700,131,462,1173,2627,95,96
500,138,8,752,378,1776,74,511,128,415,626,1754,95,97
426,131,1,755,351,1664,87,588,30,388,613,1706,95,98
1342,135,11,655,451,2594,183,663,46,409,1292,2593,95,99
1513,158,5,662,484,2822,165,739,56,456,1447,2863,95,100
1540,130,3,699,509,2881,135,747,38,436,1424,2780,95,101
1575,153,3,646,505,2882,160,704,50,486,1397,2797,95,102
1379,142,10,635,584,2750,173,655,120,431,1316,2695,95,103
496,142,10,775,465,1888,83,597,146,402,684,1912,95,104
383,159,2,704,344,1592,64,557,35,320,581,1557,95,105
1272,142,4,696,514,2628,168,611,45,426,1211,2461,95,106
1317,174,5,660,552,2708,147,776,38,458,1234,2653,95,107
1446,147,5,702,539,2839,166,731,43,469,1253,2662,95,108
1393,176,5,654,514,2742,171,762,36,400,1303,2672,95,109
1282,161,12,639,519,2613,165,632,119,406,1175,2497,95,110
513,183,10,829,461,1996,81,652,124,402,774,2033,95,111
345,131,2,588,294,1360,73,473,38,275,558,1417,95,112
1448,161,8,615,525,2757,178,668,35,442,1377,2700,95,113
1542,148,6,640,552,2888,164,786,38,380,1484,2852,95,114
1605,166,9,678,539,2997,186,803,39,415,1475,2918,95,115
1596,153,7,647,556,2959,175,784,34,393,1424,2810,95,116
1396,163,12,663,640,2874,203,743,134,451,1237,2768,95,117
488,119,11,695,416,1729,83,549,138,424,598,1792,95,118
397,155,4,661,328,1545,54,509,46,339,584,1532,95,119
1397,180,7,654,524,2762,203,664,49,453,1351,2720,95,120
1603,166,3,633,543,2948,195,776,31,472,1498,2972,95,121
1647,164,1,675,540,3027,202,743,31,511,1479,2966,95,122
1646,148,10,643,510,2957,218,748,59,441,1433,2899,95,123
1448,171,17,710,616,2962,209,750,121,507,1279,2866,95,124
462,139,11,616,358,1586,66,541,121,338,576,1642,95,125
335,125,4,589,275,1328,55,524,32,302,451,1364,95,126
1445,150,2,622,479,2698,191,708,24,470,1336,2729,95,127
1545,178,4,637,567,2931,161,819,41,422,1540,2983,95,128
1591,160,8,677,617,3053,185,800,67,463,1456,2971,95,129
1575,176,9,660,518,2938,196,750,47,453,1471,2917,95,130
1368,136,8,661,538,2711,189,645,115,475,1158,2582,95,131
523,144,8,709,438,1822,94,521,106,415,644,1780,95,132
373,148,20,606,271,1418,59,527,44,298,486,1414,95,133
1400,144,3,653,507,2707,196,698,45,451,1352,2742,95,134
1561,101,12,545,447,2666,171,671,31,386,1354,2613,95,135
1607,133,1,612,490,2843,251,746,46,414,1299,2756,95,136
1583,126,6,611,536,2862,172,738,38,398,1489,2835,95,137
1371,143,5,636,514,2669,196,665,128,428,1218,2635,95,138
431,126,9,558,359,1483,67,522,121,287,535,1532,95,139
374,146,7,573,235,1335,60,480,39,290,509,1378,95,140
1463,131,5,593,490,2682,175,704,48,429,1376,2732,95,141
1549,128,15,615,497,2804,186,770,50,403,1466,2875,95,142
1601,143,13,644,512,2913,183,725,45,442,1514,2909,95,143
1488,128,5,562,480,2663,173,664,41,397,1390,2665,95,144
1344,146,11,606,523,2630,177,660,117,483,1173,2610,95,145
464,143,5,604,357,1573,81,575,109,323,558,1646,95,146
382,171,1,619,300,1473,76,563,55,342,534,1570,95,147
347,109,3,503,293,1255,73,411,21,293,514,1312,95,148
1432,128,12,612,443,2627,185,668,23,416,1407,2699,95,149
1589,127,3,554,408,2681,161,614,43,399,1394,2611,95,150
1547,149,7,611,499,2813,190,767,43,414,1388,2802,95,151
1422,135,5,697,523,2782,194,662,116,501,1240,2713,95,152
497,149,3,630,371,1650,79,530,122,384,603,1718,95,153
355,104,0,505,268,1232,54,490,14,276,539,1373,95,154
1424,128,2,613,460,2627,172,696,27,401,1300,2596,95,155
1481,135,2,655,473,2746,166,735,33,426,1340,2700,95,156
1650,133,3,621,460,2867,164,712,46,473,1418,2813,95,157
1631,128,2,657,515,2933,157,818,44,454,1452,2925,95,158
1400,185,8,760,603,2956,169,810,138,472,1240,2829,95,159
506,145,6,900,564,2121,76,721,147,430,654,2028,95,160
364,120,1,689,298,1472,53,563,23,333,588,1560,95,161
1390,118,3,643,448,2602,185,624,41,472,1272,2594,95,162
1517,160,7,652,485,2821,175,770,40,409,1450,2844,95,163
1602,151,4,680,522,2959,184,847,66,480,1379,2956,95,164
1564,167,7,705,526,2969,203,813,57,473,1399,2945,95,165
1358,159,10,652,577,2756,171,735,135,471,1147,2659,95,166
510,157,5,711,409,1792,72,614,126,413,569,1794,95,167
369,137,1,569,271,1347,62,509,32,361,511,1475,95,168
1275,140,6,640,471,2532,182,681,36,446,1209,2554,95,169
1372,144,8,693,486,2703,158,768,63,450,1225,2664,95,170
830,133,3,638,430,2034,149,611,36,396,823,2015,95,171
1384,181,9,654,500,2728,159,777,52,397,1252,2637,95,172
1197,168,11,671,472,2519,148,629,110,413,1101,2401,95,173
474,172,10,610,356,1622,103,561,147,358,526,1695,95,174
356,133,5,544,250,1288,73,463,45,310,442,1333,95,175
1254,127,10,617,460,2468,154,670,40,441,1183,2488,95,176
1405,123,12,624,481,2645,150,684,48,415,1308,2605,95,177
1460,132,6,625,456,2679,149,698,44,391,1341,2623,95,178
1455,136,11,622,469,2693,196,726,49,421,1264,2656,95,179
1256,164,15,715,524,2674,165,639,147,485,1137,2573,95,180
365,139,8,618,372,1502,81,540,125,404,546,1696,95,181
354,137,1,494,244,1230,66,490,22,289,445,1312,95,182
1248,150,3,656,493,2550,173,671,46,425,1206,2521,95,183
1406,147,1,642,538,2734,170,721,38,443,1248,2620,95,184
1311,126,0,662,509,2608,177,703,49,468,1141,2538,95,185
376,596,14,570,594,2150,75,1056,44,365,565,2105,95,186
925,151,5,602,449,2132,135,607,119,398,851,2110,95,187
443,136,13,574,332,1498,81,480,124,366,520,1571,95,188
353,122,1,474,287,1237,59,472,29,261,525,1346,95,189
1223,114,2,604,425,2368,146,598,28,358,1188,2318,95,190
1404,118,5,595,421,2543,169,676,40,463,1200,2548,95,191
1471,121,4,602,423,2621,197,634,31,441,1199,2502,95,192
1384,119,4,647,454,2608,171,723,48,420,1177,2539,95,193
1201,175,9,653,520,2558,162,650,134,430,1009,2385,95,194
464,156,4,612,349,1585,73,572,126,319,538,1628,95,195
364,127,3,550,242,1286,70,447,19,323,477,1336,95,196
1204,114,0,596,399,2313,157,601,29,421,1045,2253,95,197
1392,96,15,596,408,2507,165,677,46,433,1178,2499,95,198
1470,111,3,596,382,2562,167,625,43,422,1230,2487,95,199
1413,141,5,634,463,2656,192,707,52,464,1163,2578,95,200
1193,169,5,624,567,2558,164,706,139,423,1043,2475,95,201
469,177,7,628,349,1630,76,507,141,373,520,1617,95,202
356,126,1,583,288,1354,70,504,23,316,545,1458,95,203
1215,96,4,554,402,2271,158,600,30,409,1117,2314,95,204
1366,118,5,634,458,2581,146,705,41,415,1246,2553,95,205
1385,113,12,656,461,2627,173,745,43,412,1231,2604,95,206
1370,149,5,615,477,2616,207,684,64,399,1218,2572,95,207
1167,157,10,715,525,2574,170,649,134,466,1069,2488,95,208
480,137,4,624,355,1600,75,539,155,316,597,1682,95,209
355,125,5,535,298,1318,65,519,41,329,480,1434,95,210
1212,111,2,582,468,2375,154,622,63,394,1098,2331,95,211
1337,109,1,648,439,2534,155,649,31,406,1226,2467,95,212
1385,114,19,650,422,2590,159,682,50,426,1201,2518,95,213
1325,117,2,630,471,2545,171,700,35,405,1183,2494,95,214
1097,156,3,721,533,2510,177,727,108,422,1064,2498,95,215
490,109,5,666,340,1610,75,460,133,338,562,1568,95,216
372,113,1,553,226,1265,63,447,27,286,560,1383,95,217
1185,119,3,612,450,2369,161,640,33,455,1074,2363,95,218
1322,117,2,648,437,2526,143,668,40,415,1200,2466,95,219
1330,116,7,635,438,2526,147,698,38,359,1263,2505,95,220
1241,111,24,557,429,2362,141,622,66,354,1087,2270,95,221
1015,160,12,512,516,2215,130,657,115,330,889,2121,95,222
484,125,8,619,325,1561,88,498,120,356,523,1585,95,223
372,124,6,586,250,1338,77,451,27,283,538,1376,95,224
1160,135,9,608,474,2386,142,595,34,399,1127,2297,95,225
1232,133,9,671,444,2489,138,696,31,436,1118,2419,95,226
1364,130,5,622,461,2582,161,675,51,365,1253,2505,95,227
1357,131,7,607,527,2629,169,769,53,359,1176,2526,95,228
1183,175,9,668,535,2570,135,639,147,421,1074,2416,95,229
457,151,5,610,332,1555,81,500,142,355,532,1610,95,230
354,101,3,585,253,1296,66,469,27,308,523,1393,95,231
1206,102,13,600,437,2358,170,566,36,398,1161,2331,95,232
1321,141,1,614,473,2550,163,682,33,394,1226,2498,95,233
1331,159,4,669,487,2650,160,752,43,391,1206,2552,95,234
1359,158,10,637,457,2621,181,738,54,389,1215,2577,95,235
1136,192,9,677,545,2559,159,699,111,421,1110,2500,95,236
478,139,9,718,385,1729,71,590,124,356,614,1755,95,237
342,130,4,602,227,1305,78,507,23,287,536,1431,95,238
1372,114,2,571,453,2512,169,622,28,409,1232,2460,95,239
1484,148,3,603,478,2716,162,763,29,399,1383,2736,95,240
1501,137,13,629,453,2733,177,698,51,430,1359,2715,95,241
1512,92,2,639,458,2703,183,684,30,412,1377,2686,95,242
1273,128,7,606,566,2580,157,672,115,502,1130,2576,95,243
479,152,4,675,395,1705,81,518,118,377,571,1665,95,244
360,137,4,629,263,1393,71,475,38,345,547,1476,95,245
362,112,4,515,360,1353,74,413,20,325,555,1387,95,246
1474,113,5,599,487,2678,195,676,40,372,1418,2701,95,247
1528,111,2,662,459,2762,188,695,26,432,1403,2744,95,248
1553,129,4,627,498,2811,184,747,43,414,1375,2763,95,249
1411,150,9,665,488,2723,181,688,105,429,1232,2635,95,250
474,150,6,689,372,1691,80,539,135,359,593,1706,95,251
343,114,5,620,289,1371,58,483,17,342,538,1438,95,252
1446,138,10,575,468,2637,165,694,45,347,1298,2549,95,253
1612,126,3,601,477,2819,149,778,28,407,1434,2796,95,254
1619,129,0,630,491,2869,176,775,36,444,1426,2857,95,255
1646,134,1,615,540,2936,210,850,51,398,1401,2910,95,256
1452,172,5,634,565,2828,193,726,138,423,1312,2792,95,257
484,170,4,776,392,1826,87,574,143,413,647,1864,95,258
344,126,0,643,290,1403,63,414,49,352,640,1518,95,259
1405,103,9,636,527,2680,153,660,30,440,1433,2716,95,260
1638,106,1,615,442,2802,188,723,32,393,1495,2831,95,261
1631,104,2,660,460,2857,172,789,47,428,1350,2786,95,262
1683,140,1,654,512,2990,208,764,58,398,1510,2938,95,263
1494,187,9,640,568,2898,182,698,167,466,1336,2849,95,264
501,150,2,773,433,1859,65,610,130,419,645,1869,95,265
362,122,2,535,283,1304,71,467,21,329,521,1409,95,266
1474,101,14,596,459,2644,167,654,60,356,1373,2610,95,267
1610,113,6,668,465,2862,171,735,47,411,1437,2801,95,268
1654,106,2,609,470,2841,164,740,39,396,1411,2750,95,269
1521,149,1,640,515,2826,177,739,74,399,1431,2820,95,270
1387,146,10,598,512,2653,175,645,132,416,1261,2629,95,271
497,185,1,807,464,1954,67,645,135,397,661,1905,95,272
360,109,3,605,298,1375,73,505,25,299,599,1501,95,273
1415,100,6,574,457,2552,182,632,40,374,1297,2525,95,274
1517,96,2,554,448,2617,158,678,34,371,1397,2638,95,275
1648,133,5,615,468,2869,187,735,47,409,1441,2819,95,276
1564,111,1,672,501,2849,185,766,35,372,1414,2772,95,277
1407,153,7,625,587,2779,180,691,142,430,1239,2682,95,278
485,144,3,732,404,1768,77,572,123,387,613,1772,95,279
384,127,0,654,263,1428,74,487,28,333,559,1481,95,280
1428,114,0,630,498,2670,175,644,32,413,1413,2677,95,281
1662,101,8,599,491,2861,185,734,45,356,1494,2814,95,282
1684,137,0,624,527,2972,173,724,40,433,1480,2850,95,283
1479,112,3,688,525,2807,182,736,46,414,1366,2744,95,284
1265,146,6,655,592,2664,149,700,151,448,1203,2651,95,285
484,114,0,723,377,1698,63,538,130,366,636,1733,95,286
380,98,0,561,312,1351,74,505,34,306,553,1472,95,287
938,99,3,615,423,2078,116,563,26,383,913,2001,95,288
1570,117,0,619,523,2829,171,727,56,427,1453,2834,95,289
1677,110,0,641,496,2924,171,758,33,424,1476,2862,95,290
1578,121,2,600,491,2792,160,725,58,368,1451,2762,95,291
1357,178,5,683,570,2793,154,697,147,426,1264,2688,95,292
460,165,3,726,470,1824,61,605,200,365,674,1905,95,293
377,125,4,618,337,1461,67,520,39,334,586,1546,95,294
1500,123,4,665,496,2788,183,666,45,447,1422,2763,95,295
1661,101,2,654,530,2948,202,748,46,435,1450,2881,95,296
1699,118,1,678,533,3029,189,771,43,456,1511,2970,95,297
1651,118,7,688,542,3006,191,791,53,462,1457,2954,95,298
1430,179,8,691,583,2891,173,724,131,395,1320,2743,95,299
493,139,6,743,377,1758,76,512,150,392,642,1772,95,300
429,116,1,635,303,1484,64,467,20,397,574,1522,95,301
1470,105,1,596,512,2684,174,651,30,428,1422,2705,95,302
1641,132,8,659,618,3058,188,881,51,426,1460,3006,95,303
1694,123,1,658,535,3011,194,801,31,432,1564,3022,95,304
1572,169,3,697,535,2976,162,758,51,460,1445,2876,95,305
1387,154,8,672,596,2817,158,715,101,453,1292,2719,95,306
461,145,4,768,419,1797,69,630,120,373,632,1824,95,307
377,105,5,578,295,1360,88,493,14,398,540,1533,95,308
1334,115,7,653,506,2615,163,613,25,482,1294,2577,95,309
1325,109,17,640,488,2579,168,585,66,466,1267,2552,95,310
1592,108,5,648,529,2882,238,723,41,463,1422,2887,95,311
1623,108,4,612,495,2842,174,733,46,426,1415,2794,95,312
1477,139,7,659,567,2849,162,688,130,486,1317,2783,95,313
490,93,9,759,401,1752,91,497,121,399,666,1774,95,314
419,81,2,630,284,1416,66,396,33,334,619,1448,95,315
926,98,3,653,474,2154,149,548,26,438,934,2095,95,316
1657,110,3,639,506,2915,207,655,21,372,1581,2836,95,317
1686,100,2,638,529,2955,184,717,47,437,1584,2969,95,318
1667,80,7,604,495,2853,177,704,48,412,1513,2854,95,319
1442,137,5,673,531,2788,170,653,124,462,1310,2719,95,320
518,104,6,807,380,1815,76,492,128,388,690,1774,95,321
381,112,5,633,296,1427,73,428,22,357,568,1448,95,322
1509,93,5,612,481,2700,161,626,43,419,1429,2678,95,323
1657,95,3,631,530,2916,180,733,48,440,1520,2921,95,324
1693,105,37,648,566,3049,153,703,66,434,1518,2874,95,325
1619,125,12,619,573,2948,185,743,46,431,1470,2875,95,326
1392,111,6,592,512,2613,159,624,106,430,1158,2477,95,327
463,122,8,709,380,1682,82,497,128,391,621,1719,95,328
379,115,4,606,319,1423,75,443,15,356,591,1480,95,329
1407,82,1,635,473,2598,189,600,32,490,1335,2646,95,330
1373,108,6,631,539,2657,154,673,35,470,1338,2670,95,331
1085,113,2,708,501,2409,148,591,30,552,987,2308,95,332
193,78,3,331,187,792,46,173,6,288,337,850,95,333
614,93,3,659,421,1790,116,493,93,399,708,1809,95,334
423,91,4,596,358,1472,75,446,80,320,571,1492,95,335
327,84,3,540,270,1224,73,423,21,315,493,1325,95,336
1337,81,10,580,437,2445,159,574,25,408,1293,2459,95,337
1561,77,16,596,510,2760,171,650,29,396,1468,2714,95,338
1659,93,7,558,479,2796,178,672,47,421,1466,2784,95,339
1565,81,5,522,454,2627,160,603,45,369,1409,2586,95,340
1294,109,8,643,498,2552,148,593,133,403,1239,2516,95,341
454,93,1,678,380,1606,69,503,148,395,605,1720,95,342
408,101,6,624,322,1461,71,450,33,378,617,1549,95,343
1399,94,7,526,484,2510,160,622,35,391,1289,2497,95,344
1645,92,5,618,471,2831,176,709,38,447,1440,2810,95,345
1604,86,2,527,410,2629,171,698,48,357,1341,2615,95,346
1620,99,5,646,503,2873,186,767,55,444,1371,2823,95,347
1400,123,5,666,540,2734,142,644,147,420,1279,2632,95,348
499,114,2,707,434,1756,70,498,134,367,682,1751,95,349
353,78,2,532,288,1253,56,442,20,331,503,1352,95,350
1389,100,2,616,413,2520,176,591,32,436,1316,2551,95,351
1568,97,2,657,486,2810,162,685,33,397,1457,2734,95,352
1571,109,1,657,484,2822,158,721,24,423,1377,2703,95,353
1547,113,1,645,507,2813,163,684,45,433,1443,2768,95,354
1187,112,3,661,533,2496,144,638,116,418,1102,2418,95,355
436,102,1,697,321,1557,84,443,95,344,570,1536,95,356
348,75,4,555,286,1268,75,384,27,310,519,1315,95,357
922,97,3,639,430,2091,128,533,25,402,884,1972,95,358
681,79,2,520,304,1586,127,329,12,509,598,1575,95,359
128,61,2,212,130,533,38,171,11,171,220,611,95,360
831,91,9,506,471,1908,119,577,29,350,765,1840,95,361
832,120,8,614,482,2056,119,546,98,392,860,2015,95,362
389,87,4,544,309,1333,74,433,107,243,530,1387,95,363
298,68,5,529,277,1177,61,353,34,254,533,1235,95,364
924,111,6,648,492,2181,149,527,41,441,987,2145,95,365
853,196,37,652,434,2172,141,332,153,499,811,1936,95,366
99,122,7,227,222,677,35,140,27,258,256,716,96,1
748,180,13,428,429,1798,152,269,18,414,954,1807,96,2
915,159,23,496,456,2049,176,351,34,431,1068,2060,96,3
885,183,11,454,360,1893,202,321,35,371,990,1919,96,4
658,206,13,462,472,1811,160,329,58,439,886,1872,96,5
154,111,10,310,254,839,67,176,33,330,259,865,96,6
126,125,10,384,308,953,46,173,19,424,341,1003,96,7
842,150,10,419,407,1828,181,306,24,367,977,1855,96,8
1015,114,28,368,270,1795,205,267,42,374,932,1820,96,9
1131,183,30,529,410,2283,234,372,59,473,1193,2331,96,10
932,175,7,479,368,1961,201,413,29,360,971,1974,96,11
750,214,12,469,445,1890,180,342,69,461,855,1907,96,12
184,129,5,402,314,1034,64,162,36,314,342,918,96,13
93,77,22,226,191,609,35,89,21,231,178,554,96,14
294,159,11,384,328,1176,121,213,17,404,425,1180,96,15
435,118,4,335,307,1199,129,246,21,325,493,1214,96,16
909,154,18,473,399,1953,209,339,48,389,954,1939,96,17
1027,199,21,529,451,2227,250,442,38,415,1086,2231,96,18
479,166,13,354,302,1314,146,300,71,303,533,1353,96,19
156,188,14,447,385,1190,61,258,59,425,444,1247,96,20
145,135,15,404,326,1025,44,210,20,355,417,1046,96,21
881,156,21,480,392,1930,208,342,32,396,968,1946,96,22
1112,176,19,481,417,2205,190,413,41,423,1167,2234,96,23
1123,203,11,528,426,2291,201,434,40,396,1232,2303,96,24
995,210,17,494,431,2147,198,474,41,399,1073,2185,96,25
745,282,17,554,558,2156,179,420,72,515,1025,2211,96,26
4,0,0,0,0,4,2,0,0,0,0,2,96,27
0,5,6,1,11,23,0,3,6,0,12,21,96,28
843,169,21,489,424,1946,162,336,37,402,1074,2011,96,29
1125,176,15,486,386,2188,195,383,43,407,1180,2208,96,30
1108,188,12,529,494,2331,232,467,34,407,1211,2351,96,31
1032,217,8,540,441,2238,215,468,26,444,1134,2287,96,32
756,260,9,495,489,2009,184,375,67,469,957,2052,96,33
194,200,7,604,528,1533,85,272,48,610,626,1641,96,34
149,159,8,484,394,1194,55,237,27,473,497,1289,96,35
921,175,5,472,417,1990,210,341,30,408,1013,2002,96,36
1115,178,2,492,424,2211,218,436,20,414,1161,2249,96,37
1146,150,6,547,502,2351,243,446,41,474,1231,2435,96,38
1010,198,1,534,433,2176,215,443,24,432,1093,2207,96,39
784,247,8,536,548,2123,216,418,69,509,959,2171,96,40
177,184,4,452,397,1214,79,193,44,436,387,1139,96,41
103,113,8,325,273,822,46,168,26,321,308,869,96,42
902,181,11,457,414,1965,215,346,33,438,1014,2046,96,43
1022,198,8,472,436,2136,203,508,26,407,965,2109,96,44
1108,148,8,558,459,2281,246,384,40,509,1164,2343,96,45
994,164,19,514,377,2068,219,382,44,389,1072,2106,96,46
723,207,7,522,547,2006,194,368,42,506,862,1972,96,47
159,198,8,443,401,1209,74,223,68,429,464,1258,96,48
158,100,3,416,294,971,51,178,20,371,386,1006,96,49
370,175,4,457,396,1402,137,234,12,461,597,1441,96,50
1058,128,5,442,427,2060,210,390,19,351,1109,2079,96,51
1120,172,18,503,431,2244,229,423,41,409,1205,2307,96,52
1041,169,9,547,412,2178,246,488,28,458,1006,2226,96,53
768,167,7,502,491,1935,173,370,54,491,915,2003,96,54
218,202,6,533,530,1489,79,294,66,540,566,1545,96,55
168,163,5,465,356,1157,63,280,23,428,439,1233,96,56
893,138,6,451,410,1898,196,359,25,371,1019,1970,96,57
1163,139,14,515,414,2245,213,431,33,406,1164,2247,96,58
1120,99,10,508,435,2172,240,362,25,424,1135,2186,96,59
1071,168,9,549,444,2241,245,408,31,438,1157,2279,96,60
775,205,7,476,544,2007,194,414,70,437,988,2103,96,61
179,169,4,463,447,1262,76,251,60,505,429,1321,96,62
164,124,2,466,362,1118,55,242,18,472,458,1245,96,63
889,126,6,443,395,1859,214,335,27,366,977,1919,96,64
1105,173,20,416,376,2090,199,394,45,353,1104,2095,96,65
1141,154,8,643,494,2440,229,452,28,554,1185,2448,96,66
1072,193,6,501,494,2266,227,486,33,394,1120,2260,96,67
761,192,6,595,565,2119,211,405,66,521,966,2169,96,68
261,222,6,519,435,1443,92,320,69,483,534,1498,96,69
188,152,8,473,337,1158,55,224,17,485,430,1211,96,70
863,175,7,439,409,1893,199,368,25,355,1031,1978,96,71
1119,161,0,517,414,2211,205,345,0,402,1181,2133,96,72
1129,171,22,587,441,2350,223,482,49,448,1177,2379,96,73
1047,268,8,589,547,2459,206,498,41,487,1228,2460,96,74
752,217,17,552,532,2070,182,385,72,496,915,2050,96,75
271,272,10,766,617,1936,109,493,100,605,766,2073,96,76
170,170,9,643,438,1430,79,415,36,524,507,1561,96,77
925,154,11,484,449,2023,210,355,25,420,1011,2021,96,78
1215,178,12,523,424,2352,232,451,34,492,1179,2388,96,79
1175,178,21,574,553,2501,236,575,24,482,1245,2562,96,80
1051,205,13,550,437,2256,210,495,31,388,1168,2292,96,81
782,242,10,593,551,2178,185,468,72,479,994,2198,96,82
216,239,10,439,377,1281,73,319,65,363,481,1301,96,83
175,162,6,686,410,1439,60,331,22,461,577,1451,96,84
846,166,11,584,416,2023,193,353,45,384,1089,2064,96,85
1133,172,11,583,443,2342,222,501,28,395,1230,2376,96,86
1016,168,13,626,421,2244,227,443,30,517,1061,2278,96,87
940,193,11,586,421,2151,206,424,26,402,1050,2108,96,88
678,230,12,619,589,2128,182,452,69,512,973,2188,96,89
208,208,2,801,531,1750,96,388,92,570,695,1841,96,90
170,111,8,578,324,1191,45,269,23,414,476,1227,96,91
770,215,3,536,423,1947,172,412,16,415,929,1944,96,92
1081,160,24,542,434,2241,221,461,42,442,1081,2247,96,93
1098,200,10,490,435,2233,244,507,27,411,1046,2235,96,94
1125,200,3,674,423,2425,288,496,27,470,1108,2389,96,95
844,235,6,538,546,2169,191,493,62,529,955,2230,96,96
266,233,5,661,453,1618,86,364,60,597,610,1717,96,97
238,171,2,576,395,1382,67,343,24,488,523,1445,96,98
927,177,2,439,385,1930,255,366,32,332,964,1949,96,99
1100,186,8,551,456,2301,231,456,65,443,1182,2377,96,100
1159,228,7,598,496,2488,265,474,20,494,1296,2549,96,101
1102,189,11,614,434,2350,286,431,30,433,1172,2352,96,102
787,254,7,507,483,2038,235,395,60,461,968,2119,96,103
240,257,7,633,538,1675,87,374,79,572,619,1731,96,104
197,152,3,583,401,1336,62,317,14,509,517,1419,96,105
883,178,2,481,514,2058,223,433,24,466,1005,2151,96,106
1102,213,28,620,503,2466,216,468,40,524,1200,2448,96,107
1150,198,28,681,507,2564,288,547,47,565,1174,2621,96,108
1123,224,11,578,457,2393,267,515,26,483,1182,2473,96,109
815,256,19,605,546,2241,211,458,62,544,964,2239,96,110
239,251,6,855,538,1889,113,485,85,642,664,1989,96,111
182,142,0,456,372,1152,61,233,15,456,464,1229,96,112
859,213,4,494,410,1980,219,375,27,393,1000,2014,96,113
1088,191,17,608,442,2346,225,476,36,478,1183,2398,96,114
1163,201,21,603,474,2462,271,558,36,545,1115,2525,96,115
1091,210,14,694,483,2492,274,525,41,474,1217,2531,96,116
854,244,7,555,569,2229,202,457,74,513,991,2237,96,117
235,252,6,551,457,1501,91,347,82,541,487,1548,96,118
188,181,1,554,403,1327,64,315,22,493,528,1422,96,119
873,184,19,450,403,1929,222,374,36,349,988,1969,96,120
1136,189,18,523,434,2300,263,468,40,401,1188,2360,96,121
1126,240,10,573,538,2487,277,489,51,508,1278,2603,96,122
1065,191,10,581,503,2350,265,442,38,505,1134,2384,96,123
788,274,5,498,556,2121,212,422,54,495,992,2175,96,124
202,215,5,534,442,1398,91,344,68,481,509,1493,96,125
166,137,4,439,294,1040,39,266,16,448,363,1132,96,126
902,208,7,489,432,2038,225,350,30,418,1026,2049,96,127
1124,193,14,582,475,2388,217,523,38,507,1129,2414,96,128
1186,213,17,612,534,2562,275,531,39,546,1277,2668,96,129
1080,243,26,605,477,2431,253,506,62,485,1157,2463,96,130
740,221,7,530,563,2061,195,418,68,498,973,2152,96,131
254,269,12,651,525,1711,84,359,83,611,647,1784,96,132
182,191,3,406,352,1134,65,288,21,428,419,1221,96,133
921,185,4,516,428,2054,213,386,28,415,1042,2084,96,134
1163,161,9,531,437,2301,257,448,26,481,1116,2328,96,135
1156,196,6,542,446,2346,267,498,40,449,1173,2427,96,136
1107,230,12,553,509,2411,247,546,48,483,1157,2481,96,137
831,254,12,504,536,2137,210,463,70,520,949,2212,96,138
196,184,7,460,336,1183,70,234,48,416,338,1106,96,139
141,166,12,389,303,1011,62,227,28,366,318,1001,96,140
940,204,1,514,437,2096,249,429,21,405,1077,2181,96,141
1166,212,6,533,496,2413,216,511,33,473,1185,2418,96,142
1131,201,4,569,414,2319,241,445,35,446,1212,2379,96,143
1024,214,12,536,460,2246,231,466,40,422,1116,2275,96,144
697,264,7,559,569,2096,185,468,67,536,849,2105,96,145
232,307,4,652,501,1696,115,385,85,586,554,1725,96,146
172,193,1,565,384,1315,69,368,28,494,446,1405,96,147
176,153,6,504,351,1190,81,196,34,493,449,1253,96,148
1050,208,39,533,532,2362,251,449,44,472,1153,2369,96,149
1119,193,50,544,421,2327,244,482,61,463,1067,2317,96,150
163,229,4,541,446,1383,161,479,34,471,948,2093,96,151
711,281,13,534,541,2080,205,474,76,482,968,2205,96,152
21,14,2,17,12,66,23,13,2,26,13,77,96,153
15,4,3,14,6,42,11,5,6,12,6,40,96,154
8,14,8,10,7,47,5,8,9,13,8,43,96,155
28,0,0,0,0,28,26,0,0,0,0,26,96,156
47,12,55,42,10,166,49,15,46,49,11,170,96,179
57,19,36,53,16,181,59,12,44,50,16,181,96,180
53,23,26,16,23,141,45,15,27,28,30,145,96,181
29,8,1,22,26,86,27,5,2,18,21,73,96,182
37,10,10,42,28,127,31,10,12,41,21,115,96,183
74,16,18,77,42,227,51,9,20,77,48,205,96,184
117,39,10,77,31,274,100,38,18,79,31,266,96,185
45,7,5,37,7,101,44,5,4,41,9,103,96,186
100,22,7,70,47,246,71,24,17,75,52,239,96,187
53,26,12,57,53,201,34,26,13,49,56,178,96,188
27,42,12,32,37,150,18,34,25,34,40,151,96,189
61,13,14,36,15,139,50,12,14,46,14,136,96,190
82,11,18,59,18,188,82,12,17,76,18,205,96,191
50,16,24,52,11,153,45,15,22,62,12,156,96,192
86,23,32,52,18,211,71,16,33,60,17,197,96,193
45,5,5,53,14,122,41,3,5,55,16,120,96,194
37,18,1,31,6,93,32,15,1,30,4,82,96,195
21,11,9,13,13,67,17,10,9,17,12,65,96,196
32,31,22,27,17,129,23,26,24,27,13,113,96,197
163,31,10,121,37,362,138,25,14,129,46,352,96,198
60,12,14,75,15,176,58,9,10,79,17,173,96,199
74,9,24,71,26,204,67,7,16,74,38,202,96,200
66,19,5,50,11,151,54,15,5,57,11,142,96,201
35,11,3,38,11,98,29,11,6,44,10,100,96,202
18,13,3,21,10,65,18,9,2,23,11,63,96,203
43,28,19,71,12,173,37,23,23,71,13,167,96,204
55,20,34,41,22,172,52,19,39,52,23,185,96,205
42,9,21,105,16,193,41,8,19,110,18,196,96,206
41,10,20,51,12,134,40,10,16,49,10,125,96,207
42,9,0,35,17,103,39,11,0,42,17,109,96,208
27,16,2,36,20,101,28,14,7,37,21,107,96,209
16,22,14,23,11,86,22,24,21,20,14,101,96,210
32,37,6,47,33,155,31,36,8,46,34,155,96,211
51,31,19,88,45,234,57,33,26,81,46,243,96,212
81,23,13,93,22,232,84,18,18,87,31,238,96,213
78,23,20,75,29,225,70,20,23,70,31,214,96,214
35,48,26,63,38,210,28,47,24,78,25,202,96,215
69,40,25,65,25,224,60,37,35,66,30,228,96,216
53,38,12,44,36,183,53,41,19,50,39,202,96,217
69,27,15,59,24,194,60,32,15,63,25,195,96,218
60,19,29,56,20,184,53,24,28,60,20,185,96,219
57,23,16,63,21,180,61,22,13,61,21,178,96,220
49,14,4,41,26,134,60,13,4,48,21,146,96,221
29,32,14,54,40,169,29,30,10,58,34,161,96,222
47,15,11,25,24,122,45,12,3,35,24,119,96,223
31,25,14,25,20,115,46,26,11,28,20,131,96,224
47,12,10,53,19,141,52,14,14,54,18,152,96,225
47,25,3,34,21,130,40,27,7,34,20,128,96,226
40,35,14,55,15,159,39,39,16,68,18,180,96,227
77,24,14,82,25,222,76,24,15,77,27,219,96,228
64,16,12,78,22,192,55,13,7,75,24,174,96,229
38,14,6,20,15,93,42,13,6,27,12,100,96,230
31,16,10,52,26,135,25,21,8,45,32,131,96,231
63,66,17,86,37,269,54,51,21,76,34,236,96,232
119,36,59,86,46,346,97,40,51,101,47,336,96,233
95,15,31,93,7,241,96,20,26,96,8,246,96,234
28,19,12,23,11,93,35,9,12,23,14,93,96,235
24,7,16,32,23,102,28,10,12,29,20,99,96,236
9,5,6,2,3,25,6,5,5,5,3,24,96,237
22,10,7,8,4,51,18,9,9,9,4,49,96,238
13,10,9,17,10,59,10,11,8,14,11,54,96,239
35,1,3,45,12,96,29,4,0,28,9,70,96,240
11,4,1,8,11,35,3,3,0,2,8,16,96,241
3,12,15,24,17,71,1,9,16,22,15,63,96,242
31,11,1,56,10,109,24,9,5,59,7,104,96,243
11,16,6,20,7,60,6,15,2,22,10,55,96,244
152,157,4,425,356,1094,55,222,19,417,464,1177,96,245
171,167,5,406,351,1100,54,220,12,425,448,1159,96,246
877,166,5,465,432,1945,182,393,17,404,1007,2003,96,247
959,171,43,482,380,2035,194,379,46,364,1069,2052,96,248
961,180,14,465,399,2019,210,359,38,375,1038,2020,96,249
690,221,10,409,411,1741,176,362,62,360,786,1746,96,250
187,222,5,510,439,1363,100,272,83,490,482,1427,96,251
145,150,3,449,345,1092,52,252,19,429,412,1164,96,252
854,184,5,461,394,1898,185,362,24,385,922,1878,96,253
1050,162,6,479,435,2132,189,482,17,375,1125,2188,96,254
1012,165,3,533,443,2156,205,453,21,449,1099,2227,96,255
969,182,5,461,452,2069,184,522,30,390,992,2118,96,256
721,206,9,502,517,1955,179,458,66,447,847,1997,96,257
220,245,9,652,513,1639,102,412,70,603,591,1778,96,258
171,178,15,572,367,1303,63,307,28,490,539,1427,96,259
841,180,7,502,429,1959,176,366,26,402,1010,1980,96,260
1094,163,22,504,396,2179,197,478,48,397,1119,2239,96,261
1047,185,31,530,434,2227,216,494,55,390,1119,2274,96,262
994,200,9,535,420,2158,231,539,37,394,1028,2229,96,263
706,298,16,546,506,2072,193,433,104,472,908,2110,96,264
227,214,10,671,535,1657,95,415,77,561,577,1725,96,265
155,162,12,471,346,1146,45,250,29,427,407,1158,96,266
834,166,17,461,418,1896,204,358,34,386,978,1960,96,267
1058,152,7,446,438,2101,206,494,27,375,1065,2167,96,268
998,196,37,516,460,2207,195,487,62,390,1086,2220,96,269
972,230,25,516,428,2171,225,501,57,420,998,2201,96,270
718,214,45,516,495,1988,214,461,90,464,848,2077,96,271
250,253,19,700,561,1783,114,485,77,599,568,1843,96,272
184,168,21,582,379,1334,105,300,37,480,471,1393,96,273
817,163,19,512,427,1938,197,378,36,411,907,1929,96,274
1073,174,9,480,396,2132,253,466,33,406,1070,2228,96,275
1060,195,24,484,420,2183,247,440,42,435,1067,2231,96,276
941,207,16,496,482,2142,218,449,43,406,1031,2147,96,277
702,251,26,486,467,1932,225,427,70,436,862,2020,96,278
214,265,13,565,484,1541,113,366,58,564,617,1718,96,279
194,166,27,492,417,1296,80,329,41,450,503,1403,96,280
857,199,5,466,474,2001,228,435,24,382,996,2065,96,281
1060,210,21,526,441,2258,219,501,42,409,1126,2297,96,282
1096,179,22,492,492,2281,265,475,45,413,1160,2358,96,283
981,228,14,563,465,2251,224,524,34,431,1097,2310,96,284
662,250,17,572,598,2099,223,478,73,538,904,2216,96,285
245,288,17,663,575,1788,95,387,69,598,653,1802,96,286
234,199,9,517,478,1437,87,318,30,477,510,1422,96,287
502,245,7,548,486,1788,171,389,16,507,716,1799,96,288
1082,193,19,518,431,2243,210,511,45,389,1193,2348,96,289
1082,200,12,513,451,2258,227,458,28,470,1159,2342,96,290
978,195,12,531,472,2188,208,472,42,428,1081,2231,96,291
763,244,4,588,572,2171,182,453,66,491,1006,2198,96,292
198,269,9,619,559,1654,80,408,86,643,572,1789,96,293
137,182,13,527,475,1334,51,321,22,542,469,1405,96,294
866,178,4,559,424,2031,206,411,15,441,1023,2096,96,295
1119,167,13,524,443,2266,201,517,34,429,1178,2359,96,296
1049,183,5,540,444,2221,235,500,21,436,1107,2299,96,297
984,225,9,564,459,2241,204,506,46,408,1108,2272,96,298
705,274,7,541,597,2124,196,464,61,502,955,2178,96,299
222,298,10,639,530,1699,84,395,75,666,553,1773,96,300
211,182,15,542,406,1356,82,303,32,501,530,1448,96,301
842,167,6,498,463,1976,192,368,18,423,1036,2037,96,302
1074,215,2,537,606,2434,199,617,21,454,1159,2450,96,303
1103,212,1,528,512,2356,200,519,19,444,1230,2412,96,304
941,208,12,543,509,2213,210,437,35,462,1139,2283,96,305
688,233,4,554,578,2057,196,430,59,517,958,2160,96,306
191,235,16,603,563,1608,81,396,79,545,563,1664,96,307
181,152,2,497,391,1223,65,282,11,467,440,1265,96,308
877,152,7,483,499,2018,196,386,25,487,1003,2097,96,309
865,174,7,480,447,1973,204,385,39,523,986,2137,96,310
930,164,8,465,457,2024,212,410,16,415,1045,2098,96,311
980,182,17,476,451,2106,235,419,46,363,1124,2187,96,312
733,253,30,494,515,2025,191,450,76,468,867,2052,96,313
220,258,20,658,527,1683,108,343,69,615,663,1798,96,314
176,142,2,601,443,1364,83,282,21,508,588,1482,96,315
509,193,1,560,514,1777,191,336,15,512,797,1851,96,316
1112,149,28,463,483,2235,237,450,51,372,1159,2269,96,317
1138,180,7,515,503,2343,258,472,29,468,1182,2409,96,318
983,162,11,513,455,2124,210,430,40,419,1115,2214,96,319
725,208,23,497,500,1953,184,399,74,472,903,2032,96,320
233,200,5,587,446,1471,98,252,51,540,527,1468,96,321
144,133,2,448,355,1082,50,200,12,445,414,1121,96,322
894,153,6,484,451,1988,195,371,23,439,997,2025,96,323
1172,135,3,525,490,2325,245,478,18,431,1250,2422,96,324
1117,199,6,530,455,2307,265,474,21,435,1223,2418,96,325
1021,204,8,515,455,2203,224,502,29,426,1091,2272,96,326
663,201,9,496,465,1834,198,386,72,439,787,1882,96,327
216,218,11,605,524,1574,95,326,64,602,618,1705,96,328
175,128,6,491,338,1138,69,259,31,503,422,1284,96,329
848,177,7,494,456,1982,209,332,24,502,971,2038,96,330
842,198,9,526,507,2082,208,409,19,492,1048,2176,96,331
586,188,2,630,573,1979,205,349,27,627,794,2002,96,332
106,78,1,294,179,658,46,137,12,284,228,707,96,333
324,261,7,635,536,1763,166,270,32,748,653,1869,96,334
177,190,7,525,433,1332,66,281,34,517,512,1410,96,335
139,157,3,432,369,1100,45,249,13,472,398,1177,96,336
843,171,9,485,418,1926,222,331,24,397,957,1931,96,337
1096,174,12,492,510,2284,231,452,39,405,1205,2332,96,338
1124,159,6,479,457,2225,247,420,32,420,1154,2273,96,339
960,135,14,469,430,2008,183,438,35,361,1024,2041,96,340
729,199,19,484,496,1927,153,356,58,476,890,1933,96,341
196,215,17,559,503,1490,84,367,71,579,500,1601,96,342
156,151,3,497,444,1251,90,297,19,465,475,1346,96,343
861,146,16,458,399,1880,212,369,35,338,1006,1960,96,344
1117,164,8,534,472,2295,215,477,34,395,1223,2344,96,345
1076,189,11,498,372,2146,220,471,36,374,1052,2153,96,346
1082,185,8,592,505,2372,240,516,45,436,1169,2406,96,347
729,224,15,522,545,2035,193,415,72,491,924,2095,96,348
198,320,9,652,565,1744,95,347,82,613,651,1788,96,349
145,170,4,469,442,1230,63,288,29,521,448,1349,96,350
852,209,21,498,433,2013,211,387,40,431,993,2062,96,351
1048,193,30,563,570,2404,212,412,76,508,1160,2368,96,352
1017,176,43,570,484,2290,235,453,65,518,1090,2361,96,353
908,220,43,542,542,2255,241,464,71,500,1115,2391,96,354
628,281,9,508,545,1971,195,378,80,508,853,2014,96,355
195,249,5,583,569,1601,95,333,40,642,592,1702,96,356
141,171,16,518,427,1273,66,231,28,464,555,1344,96,357
519,244,30,574,561,1928,179,334,64,582,854,2013,96,358
337,104,22,492,448,1403,132,199,44,541,452,1368,96,359
70,60,7,210,106,453,35,116,25,157,147,480,96,360
372,197,8,480,590,1647,124,308,31,493,674,1630,96,361
375,213,4,541,563,1696,119,333,45,511,707,1715,96,362
159,209,4,409,415,1196,65,280,59,453,441,1298,96,363
152,154,3,474,377,1160,68,241,15,466,430,1220,96,364
516,196,14,579,577,1882,139,340,42,524,854,1899,96,365
416,304,42,522,473,1757,129,330,141,529,620,1749,96,366
62,44,3,312,83,504,28,132,9,422,227,818,97,1
731,95,4,297,229,1356,207,219,6,202,771,1405,97,2
826,61,3,288,398,1576,196,332,11,183,909,1631,97,3
814,60,9,310,311,1504,230,227,11,201,884,1553,97,4
510,72,8,296,390,1276,170,317,32,203,549,1271,97,5
101,88,11,304,183,687,36,211,32,171,215,665,97,6
68,54,4,419,154,699,14,262,9,135,301,721,97,7
704,50,2,238,303,1297,214,247,5,164,686,1316,97,8
965,55,2,238,234,1494,217,210,4,250,858,1539,97,9
1020,77,3,304,320,1724,265,283,8,208,952,1716,97,10
904,76,5,342,413,1740,223,372,11,263,872,1741,97,11
434,89,6,273,295,1097,176,228,24,181,407,1016,97,12
105,75,5,571,168,924,29,262,47,164,380,882,97,13
61,49,5,229,103,447,16,141,14,150,205,526,97,14
110,44,11,195,109,469,69,122,20,117,194,522,97,15
238,37,3,155,206,639,124,185,9,94,219,631,97,16
748,58,10,224,299,1339,196,248,8,167,729,1348,97,17
917,69,4,285,385,1660,210,356,9,202,869,1646,97,18
272,58,8,327,231,896,80,220,25,156,352,833,97,19
113,83,13,357,233,799,28,259,50,158,247,742,97,20
45,37,7,280,110,479,17,148,9,136,229,539,97,21
714,59,6,236,281,1296,200,236,8,143,752,1339,97,22
1071,52,4,265,371,1763,250,293,9,194,1007,1753,97,23
1072,73,6,271,383,1805,241,364,21,216,952,1794,97,24
921,85,6,306,370,1688,225,346,15,225,882,1693,97,25
522,118,7,397,356,1400,183,262,45,238,623,1351,97,26
131,81,7,609,331,1159,47,338,60,221,462,1128,97,27
81,57,2,311,127,578,21,189,7,175,247,639,97,28
692,64,2,247,261,1266,198,224,3,202,694,1321,97,29
1063,76,2,259,345,1745,239,306,4,190,1015,1754,97,30
1006,80,5,266,397,1754,244,370,7,220,893,1734,97,31
1041,63,4,256,360,1724,252,302,11,204,959,1728,97,32
506,82,8,239,339,1174,165,252,42,176,509,1144,97,33
138,97,6,483,248,972,33,278,36,192,341,880,97,34
87,53,6,301,133,580,29,188,5,157,265,644,97,35
693,53,3,212,293,1254,203,226,7,169,659,1264,97,36
1115,57,8,259,416,1855,248,343,17,212,983,1803,97,37
1049,85,5,297,453,1889,265,362,12,219,986,1844,97,38
982,101,4,283,407,1777,278,307,9,227,948,1769,97,39
533,116,6,317,349,1321,167,219,70,216,591,1263,97,40
139,103,9,489,336,1076,38,375,64,191,372,1040,97,41
71,48,4,415,114,652,27,112,21,173,375,708,97,42
685,64,3,268,269,1289,184,237,9,187,712,1329,97,43
940,74,2,269,403,1688,215,350,11,179,911,1666,97,44
1040,87,7,304,357,1795,211,293,14,248,1037,1803,97,45
980,58,9,309,354,1710,247,273,18,195,896,1629,97,46
461,122,15,323,346,1267,158,228,52,241,530,1209,97,47
97,92,6,456,184,835,40,186,40,171,315,752,97,48
67,60,4,392,169,692,31,204,11,200,325,771,97,49
220,56,5,351,214,846,102,186,6,206,363,863,97,50
1073,78,1,301,395,1848,249,359,8,231,1048,1895,97,51
1051,77,6,321,373,1828,249,338,8,225,1016,1836,97,52
1027,77,4,262,357,1727,216,326,24,196,958,1720,97,53
572,125,7,257,289,1250,152,230,35,177,617,1211,97,54
129,100,6,490,331,1056,26,288,74,195,380,963,97,55
70,43,2,298,179,592,31,193,4,154,257,639,97,56
760,70,2,262,345,1439,209,310,8,188,752,1467,97,57
1080,69,3,294,343,1789,253,315,9,207,996,1780,97,58
1094,66,5,253,319,1737,249,314,8,204,984,1759,97,59
993,79,6,288,335,1701,234,330,5,210,892,1671,97,60
542,100,10,282,484,1418,151,346,54,229,592,1372,97,61
91,99,13,390,235,828,31,269,47,143,327,817,97,62
79,54,7,505,138,783,28,206,8,196,405,843,97,63
769,57,3,274,320,1423,229,241,8,175,785,1438,97,64
1054,68,4,312,381,1819,220,347,15,216,1066,1864,97,65
1068,80,2,293,437,1880,233,401,10,212,1026,1882,97,66
1020,93,9,343,442,1907,295,343,34,205,980,1857,97,67
508,130,9,464,374,1485,210,356,49,267,607,1489,97,68
181,119,7,522,325,1154,41,457,55,234,386,1173,97,69
86,52,11,410,149,708,41,186,26,195,330,778,97,70
687,70,4,299,257,1317,180,247,11,168,728,1334,97,71
1105,77,7,379,429,1997,255,402,22,234,1095,2008,97,72
1078,80,5,379,475,2017,280,416,29,227,1099,2051,97,73
929,102,3,488,483,2005,275,396,57,253,986,1967,97,74
531,95,8,361,438,1433,170,303,85,242,594,1394,97,75
184,134,5,1017,372,1712,53,562,117,301,674,1707,97,76
102,81,2,580,220,985,44,356,14,235,419,1068,97,77
731,56,2,359,330,1478,220,242,5,246,788,1501,97,78
1103,70,7,376,419,1975,264,409,29,283,1062,2047,97,79
1093,73,11,448,477,2102,247,447,25,293,1026,2038,97,80
960,89,8,427,491,1975,298,433,10,275,943,1959,97,81
594,99,7,543,569,1812,177,459,41,296,769,1742,97,82
115,107,5,526,316,1069,33,378,67,133,393,1004,97,83
170,79,4,1112,238,1603,35,409,12,301,851,1608,97,84
716,75,7,621,447,1866,183,333,46,267,940,1769,97,85
1007,84,5,565,521,2182,235,468,22,271,1185,2181,97,86
939,85,11,425,351,1811,221,370,28,233,951,1803,97,87
827,76,5,430,349,1687,257,316,15,252,901,1741,97,88
469,113,10,670,361,1623,164,402,50,255,722,1593,97,89
192,126,9,1142,443,1912,33,616,69,290,911,1919,97,90
112,72,1,477,189,851,41,246,4,214,414,919,97,91
658,72,4,623,323,1680,207,487,10,227,711,1642,97,92
1029,77,6,355,382,1849,275,307,12,261,996,1851,97,93
1027,62,11,317,372,1789,250,366,20,202,945,1783,97,94
968,95,4,451,548,2066,268,492,17,258,991,2026,97,95
593,101,14,415,409,1532,216,328,58,214,663,1479,97,96
202,111,8,712,244,1277,35,467,33,283,407,1225,97,97
242,71,6,593,228,1140,48,364,20,333,440,1205,97,98
668,82,3,282,347,1382,215,251,23,224,719,1432,97,99
1025,83,7,347,429,1891,270,382,38,231,1006,1927,97,100
1048,74,4,440,397,1963,282,386,15,289,1043,2015,97,101
1039,84,6,374,409,1912,275,356,30,265,945,1871,97,102
567,132,13,385,374,1471,194,325,62,232,595,1408,97,103
225,100,7,661,395,1388,50,447,73,209,589,1368,97,104
132,84,10,490,183,899,53,276,15,223,417,984,97,105
748,53,5,355,414,1575,222,342,13,209,790,1576,97,106
1153,85,7,334,439,2018,312,375,16,302,1014,2019,97,107
1167,92,7,341,374,1981,247,401,12,314,987,1961,97,108
1010,92,8,380,399,1889,276,387,12,287,901,1863,97,109
572,110,12,389,435,1518,194,347,47,210,626,1424,97,110
130,115,10,1063,417,1735,29,717,59,208,605,1618,97,111
82,67,4,457,148,758,28,213,11,164,381,797,97,112
710,73,3,326,307,1419,227,273,8,232,762,1502,97,113
1069,72,9,356,476,1982,295,432,10,209,1012,1958,97,114
1076,71,11,361,514,2033,302,472,11,240,988,2013,97,115
1026,90,15,429,493,2053,302,515,15,249,977,2058,97,116
529,137,10,405,524,1605,211,436,74,243,568,1532,97,117
183,109,4,477,352,1125,37,399,98,223,324,1081,97,118
119,88,5,489,259,960,37,276,64,211,440,1028,97,119
700,60,8,322,300,1390,238,229,14,219,723,1423,97,120
1106,64,9,279,386,1844,261,355,10,234,958,1818,97,121
1047,103,11,371,439,1971,295,420,21,250,1027,2013,97,122
995,96,12,361,396,1860,291,365,13,264,948,1881,97,123
566,132,9,392,437,1536,191,366,55,247,595,1454,97,124
173,84,17,486,279,1039,39,410,46,194,345,1034,97,125
67,72,11,362,144,656,33,241,21,180,253,728,97,126
711,93,4,288,311,1407,262,242,22,193,734,1453,97,127
1086,84,8,336,509,2023,289,431,22,252,1050,2044,97,128
1124,99,16,325,581,2145,271,525,33,237,1057,2123,97,129
947,97,10,325,451,1830,295,351,29,242,919,1836,97,130
547,116,7,366,335,1371,176,274,28,226,557,1261,97,131
170,128,11,548,277,1134,46,343,50,238,520,1197,97,132
108,67,5,367,159,706,52,217,7,186,345,807,97,133
747,77,7,365,302,1498,252,272,10,214,769,1517,97,134
1089,82,3,321,389,1884,287,344,15,232,1026,1904,97,135
1042,88,4,350,419,1903,255,409,14,223,1031,1932,97,136
953,111,7,422,463,1956,288,378,21,270,938,1895,97,137
574,147,11,384,413,1529,226,320,35,228,659,1468,97,138
122,115,12,517,285,1051,33,367,48,195,392,1035,97,139
130,73,1,445,173,822,42,257,13,252,371,935,97,140
788,95,2,351,419,1655,252,333,12,237,829,1663,97,141
1159,90,5,363,467,2084,292,459,11,243,1061,2066,97,142
1099,86,6,579,401,2171,277,355,9,249,1200,2090,97,143
949,110,3,370,423,1855,281,367,10,258,937,1853,97,144
522,189,9,406,528,1654,190,470,41,296,516,1513,97,145
159,125,18,760,412,1474,58,652,83,218,391,1402,97,146
114,140,6,672,247,1179,60,344,59,259,526,1248,97,147
90,67,3,373,141,674,56,256,15,212,322,861,97,148
1032,104,7,352,377,1872,283,316,47,261,999,1906,97,149
1110,80,5,324,380,1899,292,346,9,247,1029,1923,97,150
1011,107,4,368,488,1978,288,390,11,285,974,1948,97,151
587,132,17,346,390,1472,210,313,59,260,612,1454,97,152
125,173,12,553,350,1213,53,395,65,229,420,1162,97,153
119,76,7,460,144,806,44,218,8,264,379,913,97,154
763,96,7,320,418,1604,261,359,12,242,792,1666,97,155
1166,93,5,329,544,2137,338,412,17,278,1084,2129,97,156
1133,88,3,358,403,1985,257,377,11,276,1065,1986,97,157
1030,94,5,384,565,2078,302,497,27,281,881,1988,97,158
652,144,10,383,766,1955,232,512,133,318,639,1834,97,159
139,149,8,1169,518,1983,43,970,102,251,569,1935,97,160
104,76,6,695,216,1097,43,365,21,262,491,1182,97,161
795,98,5,377,372,1647,276,299,13,278,814,1680,97,162
1176,91,12,391,470,2140,314,441,20,289,1063,2127,97,163
1122,112,11,427,536,2208,318,542,52,274,1117,2303,97,164
1019,119,4,450,494,2086,307,462,20,302,940,2031,97,165
561,133,6,437,562,1699,223,432,109,283,648,1695,97,166
141,124,12,641,415,1333,56,482,81,204,397,1220,97,167
121,110,3,572,182,988,57,217,8,226,473,981,97,168
776,91,9,305,389,1570,275,290,26,219,742,1552,97,169
1072,97,13,389,534,2105,326,470,31,278,1014,2119,97,170
305,111,11,526,349,1302,178,408,18,225,441,1270,97,171
979,133,20,542,436,2110,285,376,33,243,1040,1977,97,172
584,125,9,427,374,1519,206,326,43,261,643,1479,97,173
154,185,7,510,360,1216,64,464,92,249,337,1206,97,174
92,77,3,368,202,742,36,228,31,236,292,823,97,175
818,64,7,368,319,1576,258,276,14,222,813,1583,97,176
1396,125,8,384,456,2369,562,508,13,254,1074,2411,97,177
1153,93,10,395,449,2100,272,432,20,298,1063,2085,97,178
1095,128,6,477,475,2181,319,429,27,278,1052,2105,97,179
611,139,4,499,437,1690,201,346,58,308,699,1612,97,180
162,141,6,609,322,1240,57,390,57,245,428,1177,97,181
98,64,6,384,179,731,52,251,13,198,359,873,97,182
781,93,4,446,490,1814,265,419,18,253,879,1834,97,183
1005,102,7,389,537,2040,283,482,27,260,958,2010,97,184
753,134,9,409,632,1937,224,477,77,293,776,1847,97,185
224,439,14,695,738,2110,45,1361,122,340,507,2375,97,186
306,175,8,457,316,1262,118,380,25,266,542,1331,97,187
147,133,11,549,197,1037,51,397,42,201,351,1042,97,188
101,67,6,421,144,739,51,203,12,237,367,870,97,189
711,109,5,352,349,1526,249,328,14,249,675,1515,97,190
952,84,6,378,434,1854,319,360,16,264,935,1894,97,191
921,95,4,319,396,1735,269,340,8,263,880,1760,97,192
901,138,12,398,422,1871,267,382,22,231,896,1798,97,193
519,135,19,400,397,1470,186,308,64,239,503,1300,97,194
180,150,12,619,497,1458,60,603,85,217,398,1363,97,195
82,77,9,351,161,680,40,231,22,201,268,762,97,196
749,104,14,315,298,1480,251,242,17,227,770,1507,97,197
1110,91,6,353,411,1971,292,392,21,254,1029,1988,97,198
1105,102,6,329,327,1869,286,302,18,226,1033,1865,97,199
982,136,7,425,432,1982,291,361,24,252,940,1868,97,200
560,159,26,406,555,1706,207,408,179,222,608,1624,97,201
119,162,11,599,561,1452,56,679,70,236,389,1430,97,202
86,77,4,500,183,850,39,222,17,211,501,990,97,203
723,84,7,357,372,1543,236,323,45,222,783,1609,97,204
1059,80,13,388,479,2019,291,465,22,231,1039,2048,97,205
980,103,7,390,505,1985,259,451,22,249,987,1968,97,206
932,183,3,459,462,2039,284,377,19,291,933,1904,97,207
542,167,11,420,408,1548,190,315,102,268,589,1464,97,208
196,206,11,590,439,1442,48,528,139,236,408,1359,97,209
115,77,11,425,161,789,61,244,32,230,353,920,97,210
675,85,3,397,532,1692,227,361,140,237,707,1672,97,211
1070,95,4,350,417,1936,295,449,19,252,945,1960,97,212
1010,84,2,367,380,1843,250,343,12,263,956,1824,97,213
928,116,3,422,425,1894,280,436,26,234,852,1828,97,214
574,148,6,474,625,1827,202,499,99,283,613,1696,97,215
195,130,12,726,222,1285,45,512,65,221,388,1231,97,216
158,86,12,541,194,991,39,258,19,231,528,1075,97,217
637,113,7,385,360,1502,251,328,14,229,690,1512,97,218
1015,90,4,360,497,1966,268,462,21,248,939,1938,97,219
939,79,5,347,443,1813,253,365,33,249,950,1850,97,220
820,120,3,360,368,1671,230,346,26,258,788,1648,97,221
474,162,6,294,426,1362,156,331,106,191,480,1264,97,222
150,154,9,563,402,1278,57,432,89,257,386,1221,97,223
140,84,12,479,206,921,50,291,18,228,438,1025,97,224
679,90,5,350,322,1446,243,254,9,261,722,1489,97,225
959,86,6,358,430,1839,272,390,13,227,957,1859,97,226
919,83,13,407,438,1860,252,360,19,288,936,1855,97,227
844,98,6,365,403,1716,262,320,42,273,792,1689,97,228
507,166,7,361,375,1416,161,280,64,245,560,1310,97,229
122,128,13,511,337,1111,45,317,119,225,393,1099,97,230
86,61,14,378,188,727,33,238,35,215,347,868,97,231
613,69,2,335,248,1267,217,179,12,220,703,1331,97,232
988,95,0,329,401,1813,235,396,18,237,986,1872,97,233
901,66,2,364,368,1701,211,380,16,233,894,1734,97,234
901,110,5,359,387,1762,233,333,25,255,923,1769,97,235
543,135,7,342,360,1387,161,305,38,218,600,1322,97,236
198,118,4,535,364,1219,43,437,68,228,401,1177,97,237
93,69,2,389,190,743,36,246,27,201,333,843,97,238
651,79,4,299,413,1446,215,349,14,238,686,1502,97,239
986,69,8,330,499,1892,223,441,28,204,952,1848,97,240
927,102,1,296,462,1788,267,375,18,254,873,1787,97,241
857,106,9,360,393,1725,203,292,86,275,819,1675,97,242
486,146,8,400,400,1440,170,301,89,287,449,1296,97,243
184,93,8,720,262,1267,36,509,44,235,371,1195,97,244
125,90,1,517,174,907,35,282,15,221,470,1023,97,245
81,83,4,374,168,710,52,225,12,172,363,824,97,246
957,75,1,311,354,1698,244,315,2,239,949,1749,97,247
1063,80,6,263,322,1734,222,319,9,223,993,1766,97,248
966,80,4,332,383,1765,267,313,9,261,901,1751,97,249
534,101,8,299,374,1316,150,282,47,209,567,1255,97,250
145,108,5,535,437,1230,53,400,184,251,338,1226,97,251
108,57,4,331,176,676,33,221,17,212,268,751,97,252
739,73,8,310,337,1467,224,286,30,235,721,1496,97,253
1092,82,1,304,420,1899,261,389,18,243,1026,1937,97,254
1059,87,4,329,420,1899,221,408,23,220,1003,1875,97,255
967,89,5,339,461,1861,231,405,12,261,927,1836,97,256
549,158,11,325,472,1515,153,358,75,261,623,1470,97,257
137,108,3,638,330,1216,38,469,51,280,360,1198,97,258
111,60,4,563,178,916,42,223,9,229,484,987,97,259
746,70,2,325,301,1444,213,294,10,244,762,1523,97,260
1116,81,3,359,350,1909,269,374,8,262,1017,1930,97,261
1049,92,6,299,374,1820,236,389,18,217,989,1849,97,262
961,74,4,357,525,1921,228,462,16,272,964,1942,97,263
536,152,7,383,401,1479,146,319,66,271,597,1399,97,264
161,115,5,576,295,1152,51,364,89,228,376,1108,97,265
100,51,4,421,192,768,35,232,18,219,345,849,97,266
806,88,16,308,351,1569,247,286,27,231,798,1589,97,267
1102,110,14,296,455,1977,262,417,45,234,1056,2014,97,268
1028,108,3,349,508,1996,240,465,18,285,1004,2012,97,269
1017,117,8,426,404,1972,231,350,45,296,1032,1954,97,270
549,112,4,302,490,1457,144,359,96,242,584,1425,97,271
188,133,9,747,425,1502,57,618,78,262,454,1469,97,272
87,65,3,515,199,869,42,423,24,198,287,974,97,273
705,84,2,272,296,1359,213,249,13,236,703,1414,97,274
1095,87,4,320,394,1900,260,350,9,265,1072,1956,97,275
1062,79,3,318,431,1893,227,356,29,259,1005,1876,97,276
886,108,4,423,420,1841,223,401,28,284,891,1827,97,277
531,144,8,394,364,1441,144,305,76,269,592,1386,97,278
146,142,5,562,320,1175,35,455,50,220,398,1158,97,279
101,81,8,414,153,757,34,207,24,230,385,880,97,280
789,72,4,328,316,1509,208,275,13,245,790,1531,97,281
1095,86,8,354,387,1930,248,377,13,279,1095,2012,97,282
1072,88,3,426,435,2024,230,372,22,321,1047,1992,97,283
947,121,11,387,451,1917,238,437,23,272,896,1866,97,284
511,124,5,414,390,1444,166,285,37,270,661,1419,97,285
206,163,5,633,397,1404,48,507,65,265,436,1321,97,286
159,66,6,459,218,908,29,257,65,252,373,976,97,287
321,71,13,404,267,1076,146,224,21,222,511,1124,97,288
1138,79,3,369,481,2070,253,415,13,295,1110,2086,97,289
1112,106,6,383,439,2046,271,384,19,302,1138,2114,97,290
986,97,4,374,476,1937,245,442,27,262,987,1963,97,291
561,106,8,369,409,1453,166,313,53,235,611,1378,97,292
143,133,5,553,347,1181,48,399,71,245,388,1151,97,293
87,55,2,459,236,839,46,340,11,210,348,955,97,294
729,74,13,340,333,1489,229,311,19,223,767,1549,97,295
1065,83,19,382,386,1935,273,361,26,269,1051,1980,97,296
1076,87,2,399,459,2023,259,458,31,237,1084,2069,97,297
1010,93,3,416,449,1971,254,417,23,283,973,1950,97,298
549,123,6,353,436,1467,161,289,73,244,670,1437,97,299
154,176,8,500,334,1172,54,355,92,261,360,1122,97,300
362,61,4,499,248,1174,48,235,47,380,536,1246,97,301
742,58,3,344,296,1443,195,266,7,223,753,1444,97,302
1065,89,15,446,766,2381,256,778,45,305,998,2382,97,303
1118,74,6,352,394,1944,225,394,18,300,1054,1991,97,304
885,149,12,348,455,1849,239,324,38,298,882,1781,97,305
543,166,13,380,387,1489,164,283,45,255,587,1334,97,306
179,125,4,615,439,1362,37,506,78,242,434,1297,97,307
127,61,4,345,186,723,44,204,8,246,378,880,97,308
721,50,4,345,340,1460,225,270,15,248,828,1586,97,309
769,86,3,310,379,1547,256,220,29,302,765,1572,97,310
821,89,4,311,488,1713,231,381,22,264,869,1767,97,311
929,83,5,314,440,1771,264,285,13,277,921,1760,97,312
538,118,2,368,441,1467,180,345,48,251,828,1652,97,313
149,128,6,505,270,1058,38,283,40,222,410,993,97,314
126,62,4,442,166,800,32,201,21,234,415,903,97,315
339,69,4,316,284,1012,165,213,17,235,477,1107,97,316
1104,85,5,328,430,1952,306,366,22,282,1041,2017,97,317
1119,86,3,329,559,2096,294,421,26,257,1076,2074,97,318
992,90,5,313,391,1791,271,296,17,252,961,1797,97,319
550,116,4,313,386,1369,184,283,59,245,556,1327,97,320
162,129,12,557,278,1138,50,290,64,220,471,1095,97,321
90,45,4,384,187,710,45,179,14,219,336,793,97,322
785,66,13,318,348,1530,229,235,28,271,788,1551,97,323
1172,76,2,296,424,1970,285,391,10,232,1099,2017,97,324
1109,70,6,311,379,1875,255,337,23,226,1036,1877,97,325
991,81,3,332,508,1915,256,423,21,294,934,1928,97,326
551,118,4,287,436,1396,174,286,59,236,539,1294,97,327
126,102,6,470,397,1101,39,367,61,214,355,1036,97,328
90,49,3,409,169,720,34,175,11,215,367,802,97,329
677,77,41,383,351,1529,203,266,67,237,791,1564,97,330
816,80,15,389,403,1703,237,330,21,261,902,1751,97,331
457,131,15,464,349,1416,189,276,21,345,556,1387,97,332
61,90,3,169,95,418,25,70,6,205,136,442,97,333
190,80,3,567,243,1083,54,333,24,258,425,1094,97,334
129,63,14,448,190,844,41,223,40,162,419,885,97,335
92,41,11,425,189,758,38,185,17,197,335,772,97,336
700,52,7,294,316,1369,230,230,12,229,744,1445,97,337
1091,62,8,332,476,1969,284,430,17,252,1025,2008,97,338
1097,80,4,315,420,1916,246,373,18,291,994,1922,97,339
1007,96,7,345,488,1943,267,446,15,284,906,1918,97,340
515,92,10,319,380,1316,176,269,47,186,572,1250,97,341
129,110,9,494,385,1127,34,389,55,205,418,1101,97,342
96,55,4,400,243,798,36,252,25,204,356,873,97,343
689,69,2,281,300,1341,209,274,7,197,697,1384,97,344
1169,67,5,384,392,2017,287,400,17,238,1026,1968,97,345
1088,151,3,373,367,1982,329,361,23,243,1052,2008,97,346
1023,110,3,346,517,1999,242,426,20,254,962,1904,97,347
563,169,5,384,421,1542,161,333,67,256,625,1442,97,348
283,124,9,611,407,1434,38,479,86,360,391,1354,97,349
67,59,7,372,156,661,31,226,14,180,360,811,97,350
758,70,6,315,290,1439,212,206,10,267,778,1473,97,351
1082,80,5,398,549,2114,281,394,86,284,1046,2091,97,352
979,104,4,391,409,1887,253,387,11,247,1017,1915,97,353
837,115,4,347,491,1794,210,420,16,268,804,1718,97,354
422,116,7,321,417,1283,141,327,69,200,441,1178,97,355
101,102,5,417,226,851,28,243,28,170,328,797,97,356
109,59,4,430,200,802,17,311,14,148,290,780,97,357
348,68,6,434,276,1132,127,278,15,223,450,1093,97,358
148,56,1,275,107,587,73,85,4,179,265,606,97,359
54,35,5,114,76,284,19,52,9,88,100,268,97,360
215,51,8,363,268,905,94,219,19,186,376,894,97,361
212,90,10,410,242,964,117,204,46,171,373,911,97,362
90,84,8,414,189,785,38,279,38,181,238,774,97,363
83,65,5,398,210,761,43,197,76,190,310,816,97,364
313,89,15,472,320,1209,150,293,23,223,484,1173,97,365
302,304,68,523,278,1475,129,231,233,258,540,1391,97,366
43,111,6,618,377,1155,70,183,10,556,405,1224,98,1
757,154,10,643,639,2203,225,314,12,727,1011,2289,98,2
954,247,6,671,743,2621,292,433,5,650,1261,2641,98,3
981,239,11,686,738,2655,321,496,8,609,1192,2626,98,4
617,378,51,642,838,2526,290,617,31,649,1050,2637,98,5
124,220,19,672,360,1395,75,385,26,529,447,1462,98,6
69,159,11,830,569,1638,68,264,14,806,602,1754,98,7
976,237,28,642,780,2663,298,509,30,633,1160,2630,98,8
1217,139,20,569,390,2335,248,314,32,567,1179,2340,98,9
1317,290,20,768,745,3140,286,570,21,624,1560,3061,98,10
1223,317,18,683,843,3084,314,664,20,594,1422,3014,98,11
743,325,38,695,794,2595,267,575,31,587,1064,2524,98,12
119,427,40,1366,880,2832,142,615,41,1078,1118,2994,98,13
101,235,4,947,588,1875,86,360,10,969,642,2067,98,14
168,242,6,878,397,1691,63,350,8,631,653,1705,98,15
474,190,24,494,525,1707,184,415,21,377,679,1676,98,16
1147,199,4,827,670,2847,244,628,7,494,1331,2704,98,17
1383,332,13,798,755,3281,312,775,20,635,1519,3261,98,18
446,401,43,621,582,2093,144,566,63,461,807,2041,98,19
150,343,62,979,695,2229,77,569,54,718,677,2095,98,20
104,220,2,911,547,1784,72,409,3,711,671,1866,98,21
1055,203,7,678,765,2708,336,520,18,515,1244,2633,98,22
1474,272,13,676,766,3201,360,683,13,482,1570,3108,98,23
1418,283,9,959,788,3457,374,708,21,589,1646,3338,98,24
1361,304,12,689,763,3129,303,708,23,477,1492,3003,98,25
743,530,81,902,1062,3318,308,753,53,925,1262,3301,98,26
144,453,94,1267,1172,3130,143,630,67,1424,929,3193,98,27
98,208,3,977,544,1830,83,295,2,889,694,1963,98,28
1080,235,11,626,711,2663,313,558,16,564,1285,2736,98,29
1492,250,20,679,768,3209,340,634,25,499,1588,3086,98,30
1455,307,13,758,770,3303,328,712,24,547,1603,3214,98,31
1361,344,7,805,806,3323,345,710,12,607,1484,3158,98,32
818,468,101,711,923,3021,303,683,116,653,1230,2985,98,33
22,4,6,16,5,53,25,3,9,18,8,63,98,34
10,13,26,9,9,67,12,16,33,15,10,86,98,35
1074,218,15,692,708,2707,311,518,21,533,1326,2709,98,36
1485,300,13,663,848,3309,372,732,16,526,1621,3267,98,37
1436,266,11,788,823,3324,354,737,17,581,1638,3327,98,38
1359,300,4,771,834,3268,316,702,7,558,1486,3069,98,39
769,510,68,861,1045,3253,326,724,47,868,1246,3211,98,40
158,507,71,1408,1245,3389,124,772,48,1604,979,3527,98,41
111,303,8,1028,592,2042,103,352,22,830,805,2112,98,42
1045,182,6,688,669,2590,309,515,14,606,1213,2657,98,43
1309,275,3,741,760,3088,316,702,8,575,1490,3091,98,44
1426,337,7,837,797,3404,330,646,13,657,1731,3377,98,45
1327,317,17,833,831,3325,355,711,11,709,1366,3152,98,46
677,453,52,982,899,3063,332,681,42,840,1070,2965,98,47
215,448,32,1203,879,2777,89,599,30,1062,834,2614,98,48
120,288,5,1286,1068,2767,112,394,12,1442,703,2663,98,49
261,235,6,982,890,2374,159,429,13,1130,709,2440,98,50
1354,235,1,737,851,3178,363,670,3,646,1523,3205,98,51
1340,277,21,818,867,3323,394,664,19,723,1550,3350,98,52
1314,316,14,842,961,3447,378,704,18,712,1462,3274,98,53
775,456,45,853,1011,3140,324,675,55,889,1136,3079,98,54
130,428,42,1204,1074,2878,154,656,64,1212,872,2958,98,55
101,189,21,936,806,2053,91,350,18,1204,661,2324,98,56
1141,236,3,749,847,2976,363,590,9,644,1334,2940,98,57
1521,281,1,758,811,3372,386,658,7,668,1619,3338,98,58
1483,287,8,813,691,3282,342,665,18,549,1634,3208,98,59
1364,333,27,782,880,3386,362,731,31,600,1457,3181,98,60
804,475,45,760,1199,3283,368,785,64,763,1180,3160,98,61
160,453,66,1014,880,2573,96,712,54,909,902,2673,98,62
114,241,7,1314,1325,3001,143,348,8,1817,698,3014,98,63
1033,255,6,851,983,3128,375,541,14,812,1291,3033,98,64
1459,332,9,834,997,3631,371,701,16,734,1655,3477,98,65
1415,292,2,895,849,3453,433,742,6,607,1580,3368,98,66
1361,384,6,904,1172,3827,459,851,28,875,1505,3718,98,67
820,471,52,1158,1393,3894,489,833,57,1062,1326,3767,98,68
259,397,48,1094,598,2396,89,485,44,879,794,2291,98,69
104,266,12,1266,929,2577,131,389,17,1374,833,2744,98,70
1020,284,9,865,932,3110,376,641,6,804,1307,3134,98,71
1437,386,10,1290,1539,4662,491,905,15,1265,1698,4374,98,72
1440,394,26,1664,1519,5043,611,923,29,1421,1729,4713,98,73
1255,482,10,1363,1641,4751,447,914,47,1540,1640,4588,98,74
752,490,45,1318,1605,4210,440,806,68,1456,1252,4022,98,75
450,679,84,2569,2355,6137,612,929,67,3171,1391,6170,98,76
120,362,11,1422,1399,3314,177,547,12,1763,924,3423,98,77
1069,304,9,937,1042,3361,353,656,12,896,1538,3455,98,78
1450,389,6,1130,1085,4060,418,875,13,841,1899,4046,98,79
1502,393,1,1113,1292,4301,464,970,6,1046,1829,4315,98,80
1462,428,6,1111,1475,4482,638,886,12,971,1637,4144,98,81
867,588,47,1123,1796,4421,661,900,57,1251,1405,4274,98,82
128,548,42,1043,1225,2986,239,746,54,898,1086,3023,98,83
131,380,11,1912,1897,4331,283,489,14,2311,1257,4354,98,84
985,356,9,1517,2255,5122,476,737,29,2214,1565,5021,98,85
1426,389,3,1714,2471,6003,596,887,7,2386,1850,5726,98,86
1313,343,21,1055,950,3682,434,816,16,808,1582,3656,98,87
1154,482,8,1262,1443,4349,419,807,11,1146,1779,4162,98,88
740,621,45,2236,3283,6925,525,1048,45,3699,1625,6942,98,89
230,651,80,2808,2937,6706,347,976,35,3502,1671,6531,98,90
148,341,19,2072,2363,4943,267,481,18,2962,1180,4908,98,91
953,283,18,1589,1360,4203,369,729,30,1660,1450,4238,98,92
1474,313,27,1347,1234,4395,393,799,29,1140,1910,4271,98,93
1411,313,5,895,911,3535,329,831,14,687,1576,3437,98,94
1396,484,14,1736,1939,5569,603,895,13,1869,1857,5237,98,95
848,579,52,1791,2333,5603,564,977,55,2281,1565,5442,98,96
366,580,99,2018,2220,5283,264,868,41,2668,1289,5130,98,97
371,352,5,1612,1630,3970,181,485,8,2340,1057,4071,98,98
1015,318,24,972,1129,3458,443,548,22,1008,1366,3387,98,99
1472,442,8,1102,1211,4235,491,793,18,1095,1715,4112,98,100
1498,391,1,1171,1445,4506,437,828,10,1266,1761,4302,98,101
1377,386,8,966,1023,3760,439,781,11,820,1630,3681,98,102
850,631,44,1113,1441,4079,481,981,43,1221,1453,4179,98,103
246,612,83,1983,2204,5128,324,900,41,2439,1361,5065,98,104
146,378,3,2096,2312,4935,307,511,12,2889,1170,4889,98,105
988,342,7,1285,1296,3918,510,706,7,1355,1399,3977,98,106
1351,387,12,1206,1477,4433,444,877,10,1321,1760,4412,98,107
1377,400,2,1204,1208,4191,488,800,5,1051,1882,4226,98,108
1327,502,15,1174,1535,4553,529,870,9,1356,1663,4427,98,109
765,591,53,1345,1678,4432,565,942,53,1496,1356,4412,98,110
184,666,54,1922,2513,5339,268,837,48,2558,1414,5125,98,111
132,239,4,1581,1366,3322,217,389,11,1607,908,3132,98,112
1020,303,21,982,1202,3528,400,544,25,1076,1397,3442,98,113
1398,329,8,995,1283,4013,427,797,14,1007,1689,3934,98,114
1351,429,9,1134,1251,4174,497,812,13,978,1691,3991,98,115
1375,354,4,1085,1303,4121,532,819,8,1016,1557,3932,98,116
823,580,44,1207,1583,4237,483,925,56,1405,1521,4390,98,117
191,525,28,1557,1426,3727,229,656,70,1756,953,3664,98,118
125,425,12,1509,2013,4084,196,489,19,2332,1038,4074,98,119
1041,279,4,997,1021,3342,444,594,7,959,1305,3309,98,120
1497,357,3,962,1106,3925,481,786,9,894,1727,3897,98,121
1424,392,16,1085,1212,4129,498,765,25,950,1774,4012,98,122
1387,411,16,1159,1204,4177,545,836,16,1089,1601,4087,98,123
822,540,77,1168,1594,4201,460,853,48,1297,1348,4006,98,124
178,583,40,1262,1362,3425,199,570,40,1669,1104,3582,98,125
108,256,5,1091,813,2273,92,365,6,1062,663,2188,98,126
1042,278,14,868,975,3177,410,558,17,868,1277,3130,98,127
1489,390,20,1052,1143,4094,413,885,20,878,1784,3980,98,128
1480,422,13,1093,1314,4322,494,879,25,966,1733,4097,98,129
1283,445,23,1048,1210,4009,474,754,24,976,1661,3889,98,130
813,517,46,1313,1187,3876,512,773,42,955,1255,3537,98,131
225,498,58,1726,2305,4812,223,588,49,2440,1133,4433,98,132
145,284,8,1239,1221,2897,150,407,11,1524,882,2974,98,133
1007,331,19,1024,1368,3749,465,685,27,1113,1637,3927,98,134
1458,357,22,1326,1012,4175,528,746,28,993,1817,4112,98,135
1505,357,41,959,1134,3996,398,886,33,781,1669,3767,98,136
1505,525,16,1174,1473,4693,552,884,27,1384,1832,4679,98,137
856,572,44,1349,1518,4339,564,792,47,1489,1466,4358,98,138
162,423,61,1316,953,2915,151,704,39,1157,962,3013,98,139
158,391,10,1580,1623,3762,174,527,12,2070,1074,3857,98,140
1085,310,4,1109,1336,3844,551,668,7,1231,1410,3867,98,141
1485,449,19,1039,1353,4345,577,910,25,1111,1765,4388,98,142
1460,373,14,1135,1429,4411,532,753,19,1072,1804,4180,98,143
1330,354,13,941,1080,3718,476,652,16,860,1648,3652,98,144
735,490,78,1599,1604,4506,515,839,61,1565,1281,4261,98,145
167,535,47,2111,2375,5235,311,845,26,2922,1207,5311,98,146
156,443,3,2284,1998,4884,314,573,3,2944,1006,4840,98,147
127,214,1,1319,962,2623,192,350,9,1417,764,2732,98,148
1379,338,12,985,1166,3880,445,686,33,1014,1685,3863,98,149
1438,293,8,1074,1043,3856,548,700,15,1024,1604,3891,98,150
1443,396,6,1261,1404,4510,514,746,16,1230,1718,4224,98,151
855,506,54,1218,1505,4138,489,823,39,1336,1287,3974,98,152
233,569,54,1666,2176,4698,320,827,60,2415,1165,4787,98,153
148,331,19,1380,1602,3480,246,397,24,2032,952,3651,98,154
1157,294,9,1069,1244,3773,525,615,12,1087,1463,3702,98,155
1564,406,10,1156,1321,4457,543,836,17,1348,1842,4586,98,156
1563,305,7,1251,1010,4136,505,737,10,1073,1810,4135,98,157
1788,438,16,1105,1364,4711,570,994,30,1190,1740,4524,98,158
1201,650,64,1384,1813,5112,557,1301,114,1697,1476,5145,98,159
296,844,119,2493,2389,6141,368,1408,75,2889,1859,6599,98,160
156,535,9,1887,1906,4493,368,652,18,2309,1169,4516,98,161
1180,418,11,1223,1404,4236,662,713,17,1330,1552,4274,98,162
2112,573,7,1342,1591,5625,603,909,7,1524,2572,5615,98,163
1741,410,9,1357,1572,5089,597,980,22,1344,2039,4982,98,164
1906,450,17,1261,1362,4996,552,921,23,1511,1901,4908,98,165
1322,606,62,1380,1552,4922,572,1069,65,1679,1384,4769,98,166
259,645,56,2437,2231,5628,382,1108,48,2489,1524,5551,98,167
205,342,8,1667,1356,3578,251,523,16,1947,1039,3776,98,168
1134,384,29,1145,1234,3926,504,702,30,1126,1384,3746,98,169
1478,435,15,1349,1332,4609,560,962,23,1353,1826,4724,98,170
434,512,18,1936,1637,4537,485,747,18,2190,1181,4621,98,171
1693,476,47,1240,1389,4845,654,838,45,1521,1686,4744,98,172
1225,563,74,1215,1386,4463,621,890,49,1674,1188,4422,98,173
275,609,65,2013,1196,4158,424,1071,108,1424,1142,4169,98,174
250,289,7,1418,887,2851,237,441,11,1349,819,2857,98,175
1119,314,15,964,1166,3578,517,648,22,1105,1411,3703,98,176
1426,436,21,1199,1135,4217,497,836,34,1154,1785,4306,98,177
1440,410,18,1066,1084,4018,494,831,29,930,1741,4025,98,178
1766,503,15,1214,1346,4844,512,862,29,1639,1724,4766,98,179
1084,699,73,1592,1751,5199,606,881,57,2069,1429,5042,98,180
282,585,89,2105,1677,4738,308,914,74,2052,1474,4822,98,181
170,327,11,1411,1121,3040,275,475,30,1586,802,3168,98,182
1004,345,13,1263,1654,4279,534,646,19,1539,1492,4230,98,183
1217,431,3,1230,1527,4408,474,779,7,1429,1711,4400,98,184
1050,437,5,1336,1743,4571,551,985,17,1645,1437,4635,98,185
219,1157,15,1769,1663,4823,284,1951,32,1798,1158,5223,98,186
470,505,77,1713,1427,4192,425,912,65,1748,1109,4259,98,187
243,381,67,1713,1413,3817,383,748,48,1784,927,3890,98,188
161,266,15,1271,1038,2751,238,437,22,1482,849,3028,98,189
1101,263,13,969,997,3343,504,686,18,989,1382,3579,98,190
1544,328,9,982,1085,3948,520,845,13,961,1704,4043,98,191
1384,396,6,1027,1094,3907,509,740,10,1021,1764,4044,98,192
1740,411,20,1128,1390,4689,562,876,30,1449,1630,4547,98,193
867,501,43,1388,1121,3920,436,889,49,892,1514,3780,98,194
272,602,64,2075,1860,4873,304,901,63,2255,1326,4849,98,195
201,291,7,1524,1120,3143,312,466,12,1482,888,3160,98,196
1013,265,8,893,950,3129,514,573,9,920,1360,3376,98,197
1427,399,4,889,942,3661,522,842,10,829,1607,3810,98,198
1374,329,11,1069,971,3754,554,665,17,886,1654,3776,98,199
1571,469,22,1202,1422,4686,501,785,22,1460,1685,4453,98,200
1084,613,78,1289,1932,4996,542,1043,146,1876,1349,4956,98,201
206,538,83,1977,1941,4745,242,922,75,2579,1163,4981,98,202
182,354,6,1618,1503,3663,254,454,7,1963,1157,3835,98,203
1114,275,6,1013,947,3355,492,655,12,1155,1350,3664,98,204
1716,475,10,1178,1392,4771,505,909,11,1561,1853,4839,98,205
1337,394,9,1257,1335,4332,503,851,17,1227,1751,4349,98,206
1362,460,11,1360,1201,4394,482,816,11,1128,1814,4251,98,207
784,553,59,1555,1696,4647,490,885,102,1721,1283,4481,98,208
235,711,80,1801,2288,5115,325,943,72,2615,1201,5156,98,209
141,387,16,1340,1607,3491,215,488,21,1983,938,3645,98,210
973,358,20,1057,1382,3790,535,672,39,1129,1443,3818,98,211
1364,293,9,1021,1215,3902,502,664,14,1087,1662,3929,98,212
1384,370,9,1163,1124,4050,517,672,8,1149,1635,3981,98,213
1283,428,19,1034,1204,3968,501,754,20,1051,1490,3816,98,214
748,492,59,1045,1202,3546,516,827,47,1001,1145,3536,98,215
206,360,53,1568,1391,3578,278,575,42,1776,996,3667,98,216
134,319,10,1342,1163,2968,228,367,14,1651,869,3129,98,217
956,298,12,941,1113,3320,467,569,13,1079,1273,3401,98,218
1273,344,4,948,1296,3865,467,683,13,1059,1610,3832,98,219
1257,345,6,991,1251,3850,430,698,11,1090,1561,3790,98,220
1093,281,28,950,913,3265,439,672,32,785,1326,3254,98,221
578,478,83,710,864,2713,330,790,82,592,929,2723,98,222
197,508,67,1577,1865,4214,244,758,31,2138,1085,4256,98,223
137,334,20,1339,1581,3411,195,404,26,2061,874,3560,98,224
857,274,7,835,1284,3257,468,523,11,1150,1233,3385,98,225
1187,344,35,989,1185,3740,456,637,28,1136,1557,3814,98,226
1162,360,24,1093,1271,3910,496,672,24,1124,1471,3787,98,227
1086,415,19,1043,1334,3897,468,754,31,1155,1407,3815,98,228
679,475,48,1064,1368,3634,491,850,30,1189,1111,3671,98,229
153,489,57,1474,1544,3717,245,636,59,1893,1021,3854,98,230
132,273,12,1332,1035,2784,185,366,14,1495,866,2926,98,231
865,267,18,790,1062,3002,438,496,29,955,1203,3121,98,232
1206,297,29,974,1318,3824,462,641,24,1159,1431,3717,98,233
1204,339,9,1040,1279,3871,472,692,11,1194,1410,3779,98,234
1146,404,8,1010,1258,3826,491,694,9,1092,1421,3707,98,235
739,554,52,1151,1302,3798,502,816,40,1290,1205,3853,98,236
211,537,58,1657,1787,4250,241,869,42,2035,1083,4270,98,237
129,306,13,1663,1261,3372,180,416,22,2014,865,3497,98,238
1019,227,10,893,926,3075,480,572,11,782,1264,3109,98,239
1401,304,19,847,1048,3619,464,761,22,810,1551,3608,98,240
1295,320,15,874,904,3408,516,706,10,659,1486,3377,98,241
1258,251,22,916,949,3396,520,590,30,775,1442,3357,98,242
705,405,35,1053,1275,3473,440,762,49,1102,1114,3467,98,243
208,461,72,1597,1651,3989,244,724,57,2017,981,4023,98,244
146,429,8,1492,1754,3829,253,504,16,2107,1075,3955,98,245
125,199,6,1471,1742,3543,180,410,9,2189,810,3598,98,246
1371,264,18,789,970,3412,447,568,14,783,1595,3407,98,247
1433,307,14,800,951,3505,471,644,16,699,1648,3478,98,248
1357,364,14,857,1050,3642,475,719,21,738,1543,3496,98,249
849,444,40,912,1110,3355,497,703,42,898,1200,3340,98,250
184,482,44,1531,1559,3800,207,815,102,1871,1019,4014,98,251
148,360,13,1380,1539,3440,200,398,19,2174,983,3774,98,252
1144,263,10,783,979,3179,494,616,17,720,1432,3279,98,253
1576,395,21,829,1114,3935,497,850,32,739,1800,3918,98,254
1598,325,29,916,1162,4030,482,874,34,768,1791,3949,98,255
1484,403,10,995,1227,4119,552,935,13,835,1620,3955,98,256
900,518,100,1092,1373,3983,514,933,73,1078,1297,3895,98,257
214,622,100,1637,1975,4548,240,1077,87,2180,1154,4738,98,258
174,287,11,1531,1217,3220,200,416,34,1790,920,3360,98,259
1204,234,23,881,1049,3391,494,593,28,862,1412,3389,98,260
1677,326,5,911,1000,3919,524,802,12,784,1815,3937,98,261
1718,426,22,851,903,3920,478,831,24,674,1824,3831,98,262
1538,347,19,1016,1188,4108,538,941,23,842,1644,3988,98,263
985,612,53,1129,1349,4128,558,912,47,1198,1408,4123,98,264
201,460,70,1724,1636,4091,269,824,46,1852,961,3952,98,265
140,248,2,1248,1182,2820,127,399,5,1715,682,2928,98,266
1204,248,9,806,1024,3291,528,644,7,683,1458,3320,98,267
1606,307,15,829,965,3722,516,781,24,675,1754,3750,98,268
1596,347,10,895,1006,3854,465,893,14,640,1795,3807,98,269
1441,339,11,984,1166,3941,468,808,13,848,1652,3789,98,270
909,550,41,996,1101,3597,490,957,46,845,1284,3622,98,271
243,545,58,1744,1764,4354,217,1079,68,2080,1138,4582,98,272
161,213,7,1472,920,2773,169,433,13,1335,858,2808,98,273
1180,246,8,861,998,3293,486,699,10,626,1495,3316,98,274
1584,344,7,1267,912,4114,556,744,10,930,1795,4035,98,275
1554,342,11,1062,1029,3998,558,748,10,780,1746,3842,98,276
1328,407,13,1143,1433,4324,516,783,13,1176,1607,4095,98,277
889,593,37,1176,1566,4261,740,842,46,1290,1395,4313,98,278
183,494,57,1757,1686,4177,268,747,49,2087,824,3975,98,279
142,253,5,1393,1340,3133,233,425,13,1760,713,3144,98,280
1195,300,2,900,1071,3468,511,656,5,891,1497,3560,98,281
1567,323,7,1024,1206,4127,531,824,9,869,1826,4059,98,282
1543,388,3,1045,1224,4203,506,808,10,974,1838,4136,98,283
1319,432,5,1128,1414,4298,595,853,4,1154,1599,4205,98,284
809,568,88,1340,1679,4484,631,955,47,1507,1355,4495,98,285
267,544,63,2025,1915,4814,305,951,56,2583,1049,4944,98,286
193,332,11,1842,1893,4271,269,590,16,2578,928,4381,98,287
509,260,5,1421,1288,3483,334,578,7,1604,1033,3556,98,288
1593,317,3,876,970,3759,486,983,7,664,1709,3849,98,289
1609,348,3,1285,1203,4448,559,833,13,1119,1876,4400,98,290
1450,431,8,1147,1348,4384,568,965,19,1039,1765,4356,98,291
909,1029,60,1575,1603,5176,593,1097,72,1690,1826,5278,98,292
234,1113,114,1999,1728,5188,259,1039,85,2428,1491,5302,98,293
170,622,13,1782,1359,3946,156,584,12,2031,1106,3889,98,294
1187,319,4,972,1078,3560,551,628,7,854,1487,3527,98,295
1599,404,6,1093,1206,4308,526,834,8,990,2000,4358,98,296
1545,430,1,1114,1255,4345,605,865,15,1018,1932,4435,98,297
1503,399,12,1072,1367,4353,566,971,16,929,1721,4203,98,298
895,1199,156,1420,1380,5050,582,1487,51,1246,1634,5000,98,299
257,626,109,1765,1756,4513,247,880,98,2295,1141,4661,98,300
372,301,5,1652,1203,3533,321,497,14,1813,886,3531,98,301
1174,283,12,1053,1220,3742,591,634,14,1045,1455,3739,98,302
1552,439,8,1121,1572,4692,648,1316,13,905,1719,4601,98,303
1556,372,7,1164,1246,4345,586,849,17,842,1890,4184,98,304
1320,453,34,975,1105,3887,518,840,32,771,1694,3855,98,305
819,567,85,1076,1323,3870,486,952,53,1192,1332,4015,98,306
196,869,87,1442,2680,5274,193,855,64,3055,2031,6198,98,307
164,217,9,1452,1146,2988,180,387,10,1813,780,3170,98,308
1163,225,4,891,1110,3393,525,589,9,950,1343,3416,98,309
1225,376,13,1025,1151,3790,514,661,31,1106,1509,3821,98,310
1195,286,11,994,1064,3550,519,661,13,897,1652,3742,98,311
1455,328,14,1058,1034,3889,544,775,26,825,1679,3849,98,312
928,540,58,1164,1518,4208,562,954,51,1273,1384,4224,98,313
275,508,66,2055,1809,4713,215,763,48,2637,1082,4745,98,314
163,252,2,1515,982,2914,157,427,10,1526,989,3109,98,315
543,246,9,1315,1185,3298,258,530,17,1478,941,3224,98,316
1583,280,11,889,1085,3848,527,728,15,756,1926,3952,98,317
1650,358,8,981,1110,4107,520,848,13,821,1914,4116,98,318
1508,351,8,1055,1078,4000,509,851,19,930,1871,4180,98,319
951,584,45,1155,1317,4052,503,938,50,991,1440,3922,98,320
217,527,71,2026,1281,4122,175,737,100,1836,1465,4313,98,321
172,280,10,1539,1164,3165,146,393,5,1720,866,3130,98,322
1217,275,8,815,1067,3382,449,648,6,766,1476,3345,98,323
1609,335,3,915,1095,3957,563,790,4,775,1833,3965,98,324
1536,366,2,944,1001,3849,458,822,3,715,1873,3871,98,325
1430,423,20,960,1088,3921,490,893,18,698,1767,3866,98,326
916,576,70,914,1056,3532,477,847,70,754,1377,3525,98,327
209,1084,64,1357,1338,4052,166,882,49,1302,1595,3994,98,328
135,529,7,1269,1080,3020,109,368,16,1322,1140,2955,98,329
968,251,11,969,1201,3400,465,485,14,986,1347,3297,98,330
997,292,8,1087,1202,3586,444,583,11,1052,1254,3344,98,331
547,248,4,1116,1176,3091,440,421,3,1219,819,2902,98,332
120,125,0,470,372,1087,72,207,6,524,253,1062,98,333
205,845,29,1129,941,3149,172,507,14,1198,1380,3271,98,334
95,1007,44,996,863,3005,98,715,46,983,1454,3296,98,335
87,420,9,824,640,1980,80,447,12,860,925,2324,98,336
1084,219,7,707,839,2856,433,613,11,581,1276,2914,98,337
1464,266,10,790,1020,3550,456,878,10,583,1804,3731,98,338
1533,311,9,989,1134,3976,657,824,13,726,1811,4031,98,339
1454,431,12,953,1347,4197,588,944,14,682,1719,3947,98,340
938,1077,45,924,1290,4274,484,1117,53,802,1925,4381,98,341
178,1596,68,1453,1306,4601,174,1162,77,1160,2175,4748,98,342
129,1047,9,1399,1182,3766,115,608,17,1319,1785,3844,98,343
1254,291,10,749,940,3244,495,744,17,582,1603,3441,98,344
1586,410,17,1024,1125,4162,568,883,16,740,1864,4071,98,345
1679,391,11,926,920,3927,504,916,8,613,1788,3829,98,346
1581,626,8,1054,1321,4590,536,1074,10,862,1944,4426,98,347
910,1348,96,1075,1362,4791,481,1209,77,932,2238,4937,98,348
185,1661,104,1571,1428,4949,149,1075,78,1357,2239,4898,98,349
128,665,9,1237,791,2830,95,476,11,1095,1336,3013,98,350
1066,267,7,792,951,3083,446,593,9,663,1357,3068,98,351
1426,354,13,852,1094,3739,486,823,11,755,1638,3713,98,352
1292,329,4,947,938,3510,470,714,6,691,1520,3401,98,353
1087,880,3,984,1141,4095,430,861,5,864,1899,4059,98,354
665,926,41,842,1096,3570,379,819,28,716,1608,3550,98,355
141,984,28,968,891,3012,115,595,24,858,1483,3075,98,356
100,722,6,851,709,2388,72,323,7,713,1221,2336,98,357
324,699,4,753,855,2635,298,353,4,712,1192,2559,98,358
178,113,1,672,369,1333,229,136,2,484,381,1232,98,359
45,80,2,212,158,497,24,113,5,190,168,500,98,360
159,720,7,620,903,2409,274,355,7,746,1095,2477,98,361
178,960,23,898,1290,3349,305,478,13,1290,1379,3465,98,362
65,779,43,685,685,2257,77,572,26,750,1087,2512,98,363
72,445,7,870,968,2362,82,249,4,1277,912,2524,98,364
375,1032,11,1112,1565,4095,369,569,15,1689,1586,4228,98,365
345,458,403,1073,689,2968,277,664,273,1161,799,3174,98,366
